2-faced	2-Gesichter
2-faces	2-Gesichter
abnormal	abnormal
abolish	abschaffen
abominable	abscheulich
abominably	abscheulich
abominate	verabscheuen
abomination	Gräuel
abort	abbrechen
aborted	abgebrochen
abrade	abraden
abrasive	Schleifmittel
abrupt	abrupt
abruptly	plötzlich
abscond	Absud
absence	Abwesenheit
absent-minded	zerstreut
absentee	Abwesenheit
absurd	absurd
absurdity	Absurdität
absurdly	absurd
absurdness	Absurdität
abuse	Missbrauch
abused	missbraucht
abuses	Missbrauch
abusive	missbräuchlich
abysmal	miserabel
abysmally	abgrundtief
abyss	Abgrund
accidental	zufällig
accost	ansprechen
accursed	verflucht
accusation	Anklage
accusations	Vorwürfe
accuse	beschuldigen
accuses	beschuldigt
accusing	beschuldigt
accusingly	anklagend
acerbate	schärfer
acerbic	erbittert
acerbically	erbärmlich
ache	schmerzen
ached	schmerzte
aches	Schmerzen
achey	achey
aching	Schmerz
acrid	scharf
acridly	scharf
acridness	Schärfe
acrimonious	erbittert
acrimoniously	erbärmlich
acrimony	Bitterkeit
adamant	unnachgiebig
adamantly	hartnäckig
addict	Süchtiger
addicted	süchtig
addicting	süchtig
addicts	Süchtige
admonish	ermahnen
admonisher	Mahner
admonishingly	mahnend
admonishment	Ermahnung
admonition	Ermahnung
adulterate	verfälschen
adulterated	verfälscht
adulteration	Verfälschung
adulterier	Ehebruch
adversarial	feindselig
adversary	Gegner
adverse	ungünstig
adversity	Unglück
afflict	Plagen
affliction	Gebrechen
afflictive	belastend
affront	Beleidigung
afraid	Angst
aggravate	verschlimmern
aggravating	erschwerend
aggravation	Verschlimmerung
aggression	Aggression
aggressive	aggressiv
aggressiveness	Aggressivität
aggressor	Aggressor
aggrieve	betrüben
aggrieved	gekränkt
aggrivation	Aggrivation
aghast	entsetzt
agonies	Qualen
agonize	quälen
agonizing	quälend
agonizingly	quälend
agony	Qual
aground	gestrandet
ail	ail
ailing	kränkend
ailment	Leiden
aimless	ziellos
alarm	Alarm
alarmed	alarmiert
alarming	alarmierend
alarmingly	erschreckend
alienate	entfremden
alienated	entfremdet
alienation	Entfremdung
allegation	Behauptung
allegations	Behauptungen
allege	behaupten
allergic	allergisch
allergies	Allergien
allergy	Allergie
aloof	distanziert
altercation	Auseinandersetzung
ambiguity	Mehrdeutigkeit
ambiguous	mehrdeutig
ambivalence	Ambivalenz
ambivalent	ambivalent
ambush	Hinterhalt
amputate	amputieren
anarchism	Anarchismus
anarchist	Anarchist
anarchistic	anarchistisch
anarchy	Anarchie
anemic	anämisch
anger	Zorn
angrily	wütend
angriness	Ärger
angry	wütend
anguish	Pein
animosity	Feindseligkeit
annihilate	vernichten
annihilation	Vernichtung
annoy	Nerven
annoyance	Ärger
annoyances	Ärger
annoyed	verärgert
annoying	nervig
annoyingly	ärgerlich
annoys	ärgert
anomalous	anomal
anomaly	Anomalie
antagonism	Antagonismus
antagonist	Gegner
antagonistic	antagonistisch
antagonize	antagonisieren
anti-	Anti-
anti-american	antiamerikanisch
anti-israeli	anti-israelisch
anti-occupation	Antibesetzung
anti-proliferation	Anti-Proliferation
anti-semites	Antisemiten
anti-social	antisozial
anti-us	Anti-uns
anti-white	anti-weiß
antipathy	Antipathie
antiquated	veraltet
antithetical	antithetisch
anxieties	Ängste
anxiety	Angst
anxious	Ängstlich
anxiously	besorgt
anxiousness	Angst
apathetic	apathisch
apathetically	apathisch
apathy	Apathie
apocalypse	Apokalypse
apocalyptic	apokalyptisch
apologist	Apologet
apologists	Apologeten
appal	appal
appall	entsetzen
appalled	entsetzt
appalling	entsetzlich
appallingly	entsetzlich
apprehension	Auffassung
apprehensions	Befürchtungen
apprehensive	besorgt
apprehensively	ängstlich
arbitrary	willkürlich
arcane	geheimnisvoll
archaic	archaisch
arduous	beschwerlich
arduously	mühsam
argumentative	argumentativ
arrogance	Arroganz
arrogant	arrogant
arrogantly	arrogant
ashamed	beschämt
asinine	Asinin
asininely	asininely
asinininity	Asininität
askance	schief
asperse	zerfallen
aspersion	Verleumdung
aspersions	Aspersionen
assail	angreifen
assassin	Attentäter
assassinate	ermorden
assault	Angriff
assult	assult
asunder	auseinander
atrocious	scheußlich
atrocities	Grausamkeiten
atrocity	Gräueltat
atrophy	Atrophie
attack	Attacke
attacks	Anschläge
audacious	kühn
audaciously	kühn
audaciousness	Kühnheit
audacity	Kühnheit
audiciously	witzig
austere	streng
authoritarian	autoritär
autocrat	Autokrat
autocratic	autokratisch
avalanche	Lawine
avarice	Habsucht
avaricious	habgierig
avariciously	gierig
avenge	rächen
averse	abgeneigt
aversion	Abneigung
aweful	furchtbar
awful	furchtbar
awfully	schrecklich
awfulness	Schrecklichkeit
awkward	peinlich
awkwardness	Ungeschicklichkeit
ax	Axt
babble	plappern
back-logged	zurückgeloggt
back-wood	Hinterholz
back-woods	Hinterwälder
backache	Rückenschmerzen
backaches	Rückenschmerzen
backaching	Rückverfolgung
backbite	verleumden
backbiting	Lästern
backward	rückwärts
backwardness	Rückständigkeit
backwood	Hinterwäldler
backwoods	hinterwäldler
bad	Schlecht
badly	schlecht
baffle	Schallwand
baffled	verdutzt
bafflement	Verblüffung
baffling	verwirrend
bait	Köder
balk	Balken
banal	banal
banalize	banalisieren
bane	Fluch
banish	verbannen
banishment	Verbannung
bankrupt	Pleite
barbarian	Barbar
barbaric	barbarisch
barbarically	barbarisch
barbarity	Barbarei
barbarous	barbarisch
barbarously	Barbarisch
barren	unfruchtbar
baseless	unbegründet
bash	bash
bashed	geschlagen
bashful	schüchtern
bashing	verprügeln
bastard	Bastard
bastards	Bastarde
battered	angeschlagen
battering	Misshandlung
batty	bekloppt
bearish	bearish
beastly	tierisch
bedlam	Bedlam
bedlamite	bedlamite
befoul	befleckt
beg	bitten
beggar	Bettler
beggarly	Bettler
begging	betteln
beguile	betören
belabor	bearbeiten
belated	verspätet
beleaguer	belagern
belie	belügen
belittle	schmälern
belittled	herabgesetzt
belittling	herabsetzend
bellicose	kriegerisch
belligerence	Kriegslust
belligerent	kriegerisch
belligerently	kriegslüstern
bemoan	beklagen
bemoaning	beklagen
bemused	verwirrt
bent	gebogen
berate	beschimpfen
bereave	berauben
bereavement	Trauerfall
bereft	beraubt
berserk	Berserker
beseech	bitten
beset	bedrängt
besiege	belagern
besmirch	beschmutzen
bestial	bestialisch
betray	verraten
betrayal	Verrat
betrayals	Verrat
betrayer	Verräter
betraying	Verrat
betrays	verrät
bewail	beklagen
bewilder	verwirren
bewildered	verwirrt
bewildering	verwirrend
bewilderingly	verwirrend
bewilderment	Verwirrung
bewitch	verzaubern
bias	vorspannen
biased	voreingenommen
biases	Vorurteile
bicker	zanken
bickering	Gezänk
bid-rigging	Gebot-Rigging
bigotries	Bigotterie
bigotry	Fanatismus
bitch	Hündin
bitchy	gehässig
biting	beißen
bitingly	beißend
bitter	bitter
bitterly	bitterlich
bitterness	Bitterkeit
bizarre	bizarr
blab	ausplaudern
blabber	blabbern
blackmail	Erpressung
blah	Blah
blame	Schuld
blameworthy	tadelnswert
bland	fade
blandish	schönreden
blaspheme	lästern
blasphemous	blasphemisch
blasphemy	Blasphemie
blasted	gesprengt
blatant	eklatant
blatantly	offensichtlich
blather	quasseln
bleak	düster
bleakly	düster
bleakness	Trostlosigkeit
bleed	bluten
bleeding	Blutung
bleeds	blutet
blemish	Makel
blind	blind
blinding	Blendung
blindingly	blendend
blindside	blindside
blister	Blase
blistering	Blasenbildung
bloated	aufgebläht
blockage	Blockierung
blockhead	Dummkopf
bloodshed	Blutvergießen
bloodthirsty	blutrünstig
bloody	blutig
blotchy	fleckig
blow	Schlag
blunder	Schnitzer
blundering	stolpernd
blunders	Fehler
blunt	stumpf
blur	verwischen
bluring	Verwaschenheit
blurred	verschwommen
blurring	Unschärfe
blurry	verschwommen
blurs	verwischt
blurt	platzt
boastful	prahlerisch
boggle	boggle
bogus	falsch
boil	Kochen
boiling	Sieden
boisterous	ausgelassen
bomb	Bombe
bombard	bombardieren
bombardment	Bombardierung
bombastic	bombastisch
bondage	Knechtschaft
bonkers	Bonbons
bore	langweilen
bored	gelangweilt
boredom	Langeweile
bores	Bohrungen
boring	langweilig
botch	Murks
bother	Mühe
bothered	störte
bothering	stört
bothers	stört
bothersome	lästig
bowdlerize	säubern
boycott	Boykott
braggart	Angeber
bragger	prahlerisch
brainless	hirnlos
brainwash	Gehirnwäsche
brash	frech
brashly	frech
brashness	Bröseligkeit
brat	Gör
bravado	Bravour
brazen	unverschämt
brazenly	dreist
brazenness	Dreistigkeit
breach	Bruch
break	Unterbrechung
break-up	beenden
break-ups	Trennungen
breakdown	Nervenzusammenbruch
breaking	brechen
breakup	beenden
breakups	Trennungen
bribery	Bestechung
brimstone	Schwefel
bristle	Borste
brittle	spröde
broke	Pleite
broken	gebrochen
brood	Brut
browbeat	Brauenschlag
bruise	Prellung
bruised	zerschlagen
bruises	Prellungen
bruising	Blutergüsse
brusque	schroff
brutal	brutal
brutalising	Brutalisierung
brutalities	Brutalitäten
brutality	Brutalität
brutalize	verrohen
brutalizing	Brutalisierung
brutally	brutal
brute	Brute
brutish	brutal
bs	bs
buckle	Schnalle
bug	Fehler
bugging	Abhören
buggy	Buggy
bugs	Fehler
bulkier	sperriger
bulkiness	Sperrigkeit
bulky	sperrig
bulkyness	Sperrigkeit
bull****	Stier****
bull----	Stier----
bullies	Mobber
bullshit	Schwachsinn
bullshyt	Bullshyt
bully	Bully
bullying	Mobbing
bullyingly	Mobbing
bum	Gammler
bump	stoßen
bumped	bestoßen
bumping	stoßen
bumpping	bumsend
bumps	Unebenheiten
bumpy	holperig
bungle	verpfuschen
bungler	Stümper
bungling	Stümperei
bunk	Koje
burden	Belastung
burdensome	beschwerlich
burdensomely	beschwerlich
burn	brennen
burned	verbrannt
burning	Verbrennung
burns	brennt
bust	Büste
busts	Büsten
busybody	Wichtigtuer
butcher	Metzger
butchery	Metzgerei
buzzing	summend
byzantine	byzantinisch
cackle	gackern
calamities	Unglücke
calamitous	katastrophal
calamitously	katastrophal
calamity	Unglück
callous	gefühllos
calumniate	verleumden
calumniation	Verleumdung
calumnies	Verleumdungen
calumnious	verleumderisch
calumniously	schimpfend
calumny	Verleumdung
cancer	Krebs
cancerous	krebsartig
cannibal	Kannibale
cannibalize	ausschlachten
capitulate	kapitulieren
capricious	launisch
capriciously	launisch
capriciousness	Launenhaftigkeit
capsize	kentern
careless	leichtsinnig
carelessness	Nachlässigkeit
caricature	Karikatur
carnage	Gemetzel
carp	Karpfen
cartoonish	cartoonish
cash-strapped	bargeldgebunden
castigate	geißeln
castrated	kastriert
casualty	Opfer
cataclysm	Katastrophe
cataclysmal	katastrophal
cataclysmic	katastrophal
cataclysmically	kataklysmisch
catastrophe	Katastrophe
catastrophes	Katastrophen
catastrophic	katastrophal
catastrophically	katastrophal
catastrophies	Katastrophen
caustic	ätzend
caustically	ätzend
cautionary	warnend
cave	Höhle
censure	Tadel
chafe	scheuern
chaff	Spreu
chagrin	Ärger
challenging	herausfordernd
chaos	Chaos
chaotic	chaotisch
chasten	chasten
chastise	züchtigen
chastisement	Züchtigung
chatter	Geschwätz
chatterbox	Schwätzer
cheap	billig
cheapen	verbilligen
cheaply	billig
cheat	betrügen
cheated	betrogen
cheater	Betrüger
cheating	Betrug
cheats	Cheats
checkered	kariert
cheerless	freudlos
cheesy	käsig
chide	schelten
childish	kindisch
chill	Ausruhen
chilly	kühl
chintzy	chintzig
choke	Choke
choleric	cholerisch
choppy	abgehackt
chore	mühsam
chronic	chronisch
chunky	klobig
clamor	Geschrei
clamorous	lärmend
clash	Zusammenstoß
cliche	Klischee
cliched	klischeehaft
clique	Clique
clog	verstopfen
clogged	verstopft
clogs	Clogs
cloud	Wolke
clouding	Trübung
cloudy	bewölkt
clueless	ahnungslos
clumsy	ungeschickt
clunky	klobig
coarse	grob
cocky	großspurig
coerce	zwingen
coercion	Zwang
coercive	Zwang
cold	kalt
coldly	kalt
collapse	Zusammenbruch
collude	Kollaborieren
collusion	Absprache
combative	kämpferisch
combust	verbrennen
comical	komisch
commiserate	Mitgefühl
commonplace	alltäglich
commotion	Aufregung
commotions	Erschütterungen
complacent	selbstgefällig
complain	beschweren
complaint	Beschwerde
complaints	Beschwerden
complex	Komplex
complicated	kompliziert
complication	Komplikation
complicit	Kompliziert
compulsion	Zwang
compulsive	zwanghaft
concede	zugeben
conceded	zugegeben
conceit	Einbildung
conceited	eingebildet
concen	Konzentrat
concens	berät
concerned	besorgt
concerns	Bedenken
concession	Konzession
concessions	Konzessionen
condemn	verurteilen
condemnable	verwerflich
condemnation	Verurteilung
condemned	verurteilt
condemns	verurteilt
condescend	geruhen
condescending	herablassend
condescendingly	herablassend
condescension	Herablassung
confess	bekennen
confession	Bekenntnis
confessions	Bekenntnisse
confined	beschränkt
conflict	Konflikt
conflicted	widersprüchlich
conflicting	widersprüchlich
conflicts	Konflikte
confound	verwechseln
confounded	verwechselt
confounding	verwirrend
confront	konfrontieren
confrontation	Konfrontation
confrontational	konfrontativ
confuse	verwechseln
confused	verwirrt
confuses	verwirrt
confusing	verwirrend
confusion	Verwechslung
confusions	Verwirrungen
congested	verstopft
congestion	Überlastung
cons	Nachteile
conscons	koncons
conservative	konservativ
conspicuous	auffällig
conspicuously	auffällig
conspiracies	Verschwörungen
conspiracy	Verschwörung
conspirator	Verschwörer
conspiratorial	konspirativ
conspire	konspirieren
consternation	Bestürzung
contagious	ansteckend
contaminate	verunreinigen
contaminated	kontaminiert
contaminates	verunreinigt
contaminating	kontaminierend
contamination	Kontamination
contempt	Verachtung
contemptible	verächtlich
contemptuous	verächtlich
contemptuously	verächtlich
contend	kämpfen
contention	Streit
contentious	umstritten
contort	verdrehen
contortions	Verrenkungen
contradict	widersprechen
contradiction	Widerspruch
contradictory	widersprüchlich
contrariness	Widersprüchlichkeit
contravene	verstoßen
contrive	ersinnen
contrived	gekünstelt
controversial	umstritten
controversy	Kontroverse
convoluted	verschachtelt
corrode	korrodieren
corrosion	Korrosion
corrosions	Korrosionen
corrosive	ätzend
corrupt	korrupt
corrupted	beschädigt
corrupting	korrumpierend
corruption	Korruption
corrupts	korrumpiert
corruptted	verdorben
costlier	teurer
costly	teuer
counter-productive	kontraproduktiv
counterproductive	kontraproduktiv
coupists	Putschisten
covetous	begehrlich
coward	Feigling
cowardly	feige
crabby	mürrisch
crack	Riss
cracked	geknackt
cracks	Risse
craftily	schlau
craftly	handwerklich
crafty	schlau
cramp	Krampf
cramped	eng
cramping	Krämpfe
cranky	verschroben
crap	Mist
crappy	beschissen
craps	scheißt
crash	Absturz
crashed	abgestürzt
crashing	krachend
crass	krass
craven	feige
cravenly	genial
craze	Begeisterung
crazily	verrückt
craziness	Verrücktheit
crazy	verrückt
creak	knarren
creaking	Knarren
creaks	knarrt
credulous	leichtgläubig
creep	Schleich
creeping	schleichend
creeps	kriecht
creepy	gruselig
crept	geschlichen
crime	Kriminalität
criminal	kriminell
cringe	kriechen
cringed	zusammengekrümmt
cringes	Krämpfe
cripple	Krüppel
crippled	verkrüppelt
cripples	Krüppel
crippling	lähmend
crisis	Krise
critic	Kritiker
critical	kritisch
criticism	Kritik
criticisms	Kritikpunkte
criticize	kritisieren
criticized	kritisiert
criticizing	kritisierend
critics	Kritik
cronyism	Vetternwirtschaft
crook	Gauner
crooked	krumm
crooks	Gauner
crowded	überfüllt
crowdedness	Überfüllung
crude	roh
cruel	grausam
crueler	grausamer
cruelest	grausamste
cruelly	grausam
cruelness	Grausamkeit
cruelties	Grausamkeiten
cruelty	Grausamkeit
crumble	zerbröckeln
crumbling	bröckelt
crummy	mies
crumple	zerknittern
crumpled	zerknittert
crumples	zerknüllt
crush	zerquetschen
crushed	zerkleinert
crushing	Zerkleinern
cry	Schrei
culpable	schuldig
culprit	Täter
cumbersome	schwerfällig
cunt	Fotze
cunts	Mösen
cuplrit	cuplit
curse	Fluch
cursed	verflucht
curses	Flüche
curt	kurz
cuss	fluchen
cussed	geärgert
cutthroat	Halsabschneider
cynical	zynisch
cynicism	Zynismus
damage	Beschädigung
damaged	beschädigt
damages	Schäden
damaging	schädlich
damn	Verdammt
damnable	verdammenswert
damnably	verdammt
damnation	Verdammnis
damned	verdammt
damning	verdammt
damper	Dämpfer
danger	Achtung
dangerous	gefährlich
dangerousness	Gefährlichkeit
dark	dunkel
darken	verdunkeln
darkened	verdunkelt
darker	dunkler
darkness	Dunkelheit
dastard	abartig
dastardly	heimtückisch
daunt	entmutigen
daunting	entmutigend
dauntingly	entmutigend
dawdle	trödeln
daze	Benommenheit
dazed	benommen
dead	tot
deadbeat	Deadbeat
deadlock	Sackgasse
deadly	tötlich
deadweight	Mitnahme
deaf	taub
dearth	Mangel
death	Tod
debacle	Debakel
debase	erniedrigen
debasement	Entwertung
debaser	Debaser
debatable	fraglich
debauch	Ausschweifung
debaucher	Ausschweißer
debauchery	Ausschweifung
debilitate	entkräften
debilitating	schwächend
debility	Schwäche
debt	Schuld
debts	Schulden
decadence	Dekadenz
decadent	dekadent
decay	zerfallen
decayed	verfallen
deceit	Betrug
deceitful	betrügerisch
deceitfully	betrügerisch
deceitfulness	Falschheit
deceive	täuschen
deceiver	Betrüger
deceivers	Betrüger
deceiving	täuschend
deception	Täuschung
deceptive	trügerisch
deceptively	täuschend
declaim	deklamieren
decline	Ablehnen
declining	rückläufig
decrement	dekrementieren
decrepit	altersschwach
decrepitude	Altersschwäche
decry	anprangern
defamation	Diffamierung
defamations	Verleumdungen
defamatory	verleumderisch
defame	diffamieren
defect	Defekt
defective	defekt
defects	Mängel
defensive	Defensive
defiance	Trotz
defiant	trotzig
defiantly	trotzig
deficiencies	Mängel
deficiency	Mangel
deficient	mangelhaft
defile	verunreinigen
defiler	Entweiher
deform	verformen
deformed	deformiert
defrauding	betrügen
defunct	verstorben
defy	trotzen
degenerate	degenerieren
degenerately	degeneriert
degeneration	Degeneration
degradation	Degradierung
degrade	degradieren
degrading	erniedrigend
degradingly	erniedrigend
dehumanization	Entmenschlichung
dehumanize	entmenschlichen
deign	geruhen
deject	verwerfen
dejected	niedergeschlagen
dejectedly	niedergeschlagen
dejection	Niedergeschlagenheit
delay	verzögern
delayed	verspätet
delaying	Verzögerung
delays	Verzögerungen
delinquency	Kriminalität
delinquent	Delinquent
delirious	phantasierend
delirium	Delirium
delude	täuschen
deluded	getäuscht
deluge	Sintflut
delusion	Täuschung
delusional	wahnhaft
delusions	Wahnvorstellungen
demean	erniedrigen
demeaning	erniedrigend
demise	Ableben
demolish	zerstören
demolisher	Demolierer
demon	Dämon
demonic	dämonisch
demonize	dämonisieren
demonized	dämonisiert
demonizes	dämonisiert
demonizing	Dämonisierung
demoralize	demoralisieren
demoralizing	demoralisierend
demoralizingly	demoralisierend
denial	Verweigerung
denied	abgelehnt
denies	bestreitet
denigrate	verunglimpfen
denounce	anprangern
dense	dicht
dent	Delle
dented	verbeult
dents	Dellen
denunciate	denunzieren
denunciation	Denunziation
denunciations	Denunziationen
deny	verweigern
deplete	aufbrauchen
deplorable	bedauerlich
deplorably	beklagenswert
deplore	bedauern
deploring	bedauernd
deploringly	bedauernd
deprave	verderben
depraved	verdorben
depravedly	verdorben
deprecate	missbilligen
depress	niederdrücken
depressed	deprimiert
depressing	deprimierend
depressingly	deprimierend
depression	Depression
depressions	Depressionen
deprive	berauben
deprived	beraubt
deride	verspotten
derision	Spott
derisive	spöttisch
derisively	spöttisch
derisiveness	Spott
derogatory	abfällig
desecrate	entheiligen
desert	Wüste
desertion	Desertion
desiccate	trocknen
desiccated	getrocknet
desititute	Desitut
desolate	verwüsten
desolately	trostlos
desolation	Verwüstung
despair	Verzweiflung
despairing	verzweifelt
despairingly	verzweifelt
desperate	verzweifelt
desperately	verzweifelt
desperation	Verzweiflung
despicable	Verabscheuungswürdig
despicably	verabscheuungswürdig
despise	verachten
despised	verachtet
despoil	plündern
despoiler	Müllabfuhr
despondence	Verzagtheit
despondency	Niedergeschlagenheit
despondent	mutlos
despondently	mutlos
despot	Despot
despotic	despotisch
despotism	Despotismus
destabilisation	Destabilisierung
destains	destiniert
destitute	mittellos
destitution	Elend
destroy	zerstören
destroyer	Zerstörer
destruction	Zerstörung
destructive	destruktiv
desultory	unregelmäßig
deter	abhalten
deteriorate	verschlechtern
deterioration	Verschlechterung
deterrent	abschreckend
detest	verabscheuen
detestable	abscheulich
detestably	verabscheuungswürdig
detested	verabscheut
detesting	verabscheuend
detests	verabscheut
detract	schmälern
detracted	beeinträchtigt
detracting	abträglich
detraction	Beeinträchtigung
detracts	schmälert
detriment	Nachteil
detrimental	schädlich
devastate	verwüsten
devastates	verwüstet
devastating	verheerend
devastatingly	verheerend
devastation	Verwüstung
deviate	abweichen
deviation	Abweichung
devil	Teufel
devilish	teuflisch
devilishly	teuflisch
devilment	Übermut
devilry	Teufelei
devious	Verschwunden
deviously	hinterhältig
deviousness	Verschlagenheit
devoid	leer
diabolic	teuflisch
diabolical	teuflisch
diabolically	teuflisch
diametrically	diametral
diappointed	diappointed
diatribe	Schmährede
diatribes	Hetzreden
dick	Schwanz
dictator	Diktator
dictatorial	diktatorisch
die	sterben
dies	stirbt
difficult	schwer
difficulties	Schwierigkeiten
difficulty	Schwierigkeit
diffidence	Schüchternheit
dilapidated	baufällig
dilemma	Dilemma
dilly-dally	bummeln
dim	dim
dimmer	Dimmer
din	Lärm
ding	ding
dings	dings
dinky	Dinky
dire	düster
direly	düster
direness	Abscheulichkeit
dirt	Schmutz
dirtbag	Drecksack
dirtbags	Schmutzbeutel
dirts	Schmutz
dirty	dreckig
disable	deaktivieren
disabled	behindert
disaccord	disaccord
disadvantage	Nachteil
disadvantaged	benachteiligt
disadvantageous	nachteilig
disadvantages	Nachteile
disaffect	beeinträchtigen
disaffected	unzufrieden
disaffirm	ablehnen
disagreeable	unangenehm
disagreeably	unangenehm
disagreed	widersprach
disagreement	Uneinigkeit
disallow	verbieten
disapointed	enttäuscht
disapointing	enttäuschend
disapointment	Enttäuschung
disappoint	enttäuschen
disappointed	enttäuscht
disappointing	enttäuschend
disappointingly	enttäuschend
disappointment	Enttäuschung
disappointments	Enttäuschungen
disappoints	enttäuschend
disapprobation	Missbilligung
disapproval	Missbilligung
disapprove	missbilligen
disapproving	missbilligend
disarm	entwaffnen
disarray	Unordnung
disaster	Katastrophe
disasterous	katastrophal
disastrous	katastrophal
disastrously	katastrophal
disavow	verleugnen
disavowal	Verleugnung
disbelief	Unglaube
disbeliever	Ungläubiger
disclaim	ablehnen
discombobulate	discombobulate
discomfititure	Discomfititure
discomfort	Beschwerden
discompose	discompose
disconcert	beunruhigt
disconcerted	beunruhigt
disconcerting	beunruhigend
disconcertingly	beunruhigend
disconsolate	trostlos
disconsolately	trostlos
disconsolation	Trostlosigkeit
discontent	Unzufriedenheit
discontented	unzufrieden
discontentedly	unzufrieden
discontinued	abgesetzt
discontinuity	Diskontinuität
discontinuous	diskontinuierlich
discord	Zwietracht
discordance	Diskordanz
discordant	diskordant
discountenance	Entlassung
discourage	entmutigen
discouragement	Entmutigung
discouraging	entmutigend
discouragingly	entmutigend
discourteous	unhöflich
discourteously	unhöflich
discoutinous	unverschämt
discredit	diskreditieren
discrepant	auffällig
discriminate	diskriminieren
discrimination	Diskriminierung
discriminatory	diskriminierend
disdain	Verachtung
disdained	verschmäht
disdainful	verächtlich
disdainfully	verächtlich
disfavor	Ungnade
disgrace	Schande
disgraced	blamiert
disgraceful	schändlich
disgracefully	schändlich
disgruntle	verärgert
disgruntled	verärgert
disgusted	angeekelt
disgustedly	angeekelt
disgustful	widerlich
disgustfully	widerlich
disgusting	widerlich
disgustingly	widerlich
dishearten	entmutigen
disheartening	entmutigend
dishearteningly	entmutigend
dishonest	unehrlich
dishonestly	unehrlich
dishonesty	Unehrlichkeit
dishonor	entehren
dishonorable	unehrenhaft
dishonorablely	unehrenhaft
disillusion	Enttäuschung
disillusioned	desillusioniert
disillusionment	Ernüchterung
disillusions	Enttäuschungen
disinclination	Abneigung
disinclined	abgeneigt
disingenuous	unaufrichtig
disingenuously	unaufrichtig
disintegrate	zerfallen
disintegrated	aufgelöst
disintegrates	zerfällt
disintegration	Zerfall
disinterest	Desinteresse
disinterested	desinteressiert
dislikes	Abneigungen
disliking	Abneigung
dislocated	disloziert
disloyal	illoyal
disloyalty	Untreue
dismal	trostlos
dismally	düster
dismalness	Trübheit
dismay	Bestürzung
dismayed	bestürzt
dismaying	bestürzend
dismayingly	erschreckend
dismissive	abweisend
dismissively	abweisend
disobedience	Ungehorsam
disobedient	ungehorsam
disobey	ungehorsam
disoobedient	unbekümmert
disorder	Störung
disordered	ungeordnet
disorderly	ungeordnet
disorganized	desorganisiert
disorient	verwirren
disoriented	desorientiert
disown	verleugnen
disparage	verunglimpfen
disparaging	herabsetzend
disparagingly	herabsetzend
dispensable	entbehrlich
dispirit	entmutigen
dispirited	entmutigt
dispiritedly	entmutigt
dispiriting	entmutigend
displace	verdrängen
displaced	versetzt
displease	missfallen
displeased	unzufrieden
displeasing	unangenehm
displeasure	Unmut
disproportionate	unverhältnismäßig
disprove	widerlegen
disputable	streitbar
dispute	Streit
disputed	umstritten
disquiet	Unruhe
disquieting	beunruhigend
disquietingly	beunruhigend
disquietude	Unruhe
disregardful	ignorant
disreputable	anrüchig
disrepute	Verruf
disrespect	Respektlosigkeit
disrespectable	respektlos
disrespectablity	Respektlosigkeit
disrespectful	respektlos
disrespectfully	respektlos
disrespectfulness	Respektlosigkeit
disrespecting	respektlos
disrupt	stören
disruption	Störung
disruptive	störend
diss	diss
dissapointed	enttäuscht
dissappointed	enttäuscht
dissappointing	enttäuschend
dissatisfaction	Unzufriedenheit
dissatisfactory	unbefriedigend
dissatisfied	unzufrieden
dissatisfies	unbefriedigend
dissatisfying	unbefriedigend
dissed	dissed
dissemble	verbergen
dissembler	Heuchler
dissension	Uneinigkeit
dissent	Dissens
dissenter	Abweichler
dissention	Meinungsverschiedenheit
disservice	Bärendienst
disses	Disse
dissidence	Dissidenz
dissident	Dissident
dissidents	Dissidenten
dissing	dissing
dissocial	dissozial
dissolute	ausschweifend
dissolution	Auflösung
dissonance	Dissonanz
dissonant	dissonant
dissonantly	dissonant
dissuade	abbringen
dissuasive	abschreckend
distains	beharrt
distaste	Abneigung
distasteful	geschmacklos
distastefully	geschmacklos
distort	verzerren
distorted	verzerrt
distortion	Verzerrung
distorts	verzerrt
distract	ablenken
distracting	ablenkend
distraction	Ablenkung
distraught	verstört
distraughtly	verstört
distraughtness	Verzweiflung
distress	Not
distressed	betrübt
distressing	peinlich
distressingly	bedrückend
distrust	Misstrauen
distrustful	misstrauisch
distrusting	misstrauisch
disturb	stören
disturbance	Störung
disturbed	gestört
disturbing	störend
disturbingly	störend
disunity	Uneinigkeit
disvalue	abwerten
divergent	abweichend
divisive	spaltend
divisively	spalterisch
divisiveness	Uneinigkeit
dizzing	schwindlig
dizzingly	schwindlig
dizzy	schwindlig
doddering	matschig
dodgey	dämlich
dogged	verbissen
doggedly	beharrlich
dogmatic	dogmatisch
doldrums	Flaute
domineer	Dominant
domineering	herrschsüchtig
donside	donside
doom	Untergang
doomed	verurteilt
doomsday	Weltuntergang
dope	Dope
doubt	Zweifel
doubtful	zweifelhaft
doubtfully	zweifelhaft
doubts	Zweifel
douchbag	Couchbeutel
douchebag	Dummkopf
douchebags	Spucktüten
downbeat	downbeat
downcast	niedergeschlagen
downer	Wermutstropfen
downfall	Untergang
downfallen	niedergeschlagen
downgrade	Downgrade
downhearted	niedergeschlagen
downheartedly	niedergeschlagen
downhill	bergab
downside	Nachteil
downsides	Nachteile
downturn	Abschwung
downturns	Rückgänge
drab	eintönig
draconian	drakonisch
draconic	drakonisch
drag	ziehen
dragged	gezogen
dragging	Ziehen
dragoon	Dragoner
drags	zieht
drain	ablassen
drained	abgelassen
draining	Entwässerung
drains	Abflüsse
drastic	drastisch
drastically	drastisch
drawback	Nachteil
drawbacks	Nachteile
dread	fürchten
dreadful	furchtbar
dreadfully	schrecklich
dreadfulness	Scheußlichkeit
dreary	trist
dripped	tropfte
dripping	tropft
drippy	drippy
drips	tropft
drones	Drohnen
droop	sinken
droops	dropps
drop-out	aussteigen
drop-outs	Aussteiger
dropout	aussteigen
dropouts	Aussteiger
drought	Dürre
drowning	Ertrinken
drunk	betrunken
drunkard	Säufer
drunken	betrunken
dubious	zweifelhaft
dubiously	zweifelnd
dubitable	verwerflich
dud	Blindgänger
dull	Stumpf
dullard	Dummkopf
dumb	Dumm
dumbfound	verblüffen
dump	ablegen
dumped	abgeladen
dumping	Dumping
dumps	Müllhalden
dunce	Dunce
dungeon	Verlies
dungeons	Verliese
dupe	betrügen
dust	Staub
dusty	staubig
dwindling	schwindet
dying	sterben
earsplitting	ohrenbetäubend
eccentric	Exzenter
eccentricity	Exzentrizität
effigy	Bildnis
effrontery	Unverschämtheit
egocentric	egozentrisch
egomania	Egomanie
egotism	Egoismus
egotistical	egoistisch
egotistically	egoistisch
egregious	ungeheuerlich
egregiously	ungeheuerlich
election-rigger	Wahl-Rigger
elimination	Beseitigung
emaciated	abgemagert
emasculate	entmannen
embarrassing	peinlich
embarrassingly	peinlich
embarrassment	Verlegenheit
embattled	umkämpft
embroil	verwickeln
embroiled	verwickelt
embroilment	Verwicklung
emergency	Notfall
emphatic	nachdrücklich
emptiness	Leere
encroach	eingreifen
encroachment	Eingriff
endanger	gefährden
enemies	Feinde
enemy	Feind
enervate	entnerven
enfeeble	entkräften
enflame	entflammen
engulf	verschlingen
enjoin	gebieten
enmity	Feindschaft
enrage	Wutanfall
enraged	wütend
enraging	aufreibend
enslave	versklaven
entangle	verwickeln
entanglement	Verstrickung
entrap	einfangen
entrapment	Einklemmung
envious	neidisch
enviously	neidisch
enviousness	Missgunst
epidemic	Epidemie
equivocal	zweideutig
erase	löschen
erode	erodieren
erodes	erodiert
erosion	Erosion
err	err
errant	fehlgeleitet
erratic	sprunghaft
erratically	unregelmäßig
erroneous	fehlerhaft
erroneously	fälschlicherweise
error	Error
errors	Fehler
eruptions	Eruptionen
escapade	Eskapade
eschew	vermeiden
estranged	entfremdet
evade	ausweichen
evasion	Ausweichen
evasive	ausweichend
evil	böse
evildoer	Übeltäter
evils	Übel
eviscerate	ausweiden
exacerbate	verschärfen
exagerate	übertreiben
exagerated	übertrieben
exagerates	übertreibt
exaggerate	übertreiben
exaggeration	Übertreibung
exasperate	verzweifelt
exasperated	verärgert
exasperating	ärgerlich
exasperatingly	verzweifelt
exasperation	Verzweiflung
excessive	übermäßig
excessively	übermäßig
exclusion	Ausschluss
excoriate	excoriate
excruciating	quälend
excruciatingly	Quälend
excuse	Ausrede
excuses	Ausreden
execrate	verfluchen
exhaust	Auspuff
exhausted	erschöpft
exhaustion	Erschöpfung
exhausts	Auspuffe
exhorbitant	exorbitant
exhort	ermahnen
exile	Exil
exorbitant	exorbitant
exorbitantance	Exorbitanz
exorbitantly	exorbitant
expel	vertreiben
expensive	teuer
expire	verfallen
expired	abgelaufen
explode	explodieren
exploit	Ausbeuten
exploitation	Ausbeutung
explosive	explosiv
expropriate	enteignen
expropriation	Enteignung
expulse	ausdrücken
expunge	löschen
exterminate	vernichten
extermination	Vernichtung
extinguish	löschen
extort	erpressen
extortion	Erpressung
extraneous	überflüssig
extravagance	Extravaganz
extravagant	extravagant
extravagantly	extravagant
extremism	Extremismus
extremist	Extremist
extremists	Extremisten
eyesore	Schandfleck
fabricate	fabrizieren
fabrication	Herstellung
facetious	witzig
facetiously	witzig
fail	Scheitern
failed	gescheitert
failing	Versagen
failure	Fehler
failures	Fehler
faint	Ohnmacht
fainthearted	kleinmütig
faithless	treulos
fake	Fälschung
fall	fallen
fallacies	Irrtümer
fallacious	trügerisch
fallaciously	trügerisch
fallaciousness	Falschheit
fallacy	Irrtum
fallen	gefallen
falling	fallen
fallout	ausfallen
falls	Stürze
false	falsch
falsehood	Lüge
falsely	fälschlicherweise
falsify	verfälschen
falter	schwanken
faltered	stockte
famine	Hungersnot
famished	ausgehungert
fanatic	Fanatiker
fanatical	fanatisch
fanatically	fanatisch
fanaticism	Fanatismus
fanatics	Fanatiker
fanciful	fantasievoll
farce	Farce
farcical	Farce
farcically	Farce
fascism	Faschismus
fascist	Faschist
fastidious	anspruchsvoll
fastidiously	anspruchsvoll
fastuous	unauffällig
fat	Fett
fatal	tödlich
fatalistic	fatalistisch
fatalistically	fatalistisch
fatally	tödlich
fateful	schicksalhaft
fatefully	schicksalhaft
fathomless	unergründlich
fatigue	ermüden
fatigued	ermüdet
fatique	ermüdend
fatty	fettig
fatuity	Fatuität
fatuous	dämlich
fatuously	mürrisch
fault	Fehler
faults	Fehler
faulty	Defekt
fawningly	schmollend
faze	Faze
fear	Angst
fearful	ängstlich
fearfully	ängstlich
fears	Ängste
fearsome	furchterregend
feckless	Furchtlos
feeble	schwach
feeblely	schwach
feebleminded	schwachsinnig
feign	vortäuschen
feint	Finte
fell	fiel
felon	Schwerverbrecher
felonious	verbrecherisch
ferociously	wild
ferocity	Wildheit
fetid	stinkend
fever	Fieber
feverish	fieberhaft
fevers	Fieber
fiasco	Fiasko
fib	Flunkerei
fibber	Flunkerer
fickle	wankelmütig
fiction	Fiktion
fictional	fiktiv
fictitious	fiktiv
fidget	zappeln
fidgety	zappelig
fiend	Teufel
fiendish	teuflisch
fierce	heftig
figurehead	Galionsfigur
filth	Schmutz
filthy	schmutzig
finagle	finagle
finicky	pingelig
fissures	Risse
fist	Faust
flabbergast	verblüffen
flabbergasted	verblüfft
flagging	Markierung
flagrant	flagrant
flagrantly	schamlos
flair	Flair
flairs	Flairs
flak	Flak
flake	Flocke
flakey	flakey
flakieness	Flockigkeit
flaking	abblätternd
flaky	flockig
flare	Flare
flares	Aufflackern
flareup	Aufflackern
flareups	Aufflackern
flat-out	flat-out
flaw	Fehler
flawed	fehlerhaft
flaws	Fehler
flee	fliehen
fleed	geflohen
fleer	fleer
flees	flieht
fleeting	flüchtig
flicering	Fälschung
flicker	flackern
flickering	flackernd
flickers	flackert
flighty	flatterhaft
flimflam	flimflam
flimsy	dünn
flirt	Flirt
flirty	flirty
floored	platt
flounder	Flunder
floundering	zappelnd
flout	Schmähung
fluster	fluster
foe	Feind
fool	Dummkopf
fooled	reingefallen
foolhardy	tollkühn
foolish	töricht
foolishly	töricht
foolishness	Torheit
forbid	verbieten
forbidden	verboten
forbidding	verbieten
forceful	kräftig
foreboding	Ahnung
forebodingly	ahnungsvoll
forfeit	einbüßen
forged	geschmiedet
forgetful	vergesslich
forgetfully	vergesslich
forgetfulness	Vergesslichkeit
forlorn	verlassen
forlornly	verloren
forsake	verlassen
forsaken	verlassene
forswear	abschwören
foul	Foul
foully	scheußlich
foulness	Unreinheit
fractious	widerspenstig
fractiously	zerstritten
fracture	Fraktur
fragile	zerbrechlich
fragmented	fragmentiert
frail	gebrechlich
frantic	verzweifelt
frantically	verzweifelt
franticly	verzweifelt
fraud	Betrug
fraudulent	betrügerisch
fraught	angespannt
frazzle	zerfetzen
frazzled	erschüttert
freak	Freak
freaking	verdammt
freakish	komisch
freakishly	komisch
freaks	Freaks
freeze	einfrieren
freezing	Einfrieren
frenetic	frenetisch
frenetically	frenetisch
frenzied	rasend
frenzy	Raserei
fret	Bund
fretful	ärgerlich
frets	Bünde
friction	Reibung
frictions	Reibungen
fried	gebraten
friggin	verdammt
frigging	frigierend
fright	Schreck
frighten	erschrecken
frightening	erschreckend
frighteningly	erschreckend
frightful	furchtbar
frightfully	schrecklich
frigid	kalt
frost	Frost
frown	Stirnrunzeln
froze	erstarrte
frozen	gefroren
fruitless	fruchtlos
fruitlessly	fruchtlos
frustrate	vereiteln
frustrated	frustriert
frustrates	frustriert
frustrating	frustrierend
frustratingly	frustrierend
frustration	Frustration
frustrations	Frustrationen
fuck	Scheiße
fucking	Ficken
fudge	Fudge
fugitive	Flüchtling
full-blown	ausgewachsen
fulminate	wettern
fumble	fummeln
fume	Rauch
fumes	Dämpfe
fundamentalism	Fundamentalismus
funky	funky
funnily	komisch
funny	komisch
furious	wütend
furiously	wütend
furor	Furor
fury	Wut
fuss	Aufregung
fussy	pingelig
fustigate	fusigate
fusty	muffig
futile	zwecklos
futilely	vergeblich
futility	Sinnlosigkeit
fuzzy	verschwommen
gabble	Geklapper
gaff	Gaff
gaffe	Fauxpas
gainsay	widersprechen
gainsayer	Gainsayer
gall	Galle
galling	Fressen
gallingly	gellend
galls	Gallen
gangster	Gangster
gape	klaffen
garbage	Müll
garish	grell
gasp	keuchen
gauche	gauche
gaudy	knallig
gawk	gaffen
gawky	schlau
geezer	Knacker
genocide	Völkermord
ghastly	grässlich
ghetto	Ghetto
ghosting	Geisterbilder
gibber	Gibber
gibberish	Kauderwelsch
gibe	Stichelei
giddy	schwindlig
gimmick	Spielerei
gimmicked	Gimmick
gimmicking	Spielerei
gimmicks	Spielereien
gimmicky	Spielerisch
glare	Blendung
glaringly	grell
glib	glib
glibly	glitschig
glitch	Panne
glitches	Glitches
gloatingly	schadenfroh
gloom	Düsternis
gloomy	düster
glower	finsterer
glum	düster
glut	Glut
gnawing	nagend
goad	Ansporn
goading	anstacheln
goof	Dummkopf
goofy	doof
gossip	Klatsch
graceless	gnadenlos
gracelessly	gnadenlos
graft	Transplantat
grainy	körnig
grapple	greifen
grate	Gitter
grating	Gitter
gravely	ernst
greasy	fettig
greed	Gier
greedy	gierig
grief	Trauer
grievance	Beschwerde
grievances	Beschwerden
grieve	trauern
grieving	trauernd
grievous	schwer
grievously	schwerwiegend
grim	grimmig
grimace	Grimasse
grind	schleifen
gripe	meckern
gripes	meckert
grisly	grausig
gritty	grobkörnig
gross	brutto
grossly	grob
grotesque	grotesk
grouch	Griesgram
grouchy	mürrisch
groundless	grundlos
grouse	Schneehuhn
growl	knurren
grudge	Groll
grudges	Groll
grudging	widerwillig
grudgingly	widerwillig
gruesome	grausam
gruesomely	grausam
gruff	schroff
grumble	murren
grumpier	mürrischer
grumpiest	mürrisch
grumpily	mürrisch
grumpish	mürrisch
grumpy	mürrisch
guile	List
guilt	Schuld
guiltily	schuldbewusst
guilty	schuldig
gullible	leichtgläubig
gutless	feige
gutter	Rinne
hack	hacken
hacks	Hacks
haggard	ausgezehrt
haggle	feilschen
hairloss	Haarausfall
halfhearted	halbherzig
halfheartedly	halbherzig
hallucinate	halluzinieren
hallucination	Halluzination
hamper	Korb
hampered	behindert
handicapped	behindert
hang	aufhängen
hangs	hängt
haphazard	planlos
hapless	unglücklich
harangue	harangue
harass	belästigen
harassed	belästigt
harasses	belästigt
harassment	Belästigung
harboring	Beherbergen
harbors	Häfen
hard	hart
hard-liner	Hardliner
hardball	Hardball
harden	härten
hardened	gehärtet
hardheaded	dickköpfig
hardhearted	hartherzig
hardliner	Hardliner
hardliners	Hardliner
hardship	Not
hardships	Härten
harm	Schaden
harmed	Geschädigten
harmful	schädlich
harms	schadet
harpy	Harpyie
harridan	Vettel
harried	bedrängt
harrow	Egge
harsh	hart
harshly	hart
hasseling	Hasseling
hassle	Ärger
hassled	bedrängt
hassles	Ärger
haste	Eile
hastily	hastig
hasty	hastig
hate	Hass
hated	gehasst
hateful	hasserfüllt
hatefully	hasserfüllt
hatefulness	Hass
hater	Hasser
haters	Hasser
hates	hasst
hating	hassen
hatred	Hass
haughtily	hochmütig
haughty	hochmütig
haunt	verfolgen
haunting	Spuk
havoc	Verwüstung
hawkish	Falken
hazard	Gefahr
hazardous	gefährlich
haze	Dunst
hazy	dunstig
head-aches	Kopfschmerzen
headache	Kopfschmerzen
headaches	Kopfschmerzen
heartbreaker	Herzensbrecher
heartbreaking	herzzerreißend
heartbreakingly	herzzerreißend
heartless	herzlos
heathen	Heiden-
heavy-handed	schwerfällig
heck	Teufel
heckle	Zwischenruf
heckled	Zwischenrufe
heckles	Zwischenrufe
hectic	hektisch
hedge	Hecke
hedonistic	hedonistisch
heedless	achtlos
hefty	kräftig
hegemonism	Hegemonismus
hegemonistic	hegemonistisch
hegemony	Hegemonie
heinous	abscheulich
hell	Hölle
hellion	Hölle
hells	Höllen
helpless	hilflos
helplessly	hilflos
helplessness	Hilflosigkeit
heresy	Ketzerei
heretic	Ketzer
heretical	ketzerisch
hesitant	zögerlich
hestitant	hesitant
hideous	abscheulich
hideously	scheußlich
hideousness	Scheußlichkeit
high-priced	hochpreisig
hiliarious	anhänglich
hinder	behindern
hindrance	Hindernis
hiss	zischen
hissed	zischte
hissing	zischend
ho-hum	ho-hum
hoard	horten
hoax	Scherz
hobble	humpeln
hogs	Schweine
hollow	hohl
hoodium	Hoodium
hoodwink	hoodwink
hooligan	Rowdy
hopeless	hoffnungslos
hopelessly	hoffnungslos
hopelessness	Hoffnungslosigkeit
horde	Horde
horrendous	schrecklich
horrendously	horrend
horrible	schrecklich
horrid	schrecklich
horrific	entsetzlich
horrified	entsetzt
horrifies	entsetzt
horrify	entsetzen
horrifying	erschreckend
horrifys	Horror
hostage	Geisel
hostile	feindlich
hostilities	Feindseligkeiten
hostility	Feindseligkeit
hotbeds	Brutstätten
hothead	Hitzkopf
hotheaded	hitzköpfig
hothouse	Treibhaus
hubris	Hybris
huckster	Hausierer
hum	summen
humid	feucht
humiliate	demütigen
humiliating	erniedrigend
humiliation	Erniedrigung
humming	summend
hung	aufgehängt
hurt	verletzt
hurted	verletzt
hurtful	verletzend
hurting	verletzt
hustler	Gauner
hype	Hype
hypocricy	Heuchelei
hypocrisy	Heuchelei
hypocrite	Heuchler
hypocrites	Heuchler
hypocritical	heuchlerisch
hypocritically	heuchlerisch
hysteria	Hysterie
hysteric	Hysteriker
hysterical	hysterisch
hysterically	hysterisch
hysterics	Hysterie
idiocies	Idiotien
idiocy	Idiotie
idiot	Dummkopf
idiotic	idiotisch
idiotically	idiotisch
idiots	Idioten
idle	Leerlauf
ignoble	unwürdig
ignominious	schmählich
ignominiously	schmählich
ignominy	Schmach
ignorance	Ignoranz
ignorant	ignorant
ignore	ignorieren
ill-fated	unglücklich
ill-favored	benachteiligt
ill-mannered	unartig
ill-natured	schlechtmütig
ill-treated	misshandelt
ill-treatment	Misshandlung
ill-usage	Mißbrauch
illegal	illegal
illegally	illegal
illegitimate	illegitim
illicit	illegal
illiterate	Analphabet
illness	Krankheit
illogic	unlogisch
illogical	unlogisch
illogically	unlogisch
illusion	Illusion
illusions	Illusionen
illusory	illusorisch
imaginary	imaginär
imbalance	Ungleichgewicht
imbecile	Unfruchtbar
imbroglio	Verwirrung
immaterial	immateriell
immature	unreif
imminence	drohend
immobilized	immobilisiert
immoderate	maßlos
immoderately	unangemessen
immodest	unbescheiden
immoral	unmoralisch
immorality	Unmoral
immorally	unmoralisch
immovable	unbeweglich
impair	beeinträchtigen
impaired	beeinträchtigte
impasse	Sackgasse
impatience	Ungeduld
impatient	ungeduldig
impatiently	ungeduldig
impeach	anklagen
impedance	Impedanz
impede	behindern
impediment	Behinderung
impending	drohend
impenitent	unbußfertig
imperfect	unvollkommen
imperfection	Unvollkommenheit
imperfections	Unvollkommenheiten
imperfectly	unvollständig
imperialist	imperialistisch
imperil	gefährden
imperious	herrisch
imperiously	herrisch
impermissible	unzulässig
impersonal	unpersönlich
impertinent	unverschämt
impetuous	ungestüm
impetuously	ungestüm
impiety	Gottlosigkeit
impinge	auftreffen
impious	gottlos
implacable	unerbittlich
implausible	unglaubwürdig
implausibly	unplausibel
implicate	implizieren
implication	Implikation
implode	implodieren
impolite	unhöflich
impolitely	unhöflich
impolitic	unklug
importunate	aufdringlich
importune	belästigen
impose	auferlegen
imposers	Betrüger
imposing	imposant
imposition	Verhängung
impossible	unmöglich
impossiblity	Unmöglichkeit
impossibly	unmöglich
impotent	impotent
impoverish	verarmt
impoverished	verarmt
impractical	unpraktisch
imprecate	verfluchen
imprecise	ungenau
imprecisely	ungenau
imprecision	Ungenauigkeit
imprison	einsperren
imprisonment	Haft
improbability	Unwahrscheinlichkeit
improbable	unwahrscheinlich
improbably	unwahrscheinlich
improper	ungeeignet
improperly	falsch
impropriety	Unschicklichkeit
imprudence	Unvorsichtigkeit
imprudent	unklug
impudence	Frechheit
impudent	unverschämt
impudently	frech
impugn	impugn
impulsive	treibend
impulsively	impulsiv
impunity	Straflosigkeit
impure	unrein
impurity	Verunreinigung
inability	Unfähigkeit
inaccuracies	Ungenauigkeiten
inaccuracy	Ungenauigkeit
inaccurate	ungenau
inaccurately	ungenau
inaction	Untätigkeit
inactive	inaktiv
inadequacy	Unzulänglichkeit
inadequate	unzureichend
inadequately	unzureichend
inadverent	versehentlich
inadverently	versehentlich
inane	albern
inanely	unverschämt
inappropriate	ungeeignet
inappropriately	unpassend
inapt	unpassend
inaptitude	Unfähigkeit
inarticulate	unartikuliert
inattentive	unaufmerksam
inaudible	unverständlich
incapable	unfähig
incapably	unfähig
incautious	unvorsichtig
incendiary	Brandstiftung
incense	Weihrauch
incessant	unaufhörlich
incessantly	unaufhörlich
incite	anregen
incitement	Anstiftung
incivility	Unhöflichkeit
inclement	unfreundlich
incognizant	inkognizant
incoherence	Zusammenhanglosigkeit
incoherent	inkohärent
incoherently	zusammenhanglos
incommensurate	unverhältnismäßig
incomparable	unvergleichbar
incomparably	unvergleichlich
incompatability	Inkompatibilität
incompatibility	Unvereinbarkeit
incompatible	unvereinbar
incompetence	Inkompetenz
incompetent	inkompetent
incompetently	inkompetent
incomplete	unvollständig
incomprehensible	unverständlich
incomprehension	Unverständnis
inconceivable	undenkbar
inconceivably	unvorstellbar
incongruous	unpassend
incongruously	unpassend
inconsequent	inkonsequent
inconsequential	belanglos
inconsequentially	inkonsequent
inconsequently	inkonsequent
inconsiderate	rücksichtslos
inconsiderately	rücksichtslos
inconsistence	Inkonsistenz
inconsistencies	Inkonsistenzen
inconsistency	Inkonsistenz
inconsistent	inkonsistent
inconsolable	untröstlich
inconsolably	untröstlich
inconstant	unbeständig
inconvenience	Unbequemlichkeit
inconveniently	ungünstig
incorrect	falsch
incorrectly	falsch
incorrigible	unverbesserlich
incorrigibly	unverbesserlich
incredulous	ungläubig
incredulously	ungläubig
inculcate	einschätzen
indecency	Unanständigkeit
indecent	unanständig
indecently	unanständig
indecision	Unentschlossenheit
indecisive	unentschlossen
indecisively	unentschlossen
indecorum	Indecorum
indelicate	unfein
indeterminable	unbestimmbar
indeterminably	unbestimmbar
indeterminate	unbestimmt
indifference	Gleichgültigkeit
indifferent	gleichgültig
indigent	bedürftig
indignant	empört
indignantly	empört
indignation	Empörung
indignity	Demütigung
indiscreet	indiskret
indiscreetly	indiskret
indiscretion	Indiskretion
indiscriminate	unterschiedslos
indiscriminately	wahllos
indiscriminating	wahllos
indoctrinate	indoktrinieren
indoctrination	Indoktrination
indolent	träge
indulge	hingeben
ineffective	unwirksam
ineffectively	unwirksam
ineffectiveness	Unwirksamkeit
ineffectual	unwirksam
ineffectually	ineffektiv
ineffectualness	Unwirksamkeit
inefficacious	unwirksam
inefficacy	Unwirksamkeit
inefficiency	Ineffizienz
inefficient	ineffizient
inefficiently	ineffizient
inelegance	Uneleganz
inelegant	unelegant
ineloquent	unschlüssig
ineloquently	ungenau
inept	ungeschickt
ineptitude	Unbeholfenheit
ineptly	unfähig
inequalities	Ungleichheiten
inequality	Ungleichheit
inequitable	ungerecht
inequitably	ungerechtfertigt
inequities	Ungerechtigkeiten
inescapable	unausweichlich
inescapably	unausweichlich
inessential	unwesentlich
inevitable	unvermeidlich
inevitably	zwangsläufig
inexcusable	unentschuldbar
inexcusably	unentschuldbar
inexorable	unerbittlich
inexorably	unerbittlich
inexperience	Unerfahrenheit
inexperienced	unerfahren
inexpert	unerfahren
inexpertly	unsachgemäß
inexpiable	unzuverlässig
inexplainable	unerklärlich
inextricable	unentwirrbar
inextricably	untrennbar
infamous	berüchtigt
infamously	berauschend
infamy	Schande
infected	infiziert
infection	Infektion
infections	Infektionen
inferior	minderwertig
inferiority	Minderwertigkeit
infernal	höllisch
infest	befallen
infested	befallen
infidel	ungläubig
infidels	Ungläubige
infiltrator	Eindringling
infiltrators	Eindringlinge
infirm	gebrechlich
inflame	entflammen
inflammation	Entzündung
inflammatory	entzündlich
inflammed	entzündet
inflated	aufgeblasen
inflationary	inflationär
inflexible	unflexibel
inflict	zufügen
infraction	Übertretung
infringe	verletzen
infringement	Verletzung
infringements	Verstöße
infuriate	wütend
infuriated	wütend
infuriating	ärgerlich
infuriatingly	aufreizend
inglorious	unrühmlich
ingrate	Undankbare
ingratitude	Undankbarkeit
inhibit	hemmen
inhibition	Hemmung
inhospitable	unwirtlich
inhuman	unmenschlich
inhumane	unmenschlich
inhumanity	Unmenschlichkeit
inimical	feindlich
inimically	feindlich
iniquitous	ungerecht
iniquity	Ungerechtigkeit
injudicious	unklug
injure	verletzen
injurious	schädlich
injury	Verletzung
injustice	Ungerechtigkeit
injustices	Ungerechtigkeiten
innuendo	Anspielung
inoperable	inoperabel
inopportune	unpassend
inordinate	übermäßig
inordinately	unangemessen
insane	wahnsinnig
insanely	wahnsinnig
insanity	Wahnsinn
insatiable	unersättlich
insecure	unsicher
insecurity	Unsicherheit
insensible	unempfindlich
insensitive	unempfindlich
insensitively	unsensibel
insensitivity	Unempfindlichkeit
insidious	heimtückisch
insidiously	heimtückisch
insignificance	Bedeutungslosigkeit
insignificant	unbedeutend
insignificantly	unbedeutend
insincere	unaufrichtig
insincerely	unaufrichtig
insincerity	Unaufrichtigkeit
insinuate	unterstellen
insinuating	anzüglich
insinuation	Unterstellung
insociable	unbegreiflich
insolence	Unverschämtheit
insolent	frech
insolently	unverschämt
insolvent	zahlungsunfähig
insouciance	Sorglosigkeit
instability	Instabilität
instable	instabil
instigate	anstiften
instigator	Anstifter
instigators	Anstifter
insubordinate	ungehorsam
insubstantial	unwesentlich
insubstantially	unwesentlich
insufferable	unerträglich
insufferably	unerträglich
insufficiency	Insuffizienz
insufficient	unzureichend
insufficiently	ungenügend
insular	insular
insult	Beleidigung
insulted	beleidigt
insulting	beleidigend
insultingly	beleidigend
insults	Beleidigungen
insupportable	unerträglich
insupportably	unerträglich
insurmountable	unüberwindbar
insurmountably	unüberwindbar
insurrection	Aufstand
intefere	interferieren
inteferes	interferiert
intense	heftig
interfere	stören
interference	Interferenz
interferes	stört
intermittent	wechselnd
interrupt	unterbrechen
interruption	Unterbrechung
interruptions	Unterbrechungen
intimidate	einschüchtern
intimidating	einschüchternd
intimidatingly	einschüchternd
intimidation	Einschüchterung
intolerable	unerträglich
intolerablely	unerträglich
intolerance	Intoleranz
intoxicate	berauschen
intractable	hartnäckig
intransigence	Unnachgiebigkeit
intransigent	unnachgiebig
intrude	eindringen
intrusion	Einbruch
intrusive	aufdringlich
inundate	überschwemmen
inundated	überschwemmt
invader	Eindringling
invalid	ungültig
invalidity	Nichtigkeit
invasive	invasiv
invective	Schmähung
inveigle	verleiten
invidious	gehässig
invidiously	hinterhältig
invidiousness	Unverschämtheit
invisible	unsichtbar
involuntarily	unwillkürlich
involuntary	unfreiwillig
irascible	jähzornig
irate	wütend
irately	zornig
ire	Ire
irk	ärgern
irked	verärgert
irking	ärgerlich
irks	ärgert
irksome	lästig
irksomely	ärgerlich
irksomeness	Lästigkeit
irksomenesses	Unannehmlichkeiten
ironic	ironisch
ironical	ironisch
ironically	ironisch
ironies	Ironien
irony	Ironie
irragularity	Irragularität
irrational	irrational
irrationalities	Irrationalitäten
irrationality	Irrationalität
irrationally	irrational
irrationals	Irrationales
irreconcilable	unvereinbar
irrecoverable	uneinbringlich
irrecoverableness	Unwiederbringlichkeit
irrecoverablenesses	Unwiederbringlichkeit
irrecoverably	unwiederbringlich
irredeemable	unkündbar
irredeemably	unkündbar
irregular	irregulär
irregularity	Unregelmäßigkeit
irrelevance	Irrelevanz
irrelevant	irrelevant
irreplacible	irreparabel
irresolute	unentschlossen
irresolvable	unlösbar
irresponsible	unverantwortlich
irresponsibly	unverantwortlich
irretating	irretating
irretrievable	unwiederbringlich
irreversible	irreversibel
irritable	reizbar
irritably	gereizt
irritant	reizend
irritate	reizen
irritated	irritiert
irritating	irritierend
irritation	Reizung
irritations	Irritationen
isolate	isolieren
isolated	isoliert
isolation	Isolierung
issue	Problem
issues	Probleme
itch	jucken
itching	Juckreiz
itchy	juckt
jabber	quasseln
jaded	abgestumpft
jagged	gezackt
jam	Marmelade
jarring	erschütternd
jaundiced	Gelbsucht
jealous	eifersüchtig
jealously	eifersüchtig
jealousness	Eifersucht
jealousy	Eifersucht
jeer	höhnisch
jeering	höhnisch
jeeringly	jubelnd
jeers	Spott
jeopardize	gefährden
jeopardy	Gefahr
jerk	Trottel
jerky	ruckartig
jitter	Jitter
jitters	Bammel
jittery	nervös
job-killing	Job-Tötung
jobless	arbeitslos
joke	Scherz
joker	Joker
jolt	Ruck
judder	judder
juddering	judging
judders	Judder
jumpy	nervös
junk	Müll
junky	Schrott
junkyard	Schrottplatz
jutter	Jutter
jutters	jutters
kaput	kaputt
kill	töten
killed	getötet
killer	Mörder
killing	Tötung
killjoy	Killjoy
kills	tötet
knave	Bube
knife	Messer
knock	klopfen
knotted	verknotet
kook	Kook
kooky	verrückten
lack	Mangel
lackadaisical	läppisch
lacked	fehlte
lackey	Lakai
lackeys	Lakaien
lacking	fehlt
lackluster	glanzlos
lacks	fehlt
laconic	lakonisch
lag	Verzögerung
lagged	zurückgeblieben
lagging	hinken
laggy	laggy
lags	Verzögerungen
laid-off	entlassen
lambast	Lammfleisch
lame	Lame
lament	Klage
lamentable	beklagenswert
lamentably	beklagenswert
languid	matt
languish	schmachten
languor	Mattigkeit
languorous	schläfrig
languorously	träge
lanky	schlaksig
lapse	Ablauf
lapsed	abgelaufen
lapses	verfällt
lascivious	lasziv
last-ditch	Last-Graben
latency	Latenz
laughable	lächerlich
laughably	lächerlich
laughingstock	Gespött
lawbreaker	Gesetzesbrecher
lawbreaking	Gesetzesbrecher
lawless	gesetzlos
lawlessness	Gesetzlosigkeit
layoff	entlassen
layoff-happy	Entlassung-glücklich
lazy	faul
leak	Leck
leakage	Leckage
leakages	Leckagen
leaking	undicht
leaks	Lecks
leaky	undicht
lech	lech
lecher	Wüstling
lecherous	geil
lechery	Geilheit
leech	Blutegel
leer	leer
leery	misstrauisch
lemon	Zitrone
lengthy	lang
letch	letsch
lethal	tödlich
lethargic	lethargisch
lethargy	Lethargie
lewd	Lewd
lewdly	lüstern
lewdness	Lüsternheit
liability	Haftung
liable	haftbar
liar	Lügner
liars	Lügner
licentious	ausschweifend
licentiously	ausschweifend
licentiousness	Zügellosigkeit
lie	Lüge
lied	gelogen
lier	Lügner
lies	Lügen
life-threatening	lebensbedrohlich
lifeless	leblos
limit	Grenze
limitation	Einschränkung
limitations	Einschränkungen
limited	begrenzt
limits	Grenzen
limp	schlaff
listless	lustlos
litigious	streitsüchtig
livid	wütend
lividly	lebhaft
loath	abgeneigt
loathe	verabscheuen
loathing	Abscheu
loathly	abscheulich
loathsome	abscheulich
loathsomely	widerwärtig
lone	einsam
loneliness	Einsamkeit
lonely	einsam
loner	Einzelgänger
lonesome	einsam
long-winded	langatmig
longing	Sehnsucht
longingly	sehnsüchtig
loophole	Schlupfloch
loopholes	Schlupflöcher
loose	lose
loot	Beute
lorn	Lorn
lose	verlieren
loser	Verlierer
losers	Verlierer
loses	verliert
loss	Verlust
losses	Verluste
loud	laut
louder	lauter
lousy	lausig
loveless	lieblos
lovelorn	Liebeskummer
lowly	niedrig
ludicrous	lächerlich
ludicrously	lächerlich
lugubrious	schwermütig
lukewarm	lauwarm
lull	Flaute
lumpy	klumpig
lunatic	verrückt
lunaticism	Irrsinn
lurch	Stich
lure	locken
lurid	reißerisch
lurk	lauern
lurking	lauernd
lying	lügen
macabre	makaber
mad	wütend
maddeningly	unerträglich
madder	Krapp
madly	verrückt
madman	Verrückter
madness	Wahnsinn
maladjusted	unangepasst
maladjustment	Fehlanpassung
malady	Krankheit
malaise	Unwohlsein
malcontent	unzufrieden
malcontented	unzufrieden
maledict	Maledikt
malevolence	Böswilligkeit
malevolent	böswillig
malevolently	böswillig
malice	Bosheit
malicious	bösartig
maliciously	böswillig
maliciousness	Bösartigkeit
malign	verleumden
malignant	maligne
malodorous	übelriechend
maltreatment	Misshandlung
mangle	Mangel
mangled	verstümmelt
mangles	Mangeln
mangling	Mangling
mania	Manie
maniac	Wahnsinniger
maniacal	wahnsinnig
manic	manisch
manipulate	manipulieren
manipulation	Manipulation
manipulative	manipulativ
manipulators	Manipulatoren
mar	beschädigen
marginal	marginal
marginally	geringfügig
martyrdom	Martyrium
martyrdom-seeking	Märtyrer-Suche
mashed	püriert
massacre	Massaker
massacres	Massaker
matte	matt
mawkish	Mawkisch
mawkishly	mürrisch
mawkishness	Rührseligkeit
meager	dürftig
meaningless	bedeutungslos
meanness	Gemeinheit
measly	schäbig
meddlesome	aufdringlich
mediocre	mittelmäßig
mediocrity	Mittelmäßigkeit
melancholy	Melancholie
melodramatic	melodramatisch
melodramatically	melodramatisch
meltdown	Kernschmelze
menace	Bedrohung
menacing	bedrohlich
menacingly	bedrohlich
mendacious	verlogen
mendacity	Verlogenheit
menial	niedere
merciless	gnadenlos
mercilessly	gnadenlos
mess	Chaos
messed	durcheinander
messes	Durcheinander
messing	Verwirrung
messy	unordentlich
midget	Zwerg
miff	Miff
militancy	Militanz
mindless	geistlos
mindlessly	gedankenlos
mire	Schlamm
misaligned	verstellt
misapprehend	missverstehen
misbecoming	Missverständnis
misbehavior	Fehlverhalten
miscalculation	Fehlkalkulation
miscellaneous	Sonstiges
mischief	Unfug
mischievous	boshaft
mischievously	verschmitzt
misconception	Missverständnis
misconceptions	Missverständnisse
miscreant	Bösewicht
miscreants	Schurken
misdirection	Fehlleitung
miser	Geizhals
miserable	elend
miserableness	Armseligkeit
miserably	kläglich
miseries	Elend
miserly	geizig
misery	Elend
misfit	Außenseiter
misfortune	Unglück
misgiving	Bedenken
misgivings	Bedenken
misguidance	Irreführung
misguide	verleiten
misguided	fehlgeleitet
mishandle	misshandeln
mishap	Missgeschick
misinform	fehlinformieren
misjudge	verkennen
misjudgment	Fehleinschätzung
mislead	irreführen
misleading	irreführend
misleadingly	irreführend
mislike	falsch
mispronounces	Fehltritte
miss	Fräulein
missed	verpasst
misses	vermisst
mist	Nebel
mistake	Fehler
mistaken	verwechselt
mistakenly	fälschlicherweise
mistakes	Fehler
mistified	verunstaltet
mistress	Herrin
mistrust	Misstrauen
mistrustful	misstrauisch
mistrustfully	misstrauisch
mists	Nebel
misunderstand	missverstehen
misunderstanding	Missverständnis
misunderstandings	Missverständnisse
misuse	Missbrauch
moan	Stöhnen
mobster	Gangster
mock	spotten
mocked	verspottet
mockeries	Spötteleien
mockery	Spott
mocking	Verspottung
mockingly	spöttisch
mocks	Spott
molest	belästigen
molestation	Belästigung
monotonous	eintönig
monotony	Monotonie
monster	Monster-
monstrosities	Monstrositäten
monstrosity	Ungeheuerlichkeit
monstrous	monströs
monstrously	monströs
moody	launisch
moot	strittig
morbid	morbid
morbidly	krankhaft
mordant	Beize
mordantly	mürrisch
moribund	moribund
moron	Trottel
moronic	schwachsinnig
morons	Idioten
mortification	Demütigung
mortified	beschämt
mortify	vernichtend
mortifying	beschämend
motionless	bewegungslos
motley	bunt
mourn	trauern
mourner	Trauernde
mournful	traurig
mournfully	traurig
muddle	Durcheinander
muddy	schlammig
mudslinger	Verleumder
mudslinging	Schlammschlacht
mulish	störrisch
multi-polarization	Multi-Polarisation
mundane	banal
murder	Mord
murderer	Mörder
murderous	mörderisch
murderously	mörderisch
murky	trübe
muscle-flexing	Muskelflexion
mushy	matschig
musty	muffig
mysterious	geheimnisvoll
mysteriously	geheimnisvoll
mystery	Geheimnis
mystify	verwirren
myth	Mythos
nag	Gaul
nagging	Gezeter
naive	naiv
naively	naiv
narrower	schmaler
nastily	böse
nastiness	Gemeinheit
nasty	böse
naughty	frech
nauseate	ekeln
nauseates	Übelkeit
nauseating	widerlich
nauseatingly	widerlich
naïve	naiv
nebulous	nebulös
nebulously	nebulös
needless	unnötig
needlessly	unnötigerweise
needy	Bedürftige
nefarious	schändlich
nefariously	schändlich
negate	negieren
negation	Negation
negative	Negativ
negatives	Negative
negativity	Negativität
neglect	vernachlässigen
neglected	vernachlässigt
negligence	Fahrlässigkeit
negligent	fahrlässig
nemesis	Nemesis
nepotism	Vetternwirtschaft
nervous	nervös
nervously	nervös
nervousness	Nervosität
nettle	Nessel
nettlesome	nett
neurotic	neurotisch
neurotically	neurotisch
niggle	nickeln
niggles	Nigger
nightmare	Albtraum
nightmarish	alptraumhaft
nightmarishly	alptraumhaft
nitpick	Nitpick
nitpicking	pingelig
noise	Lärm
noises	Geräusche
noisier	lauter
noisy	laut
non-confidence	Nicht-Vertrauen
nonsense	Unsinn
nosey	neugierig
notoriety	Bekanntheit
notorious	berüchtigt
notoriously	notorisch
noxious	schädlich
nuisance	Ärgernis
numb	betäuben
obese	fettleibig
object	Objekt
objection	Einwand
objectionable	anstößig
objections	Einwände
oblique	schräg
obliterate	auslöschen
obliterated	ausgelöscht
obnoxious	anstößig
obnoxiously	widerlich
obscene	obszön
obscenely	obszön
obscenity	Obszönität
obscure	obskur
obscured	verdunkelt
obscures	verdunkelt
obscurity	Dunkelheit
obsess	Besessenheit
obsessive	obsessiv
obsessively	besessen
obsessiveness	Obsessivität
obsolete	obsolet
obstacle	Hindernis
obstinate	hartnäckig
obstinately	hartnäckig
obstruct	behindern
obstructed	behindert
obstructing	behindernd
obstruction	Obstruktion
obstructs	behindert
obtrusive	aufdringlich
obtuse	stumpf
occlude	verschließen
occluded	okkludiert
occludes	verschließt
occluding	verdeckend
odd	ungerade
odder	seltsam
oddest	seltsamste
oddities	Kuriositäten
oddity	Kuriosität
oddly	seltsam
odor	Geruch
offence	Delikt
offend	beleidigen
offender	Täter
offending	beleidigend
offenses	Straftaten
offensive	beleidigend
offensively	offensiv
offensiveness	Anstößigkeit
officious	dienstbar
ominous	ominös
ominously	bedrohlich
omission	Unterlassung
omit	auslassen
one-sided	einseitig
onerous	beschwerlich
onerously	eifersüchtig
onslaught	Ansturm
opinionated	rechthaberisch
opponent	Gegner
opportunistic	opportunistisch
oppose	ablehnen
opposition	Opposition
oppositions	Oppositionen
oppress	unterdrücken
oppression	Unterdrückung
oppressive	bedrückend
oppressively	drückend
oppressiveness	Unterdrückung
oppressors	Unterdrücker
ordeal	Tortur
orphan	Waise
ostracize	ächten
outbreak	Ausbruch
outburst	Ausbruch
outbursts	Ausbrüche
outcast	Ausgestoßener
outcry	Aufschrei
outlaw	verbieten
outmoded	veraltet
outrage	Empörung
outraged	empört
outrageous	empörend
outrageously	unverschämt
outrageousness	Unverschämtheit
outrages	empört
outsider	Außenseiter
over-acted	überbetont
over-awe	einschüchtern
over-hyped	überhyped
over-priced	überteuert
over-valuation	Überbewertung
overact	übertreiben
overacted	überzeichnet
overawe	einschüchtern
overbalance	Übergewicht
overbalanced	ausbalanciert
overbearing	anmaßend
overbearingly	herrisch
overblown	übertrieben
overdo	übertreiben
overdone	übertrieben
overdue	überfällig
overemphasize	überbetonen
overheat	überhitzen
overkill	Overkill
overloaded	überladen
overlook	übersehen
overpaid	überbezahlt
overpayed	überbezahlt
overplay	überspielen
overpower	überwältigen
overpriced	überteuert
overrated	überbewertet
overreach	Überreichweite
overrun	überrannt
overshadow	überschatten
oversight	Aufsicht
oversights	Versehen
oversimplification	Übervereinfachung
oversize	Übergröße
overstate	übertreiben
overstated	übertrieben
overstatement	Übertreibung
overstatements	Übertreibungen
overstates	übertreibt
overtaxed	überfordert
overthrow	Sturz
overturn	umkippen
overweight	Übergewicht
overwhelm	überwältigen
overwhelmed	überwältigt
overwhelming	überwältigend
overwhelmingly	überwältigend
overwhelms	überwältigt
overzealous	übereifrig
overzealously	übereifrig
overzelous	überbelichtet
pain	Schmerzen
painful	schmerzlich
painfull	schmerzhaft
painfully	schmerzlich
pains	Schmerzen
pale	blass
pales	verblasst
paltry	armselig
pan	Pfanne
pandemonium	Pandämonium
pander	Kuppler
pandering	pending
panders	Pfänder
panic	Panik
panick	Panik
panicky	panisch
paradoxical	paradox
paradoxically	paradoxerweise
paralize	paralisieren
paralyzed	gelähmt
paranoia	Paranoia
paranoid	paranoid
parasite	Parasit
pariah	Paria
parody	Parodie
partiality	Parteilichkeit
partisan	Partisan
partisans	Partisanen
passe	passe
passive	passiv
passiveness	Passivität
pathetic	erbärmlich
pathetically	pathetisch
patronize	bevormunden
paucity	Mangel
pauper	Armer
paupers	Arme
payback	Rückzahlung
peculiar	eigenartig
peculiarly	besonders
pedantic	pedantisch
peeled	geschält
peeve	ärgern
peeved	verärgert
peevish	mürrisch
peevishly	mürrisch
penalize	bestrafen
penalty	Elfmeter
perfidious	perfide
perfidity	Perfidität
perfunctory	oberflächlich
peril	Tücke
perilous	gefährlich
perilously	gefährlich
perish	umkommen
pernicious	verderblich
perplex	verwirren
perplexed	verwirrt
perplexing	verblüffend
perplexity	Verwirrung
persecute	verfolgen
persecution	Verfolgung
pertinacious	hartnäckig
pertinaciously	hartnäckig
pertinacity	Hartnäckigkeit
perturb	stören
perturbed	beunruhigt
perverse	pervers
perversely	pervers
perversion	Perversion
perversity	Perversität
pervert	pervers
perverted	pervertiert
perverts	pervers
pessimism	Pessimismus
pessimistic	pessimistisch
pessimistically	pessimistisch
pest	Pest
pestilent	pestlos
petrified	versteinert
petrify	versteinern
pettifog	pettifog
petty	kleinlich
phobia	Phobie
phobic	phobisch
phony	falsch
picket	Streikposten
picketed	gepickt
picketing	Streikposten
pickets	Streikposten
picky	wählerisch
pig	Schwein
pigs	Schweine
pillage	plündern
pillory	Pranger
pimple	Pickel
pinch	Prise
pique	pique
pitiable	erbärmlich
pitiful	erbärmlich
pitifully	kläglich
pitiless	erbarmungslos
pitilessly	unbarmherzig
pittance	Almosen
plagiarize	plagiieren
plague	Pest
plasticky	plasticky
plaything	Spielzeug
plea	Plädoyer
pleas	Bitten
plebeian	Plebejer
plight	Notlage
plot	Handlung
plotters	Plotter
ploy	Trick
plunder	Plunder
plunderer	Plünderer
pointless	zwecklos
pointlessly	sinnlos
poison	Gift
poisonous	giftig
poisonously	giftig
pokey	Stichel
poky	winzig
polarisation	Polarisation
polemize	polemisieren
pollute	verschmutzen
polluter	Verursacher
polluters	Verschmutzer
polution	Verschmutzung
pompous	pompös
poor	Arm
poorer	ärmer
poorest	ärmsten
poorly	schlecht
posturing	posierend
pout	Schmollmund
poverty	Armut
powerless	machtlos
prate	schwafeln
pratfall	Pratfall
prattle	Geschwätz
precarious	prekär
precariously	unsicher
precipitate	Präzipitat
precipitous	steil
predatory	räuberisch
predicament	Dilemma
prejudge	vorurteils
prejudice	Vorurteil
prejudices	Vorurteile
prejudicial	abträglich
premeditated	vorsätzlich
preoccupy	beschäftigen
preposterous	absurd
preposterously	grotesk
presumptuous	anmaßend
presumptuously	mutwillig
pretence	Vorwand
pretense	Vorwand
pretentious	protzig
pretentiously	protzig
prevaricate	voreilig
pricey	teuer
pricier	teurer
prick	Stechen
prickle	Prickeln
prickles	Stacheln
prideful	stolz
prik	Prik
primitive	Primitive
prison	Gefängnis
prisoner	Häftling
problem	Problem
problematic	problematisch
problems	Probleme
procrastinate	zögern
procrastination	Aufschub
profane	entweihen
profanity	Profanität
prohibit	verbieten
prohibitive	unerschwinglich
prohibitively	prohibitiv
propaganda	Propaganda
propagandize	propagieren
proprietary	Eigentum
prosecute	verfolgen
protest	Protest
protested	protestierte
protesting	protestierend
protests	Proteste
protracted	langwierig
provocation	Provokation
provocative	provokativ
provoke	provozieren
pugnacious	streitsüchtig
pugnaciously	kampflustig
pugnacity	Kampflust
punch	schlagen
punish	bestrafen
punishable	strafbar
punitive	strafend
punk	Punk
puny	mickrig
puppet	Marionette
puppets	Puppen
puzzled	verwirrt
puzzlement	Verwirrung
puzzling	rätselhaft
quack	Quacksalber
qualm	Bedenken
qualms	Bedenken
quandary	Dilemma
quarrel	Streit
quarrellous	streitsüchtig
quarrellously	streitsüchtig
quarrels	Streitigkeiten
quarrelsome	zänkisch
quash	quetschen
queer	schwul
questionable	fraglich
quibble	knabbern
quibbles	Knabbereien
quitter	Drückeberger
rabid	tollwütig
racism	Rassismus
racist	Rassist
racists	Rassisten
racy	rassig
radical	Radikale
radicalization	Radikalisierung
radically	radikal
radicals	Radikale
rage	Rage
ragged	zottig
raging	tobend
rail	Schiene
raked	geharkt
rampage	Amoklauf
rampant	grassierend
ramshackle	baufällig
rancor	Rancor
rankle	rangeln
rant	schimpfen
ranted	schimpfte
ranting	schimpfend
rantingly	schimpfend
rants	Gerüchte
rape	vergewaltigen
raped	vergewaltigt
raping	vergewaltigen
rascal	Schlingel
rascals	Schurken
rash	Ausschlag
rattle	Rassel
rattled	rasselte
rattles	Rasseln
ravage	verwüsten
raving	tobend
reactionary	reaktionär
rebellious	rebellisch
rebuff	Abfuhr
rebuke	Tadel
recalcitrant	widerspenstig
recant	widerrufen
recession	Rezession
recessionary	rezessiv
reckless	leichtsinnig
recklessly	rücksichtslos
recklessness	Leichtsinn
recoil	Rückstoß
recourses	Ressourcen
redundancy	Redundanz
redundant	redundant
refusal	Ablehnung
refused	verweigert
refuses	verweigert
refusing	Verweigerung
refutation	Widerlegung
refute	widerlegen
refuted	widerlegt
refutes	widerlegt
refuting	widerlegen
regress	Regress
regression	Regression
regressive	regressiv
regret	Bedauern
regreted	berichtigt
regretful	bedauernd
regrets	bedauert
regrettable	bedauerlich
regrettably	leider
regretted	bedauert
reject	ablehnen
rejected	abgelehnt
rejecting	ablehnen
rejection	Ablehnung
relapse	Rückfall
relentless	unerbittlich
relentlessly	gnadenlos
relentlessness	Unermüdlichkeit
reluctance	Zurückhaltung
reluctant	widerwillig
reluctantly	widerwillig
remorse	Reue
remorseful	reumütig
remorsefully	reuevoll
remorseless	unerbittlich
remorselessly	erbarmungslos
remorselessness	Unerbittlichkeit
renounce	verzichten
renunciation	Verzicht
repel	abstoßen
reprehensible	verwerflich
reprehensibly	verwerflich
reprehension	Rüge
reprehensive	umfassend
repress	unterdrücken
repression	Repression
repressive	repressiv
reprimand	Verweis
reproach	Vorwurf
reproachful	vorwurfsvoll
reprove	tadeln
reprovingly	tadelnd
repudiate	ablehnen
repudiation	Zurückweisung
repugn	ablehnen
repugnance	Abscheu
repugnant	abstoßend
repugnantly	abstoßend
repulse	Abwehr
repulsed	abgestoßen
repulsing	abstoßend
repulsive	abstoßend
repulsively	abstoßend
repulsiveness	Widerwärtigkeit
resent	erneut
resentful	nachtragend
resentment	Groll
resignation	Rücktritt
resigned	resigniert
resistance	Widerstand
restless	unruhig
restlessness	Unruhe
restrict	beschränken
restricted	beschränkt
restriction	Beschränkung
restrictive	restriktiv
retaliate	vergelten
retaliatory	Vergeltung
retard	verzögern
retarded	Verzögert
retardedness	Zurückgebliebenheit
reticent	zurückhaltend
retract	einfahren
retreat	Rückzug
retreated	zurückgezogen
revenge	Rache
revengeful	rachsüchtig
revengefully	rachsüchtig
revert	zurückkehren
revile	schmähen
reviled	geschmäht
revoke	widerrufen
revolt	Revolte
revolting	widerlich
revoltingly	widerwärtig
revulsion	Abscheu
revulsive	revulsiv
rhapsodize	schwindeln
rhetoric	Rhetorik
rhetorical	rhetorisch
ricer	ricer
ridicule	Spott
ridicules	Spott
ridiculous	lächerlich
ridiculously	lächerlich
rift	Riss
rifts	Risse
rigid	starr
rigidity	Steifigkeit
rigidness	Starrheit
rile	ärgern
riled	geärgert
rip-off	Abzocke
ripoff	Abzocke
ripped	gerissen
risk	Risiko
risks	Risiken
risky	riskant
rival	Rivale
rivalry	Rivalität
roadblocks	Straßensperren
rocky	felsig
rogue	Schurke
rollercoaster	Achterbahn
rot	verrotten
rotten	faul
rough	Rau
rremediable	remediable
rubbish	Müll
rude	unhöflich
rue	bereuen
ruffian	Grobian
ruffle	Rüsche
ruin	Ruine
ruined	ruiniert
ruining	ruinieren
ruinous	ruinös
ruins	Ruinen
rumbling	Grollen
rumor	Gerücht
rumors	Gerüchte
rumours	Gerüchte
rumple	zerknittern
run-down	heruntergewirtschaftet
rupture	Bruch
rust	Rost
rusts	rostet
rusty	rostig
rut	Furche
ruthless	rücksichtslos
ruthlessly	rücksichtslos
ruthlessness	Rücksichtslosigkeit
ruts	Furchen
sabotage	Sabotage
sack	Sack
sacrificed	geopfert
sad	traurig
sadden	betrüben
sadly	traurig
sadness	Traurigkeit
sag	durchhängen
sagged	abgesackt
sagging	Absacken
saggy	schlaff
sags	durchhängt
salacious	höhnisch
sanctimonious	scheinheilig
sap	Saft
sarcasm	Sarkasmus
sarcastic	sarkastisch
sarcastically	sarkastisch
sardonic	sardonisch
sardonically	sardonisch
sass	sauer
satirical	satirisch
satirize	persiflieren
savage	wild
savaged	verwildert
savagery	Wildheit
savages	Wilde
scaly	schuppig
scam	Betrug
scams	Betrügereien
scandal	Skandal
scandalize	schockieren
scandalized	empört
scandalous	skandalös
scandalously	skandalös
scandals	Skandale
scandel	Scandel
scandels	Scandels
scant	wenig
scapegoat	Sündenbock
scar	Narbe
scarce	knapp
scarcely	kaum
scarcity	Knappheit
scare	Schrecken
scared	erschrocken
scarier	erschreckender
scariest	gruseligsten
scarily	unheimlich
scarred	vernarbt
scars	Narben
scary	unheimlich
scathing	vernichtend
scathingly	vernichtend
sceptical	skeptisch
scoff	spotten
scoffingly	spöttisch
scold	schelten
scolded	gescholten
scolding	Schelte
scoldingly	schimpfend
scorching	sengend
scorchingly	sengend
scorn	Verachtung
scornful	verächtlich
scornfully	verächtlich
scoundrel	Schurke
scourge	Geißel
scramble	Gerangel
scrambled	Rührei
scrambles	scrambelt
scrambling	krabbeln
scrap	Schrott
scratch	kratzen
scratched	zerkratzt
scratches	Kratzer
scratchy	kratzig
scream	Schrei
screech	kreischen
screw-up	vermasseln
screwed	geschraubt
screwed-up	vermasselt
screwy	verrückt
scuff	Scheuern
scuffs	Schrammen
scum	Abschaum
scummy	schäbig
secretive	geheimnisvoll
sedentary	sesshaft
seedy	schäbig
seethe	kochen
seething	brodelnd
self-coup	Selbst-Coup
self-criticism	Selbstkritik
self-defeating	selbstzerstörerisch
self-destructive	selbstzerstörerisch
self-humiliation	Selbstdemütigung
self-interest	Eigennutz
self-interested	eigennützig
self-serving	eigennützig
selfinterested	selbstinteressiert
selfish	egoistisch
selfishly	egoistisch
selfishness	Selbstsucht
semi-retarded	halbverzögert
senile	senil
sensationalize	sensationalisieren
senseless	sinnlos
senselessly	sinnlos
seriousness	Schwere
sermonize	predigen
servitude	Knechtschaft
set-up	Konfiguration
setback	Rückschlag
setbacks	Rückschläge
sever	trennen
severe	schwer
severity	Schwere
shabby	schäbig
shadowy	schattenhaft
shady	schattig
shake	Shake
shaky	wackelig
shallow	flach
sham	Schein
shambles	Trümmer
shame	Schande
shameful	beschämend
shamefully	beschämend
shamefulness	Schändlichkeit
shameless	schamlos
shamelessly	schamlos
shamelessness	Schamlosigkeit
shark	Hai
sharply	scharf
shatter	zerschmettern
shemale	Transen
shimmer	schimmern
shimmy	shimmy
shipwreck	Schiffswrack
shirk	Schirk
shirker	Drückeberger
shit	Scheisse
shiver	Schauer
shock	Schock
shocked	schockiert
shocking	schockierend
shockingly	erschreckend
shoddy	Shoddy
short-lived	kurzlebig
shortage	Mangel
shortchange	Wechselgeld
shortcoming	Mangel
shortcomings	Mängel
shortness	Kürze
shortsighted	kurzsichtig
shortsightedness	Kurzsichtigkeit
showdown	Showdown
shrew	Spitzmaus
shriek	Schrei
shrill	schrillen
shrilly	schrill
shrivel	schrumpfen
shroud	Leichentuch
shrouded	eingehüllt
shrug	zucken
shun	meiden
shunned	gemieden
sick	krank
sicken	erkranken
sickening	widerlich
sickeningly	widerwärtig
sickly	kränklich
sickness	Krankheit
sidetrack	Nebenspur
sidetracked	abgelenkt
siege	Belagerung
sillily	frech
silly	dumm
simplistic	simpel
simplistically	vereinfachend
sin	Sünde
sinful	sündig
sinfully	sündhaft
sinister	unheimlich
sinisterly	unheimlich
sink	sinken
sinking	Untergang
skeletons	Skelette
skeptic	Skeptiker
skeptical	skeptisch
skeptically	skeptisch
skepticism	Skepsis
sketchy	skizzenhaft
skimpy	dürftig
skinny	dünn
skittish	schwankend
skittishly	übermütig
skulk	schleichen
slack	locker
slander	Verleumdung
slanderer	Verleumder
slanderous	verleumderisch
slanderously	verleumderisch
slanders	Verleumdungen
slap	schlagen
slashing	Zerschlagung
slaughter	schlachten
slaughtered	geschlachtet
slave	Sklave
slaves	Sklaven
sleazy	sleazy
slime	Schleim
slog	schmeißen
slogged	niedergeschlagen
slogging	Schütteln
slogs	Klamotten
sloooooooooooooow	slooooooooooooooow
sloooow	slaueau
slooow	schlampig
sloow	schluchzend
sloppily	schlampig
sloppy	schlampig
sloth	Faultier
slothful	träge
slow	langsam
slowed	verlangsamt
slower	Langsamer
slowly	langsam
sloww	langsam
slowww	langsam
slowwww	langsamwww
slug	Schnecke
sluggish	träge
slump	Einbruch
slumping	sinkend
slumpping	slumpping
slur	Bogen
slut	Schlampe
sluts	Schlampen
sly	schlau
smack	klatschen
smallish	kleiner
smash	Smash
smear	Abstrich
smell	Geruch
smelled	roch
smelling	riechend
smells	riecht
smelly	stinkend
smelt	Stint
smoke	Rauch
smokescreen	Nebelwand
smolder	schwelen
smoldering	schwelend
smother	ersticken
smoulder	schwelen
smouldering	schwelend
smudge	verschmieren
smudged	verschmiert
smudges	Flecken
smudging	verschmieren
smug	selbstgefällig
smugly	selbstgefällig
smut	Schmutz
smuttier	düsterer
smuttiest	dreckigste
smutty	schmutzig
snag	Haken
snagged	geschnappt
snagging	verheddert
snags	Haken
snappish	bissig
snappishly	schnippisch
snare	Schlinge
snarky	schnippisch
snarl	Knurren
sneak	schleichen
sneakily	hinterhältig
sneaky	hinterhältig
sneer	spotten
sneering	höhnisch
sneeringly	höhnisch
snob	Snob
snobbish	snobistisch
snobby	hochnäsig
snobish	snobistisch
snobs	Snobs
snub	Brüskierung
so-cal	so-kal
soapy	seifig
sob	Schluchzen
sober	nüchtern
sobering	ernüchternd
solemn	feierlich
solicitude	Sorge
somber	düster
sore	wund
sorely	schmerzlich
soreness	Wundsein
sorrow	Trauer
sorrowful	traurig
sorrowfully	traurig
sour	sauer
sourly	säuerlich
spade	Spaten
spank	versohlen
spendy	Spend
spew	speien
spewed	gespuckt
spewing	spuckend
spilling	verschütten
spinster	Jungfer
spiritless	geistlos
spite	Trotz
spiteful	boshaft
spitefully	boshaft
spitefulness	Gehässigkeit
splatter	spritzen
split	Teilt
splitting	Spaltung
spoil	verwöhnen
spoilage	Verderbnis
spoilages	Verwürfe
spoiled	verdorben
spoilled	verdorben
spoils	Beute
spook	Spuk
spookier	gespenstischer
spookiest	Gruseligste
spookily	gespenstisch
spooky	gespenstisch
spoon-feed	Löffel-füttern
spoonfed	Löffelgespeist
sporadic	sporadisch
spotty	fleckig
spurious	unecht
spurn	verschmähen
sputter	spucken
squabble	Streit
squabbling	Zankerei
squander	verschwenden
squash	quetschen
squeak	quietschen
squeaks	quietscht
squeaky	quietschend
squeal	quietschen
squealing	Quietschen
squeals	Quietschen
squirm	winden
stab	stechen
stagnant	stagniert
stagnate	stagnieren
stagnation	Stagnation
staid	staid
stain	Fleck
stains	Flecken
stale	abgestanden
stalemate	Patt
stall	Stall
stalls	Stände
stammer	stammeln
stampede	Ansturm
stark	Stark
starkly	stark
startle	erschrecken
startling	erschreckend
startlingly	erstaunlich
starvation	Hunger
starve	verhungern
static	statisch
steal	stehlen
stealing	stehlen
steals	stiehlt
steep	steil
steeply	steil
stench	Gestank
stereotype	Stereotyp
stereotypical	stereotypisch
stereotypically	stereotypisch
stern	Stern
stew	Eintopf
sticky	klebrig
stiff	steif
stiffness	Steifheit
stifle	ersticken
stifling	erstickend
stiflingly	erstickend
stigma	Stigma
stigmatize	stigmatisieren
sting	Stachel
stinging	stechen
stingingly	erbärmlich
stingy	geizig
stink	stinken
stinks	stinkt
stodgy	schwerfällig
stole	Stahl
stolen	gestohlen
stooge	Strohmann
stooges	Handlanger
stormy	stürmisch
straggle	umherstreifen
straggler	Nachzügler
strain	Belastung
strained	angespannt
straining	anstrengend
strange	seltsam
strangely	seltsam
stranger	Fremder
strangest	seltsamste
strangle	erwürgen
streaky	streifig
strenuous	anstrengend
stress	Stress
stresses	betont
stressful	stressig
stressfully	stressig
stricken	betroffen
strict	streng
strictly	streng
strident	schrill
stridently	schrill
strife	Streit
strike	Streik
stringent	streng
stringently	streng
struck	geschlagen
struggle	Kampf
struggled	gekämpft
struggles	Kämpfe
struggling	kämpfen
strut	Strebe
stubborn	stur
stubbornly	stur
stubbornness	Sturheit
stuck	stecken
stuffy	stickig
stumble	stolpern
stumbled	gestolpert
stumbles	stolpert
stump	Stumpf
stumped	ratlos
stumps	Stümpfe
stun	betäuben
stunt	Kunststück
stunted	verkümmert
stupid	blöd
stupidest	dümmste
stupidity	Dummheit
stupidly	dumm
stupified	verblüfft
stupify	verblödeln
stupor	Stupor
stutter	stottern
stuttered	stotterte
stuttering	Stottern
stutters	stottert
sty	Schweinestall
stymied	verstümmelt
sub-par	Subpar
subdued	gedämpft
subjected	unterworfen
subjection	Unterwerfung
subjugate	unterwerfen
subjugation	Unterwerfung
submissive	unterwürfig
subordinate	untergeordnet
subpoena	Vorladung
subpoenas	Vorladungen
subservience	Unterwürfigkeit
subservient	unterwürfig
substandard	minderwertig
subtract	subtrahieren
subversion	Subversion
subversive	subversiv
subversively	subversiv
subvert	untergraben
succumb	erliegen
suck	saugen
sucked	angesaugt
sucker	Saugnapf
sucky	sucky
sue	verklagen
sued	verklagt
sueing	verklagen
sues	verklagt
suffer	leiden
sufferer	Leidende
sufferers	Leidende
suffering	Leiden
suffers	leidet
suffocate	ersticken
sugar-coat	Zuckermantel
sugarcoated	sugarcoated
suicidal	lebensmüde
suicide	Selbstmord
sulk	schmollen
sullen	mürrisch
sully	besudeln
sunder	Sander
sunk	versenkt
sunken	versunken
superficial	oberflächlich
superficiality	Oberflächlichkeit
superficially	oberflächlich
superfluous	überflüssig
superstition	Aberglaube
superstitious	abergläubisch
suppress	unterdrücken
suppression	Unterdrückung
surrender	Kapitulation
susceptible	anfällig
suspect	vermuten
suspicion	Verdacht
suspicions	Verdacht
suspicious	verdächtig
suspiciously	verdächtig
swagger	stolzieren
swamped	überschwemmt
sweaty	verschwitzt
swelled	angeschwollen
swelling	Schwellung
swindle	Schwindel
swipe	wischen
swollen	geschwollen
symptom	Symptom
symptoms	Symptome
syndrome	Syndrom
taboo	Tabu
tacky	klebrig
taint	verderben
tainted	verdorben
tamper	manipulieren
tangle	Gewirr
tangled	verheddert
tangles	Verwicklungen
tank	Panzer
tanked	getankt
tanks	Panzer
tantrum	Wutanfall
tardy	spät
tarnish	trüben
tarnished	getrübt
tarnishes	anläuft
tarnishing	Anlaufen
tattered	zerfetzt
taunt	Spott
taunting	höhnisch
tauntingly	spöttisch
taunts	Sticheleien
taut	straff
tawdry	schäbig
taxing	Besteuerung
tease	necken
teasingly	neckisch
tedious	langweilig
tediously	mühsam
temerity	Kühnheit
temper	Temperament
tempest	Sturm
temptation	Versuchung
tenderness	Zärtlichkeit
tense	Tempus
tension	Spannung
tentative	Vorsichtig
tentatively	vorläufig
tenuous	dürftig
tenuously	dürftig
tepid	lauwarm
terrible	furchtbar
terribleness	Schrecklichkeit
terribly	fürchterlich
terror	Terror
terror-genic	terror-genic
terrorism	Terrorismus
terrorize	terrorisieren
testily	gereizt
testy	gereizt
tetchily	zittrig
tetchy	gereizt
thankless	undankbar
thicker	dicker
thirst	Durst
thorny	dornig
thoughtless	gedankenlos
thoughtlessly	gedankenlos
thoughtlessness	Gedankenlosigkeit
thrash	Thrash
threat	Bedrohung
threaten	drohen
threatening	bedrohlich
threats	Bedrohungen
threesome	Dreier
throb	pochen
throbbed	pochte
throbbing	pochend
throbs	pocht
throttle	drosseln
thug	Schläger
thwart	vereiteln
time-consuming	Zeitaufwendig
timid	schüchtern
timidity	Schüchternheit
timidly	schüchtern
timidness	Ängstlichkeit
tingled	kribbelte
tingling	Kribbeln
tired	müde
tiresome	ermüdend
tiring	ermüdend
tiringly	ermüdend
toil	Mühsal
toll	Maut
top-heavy	kopflastig
topple	stürzen
torment	quälen
tormented	gequält
torrent	Torrent
tortuous	gewunden
torture	Folter
tortured	gefoltert
tortures	Folterungen
torturing	folternd
torturous	quälend
torturously	quälend
totalitarian	totalitär
touchy	empfindlich
toughness	Zähigkeit
tout	Schlepper
touted	angepriesen
touts	Werbespots
toxic	giftig
traduce	verleumden
tragedy	Tragödie
tragic	tragisch
tragically	tragisch
traitor	Verräter
traitorous	verräterisch
traitorously	verräterisch
tramp	Tramp
trample	trampeln
transgress	überschreiten
transgression	Überschreitung
trap	Falle
traped	abgefangen
trapped	gefangen
trash	Müll
trashed	verwüstet
trashy	trashig
trauma	Trauma
traumatic	traumatisch
traumatically	traumatisch
traumatize	traumatisieren
traumatized	traumatisiert
travesties	Travestien
travesty	Travestie
treacherous	tückisch
treacherously	verräterisch
treachery	Verrat
treason	Verrat
treasonous	verräterisch
trick	Trick
tricked	ausgetrickst
trickery	Trickserei
tricky	schwierig
trivial	trivial
trivialize	trivialisieren
trouble	Ärger
troubled	beunruhigt
troublemaker	Unruhestifter
troubles	Probleme
troublesome	lästig
troublesomely	mühsam
troubling	beunruhigend
troublingly	beunruhigend
truant	schwänzen
tumble	taumeln
tumbled	taumelte
tumbles	taumelt
tumultuous	turbulent
turbulent	turbulent
turmoil	Aufruhr
twist	Twist
twisted	verdrehte
twists	Drehungen
two-faced	zweigesichtig
tyrannical	tyrannisch
tyrannically	tyrannisch
tyranny	Tyrannei
tyrant	Tyrann
ugh	Pfui
uglier	hässlicher
ugliest	hässlichste
ugliness	Hässlichkeit
ugly	hässlich
ulterior	später
ultimatum	Ultimatum
ultimatums	Ultimaten
unable	unfähig
unacceptablely	inakzeptabel
unacceptably	inakzeptabel
unaccessible	unerreichbar
unaccustomed	ungewohnt
unachievable	unerreichbar
unaffordable	unbezahlbar
unappealing	unattraktiv
unattractive	unattraktiv
unavoidably	unvermeidlich
unbearable	unerträglich
unbearablely	unerträglich
unbelievably	unglaublich
uncaring	gleichgültig
uncertain	unsicher
uncivil	unhöflich
uncivilized	unzivilisiert
unclean	unrein
unclear	unklar
uncollectible	uneinbringlich
uncomfortable	unbequem
uncomfortably	unangenehm
uncomfy	unkomfortabel
uncompromising	kompromisslos
uncompromisingly	kompromisslos
unconfirmed	unbestätigt
unconstitutional	verfassungswidrig
uncontrolled	unkontrolliert
uncooperative	unkooperativ
uncouth	ungehobelt
uncreative	unkreativ
undecided	unentschieden
undependability	Unzuverlässigkeit
undependable	unzuverlässig
undercut	unterbieten
undercuts	Hinterschneidungen
undercutting	Unterbietung
underdog	Underdog
underestimate	unterschätzen
underlings	Untergebene
undermine	untergraben
undermined	untergraben
undermines	untergräbt
undermining	Aushöhlung
underpaid	unterbezahlt
underpowered	unterpowered
undersized	unterdimensioniert
undesirable	unerwünscht
undetermined	unbestimmt
undid	aufheben
undignified	unwürdig
undissolved	ungelöst
undocumented	undokumentiert
undue	unangemessen
unease	Unbehagen
uneasily	unruhig
uneasiness	Unbehagen
uneasy	unruhig
uneconomical	unwirtschaftlich
unemployed	arbeitslos
unequal	ungleich
unethical	unethisch
uneven	ungleichmäßig
uneventful	ereignislos
unexpected	unerwartet
unexpectedly	unerwartet
unexplained	unerklärt
unfairly	unfair
unfaithful	untreu
unfaithfully	untreu
unfamiliar	unbekannt
unfavorable	ungünstig
unfeeling	gefühllos
unfinished	unvollendet
unfit	untauglich
unforeseen	unvorhergesehen
unforgiving	unversöhnlich
unfortunate	unglücklich
unfortunately	Unglücklicherweise
unfounded	unbegründet
unfriendly	unfreundlich
unfulfilled	unerfüllt
unfunded	ungedeckt
ungovernable	unregierbar
ungrateful	undankbar
unhappily	unglücklich
unhappiness	Unglück
unhappy	unzufrieden
unhealthy	ungesund
unilateralism	Unilateralismus
unimaginable	unvorstellbar
unimaginably	unvorstellbar
unimportant	unwichtig
uninsured	unversichert
unintelligible	unverständlich
unintelligile	unintelligil
unipolar	unipolar
unjust	ungerecht
unjustifiably	ungerechtfertigt
unjustified	ungerechtfertigt
unjustly	ungerecht
unkindly	unfreundlich
unknown	unbekannte
unlamentable	unsterblich
unlamentably	unauffällig
unlawful	ungesetzlich
unlawfully	unrechtmäßig
unlawfulness	Rechtswidrigkeit
unleash	entfesseln
unlikely	unwahrscheinlich
unlucky	unglücklich
unmoved	unbewegt
unnatural	unnatürlich
unnaturally	unnatürlich
unnerve	entnerven
unnerved	entnervt
unnerving	entnervend
unnervingly	entnervend
unnoticed	unbemerkt
unobserved	unbeobachtet
unorthodox	unorthodox
unorthodoxy	Unorthodoxie
unpleasant	unangenehm
unpleasantries	Unlust
unpopular	unpopulär
unpredictable	unberechenbar
unprepared	unvorbereitet
unproductive	unproduktiv
unprofitable	unrentabel
unprove	unbewiesen
unproved	unbewiesen
unproven	unbewiesen
unproving	unbewiesen
unqualified	unqualifiziert
unravel	entwirren
unraveled	entwirrt
unreachable	unerreichbar
unreadable	unlesbar
unrealistic	unrealistisch
unreasonable	unvernünftig
unreasonably	unvernünftig
unrelenting	unerbittlich
unrelentingly	unnachgiebig
unreliability	Unzuverlässigkeit
unreliable	unzuverlässig
unresolved	ungelöst
unrest	Unruhe
unruly	widerspenstig
unsafe	unsicher
unsatisfactory	ungenügend
unsavory	unappetitlich
unscrupulous	skrupellos
unscrupulously	skrupellos
unsecure	unsicher
unseemly	ungehörig
unsettle	verunsichern
unsettled	ungeklärt
unsettling	beunruhigend
unsettlingly	beunruhigend
unskilled	unerfahren
unsound	ungesund
unspeakable	unaussprechlich
unspeakablely	unaussprechlich
unstable	instabil
unsteadily	unsicher
unsteadiness	Unsicherheit
unsteady	unsicher
unsuccessful	erfolglos
unsuccessfully	vergeblich
unsure	unsicher
unsuspecting	ahnungslos
untenable	unhaltbar
untested	ungetestet
unthinkable	undenkbar
unthinkably	undenkbar
untimely	vorzeitig
untouched	unberührt
untrue	unwahr
untrustworthy	unseriös
untruthful	unwahr
unusable	unbrauchbar
unusably	unbrauchbar
unuseably	unbrauchbar
unusual	ungewöhnlich
unusually	ungewöhnlich
unwanted	unerwünscht
unwarranted	unberechtigt
unwatchable	unerreichbar
unwelcome	unwillkommen
unwieldy	unhandlich
unwilling	unwillig
unwillingly	widerwillig
unwillingness	Unwilligkeit
unwise	unklug
unwisely	unklug
unworthy	unwürdig
unyielding	unnachgiebig
upbraid	rügen
upheaval	Umwälzung
uprising	Aufstand
uproar	Aufruhr
uproarious	ärgerlich
uproariously	ärgerlich
uproarous	aufruhrend
uproarously	aufrührerisch
uproot	entwurzeln
upset	verärgert
upseting	upseting
upsets	Verstimmungen
upsetting	ärgerlich
upsettingly	ärgerlich
urgent	dringend
useless	nutzlos
usurp	usurpieren
usurper	Usurpator
utterly	völlig
vagrant	Landstreicher
vague	vage
vagueness	Vagheit
vain	vergeblich
vainly	vergeblich
vanity	Eitelkeit
vehement	vehement
vehemently	vehement
vengeance	Rache
vengeful	rachsüchtig
vengefully	rachsüchtig
vengefulness	Rachsucht
venom	Gift
venomous	giftig
venomously	giftig
vent	Entlüftung
vestiges	Spuren
vex	ärgern
vexation	Ärger
vexing	ärgerlich
vexingly	ärgerlich
vibrate	vibrieren
vibrated	vibrierte
vibrates	vibriert
vibrating	vibrierend
vibration	Vibration
vice	Laster
vicious	bösartig
viciously	bösartig
viciousness	Bösartigkeit
victimize	schikanieren
vile	gemein
vileness	Niedertracht
vilify	verunglimpfen
villainous	schurkisch
villainously	schändlich
villains	Schurken
villian	Bösewicht
villianous	bösartig
villianously	bösartig
villify	verklären
vindictive	rachsüchtig
vindictively	rachsüchtig
vindictiveness	Rachsucht
violate	verletzen
violation	Verstoß
violator	Verletzer
violators	Verletzer
violent	heftig
violently	heftig
viper	Viper
virulence	Virulenz
virulent	virulent
virulently	virulent
virus	Virus
vociferous	lautstark
vociferously	lautstark
volatile	flüchtig
volatility	Volatilität
vomit	erbrechen
vomited	erbrochen
vomiting	Erbrechen
vulgar	vulgär
vulnerable	verwundbar
wack	verrückt
wail	jammern
wallow	Suhle
wane	schwinden
waning	abnehmend
wanton	mutwillig
war-like	kriegsähnlich
warily	vorsichtig
wariness	Vorsicht
warlike	kriegerisch
warned	gewarnt
warning	Warnung
warp	Kette
warped	verzogen
wary	vorsichtig
washed-out	ausgewaschen
waste	Abfall
wasted	verschwendet
wasteful	verschwenderisch
wastefulness	Verschwendung
wasting	Verschwendung
water-down	verwässern
watered-down	verwässert
wayward	eigensinnig
weak	schwach
weaken	schwächen
weakening	Schwächung
weaker	schwächer
weaknesses	Schwächen
weariness	Müdigkeit
wearisome	ermüdend
weary	müde
wedge	Keil
weed	Gras
weep	weinen
weird	seltsam
weirdly	komisch
wheedle	Schmeichelei
whimper	wimmern
whine	jammern
whining	jammern
whiny	weinerlich
whips	Peitschen
whore	Hure
whores	Huren
wicked	böse
wickedly	böse
wickedness	Bosheit
wild	wild
wildly	wild
wiles	List
wilt	verwelken
wily	schlau
wimpy	feige
wince	zusammenzucken
wobble	flattern
wobbled	wackelte
wobbles	wackelt
woe	Weh
woebegone	wehleidig
woeful	elend
woefully	erbärmlich
womanizer	Schürzenjäger
womanizing	Womanizing
worn	getragen
worried	besorgt
worriedly	besorgt
worrier	Besorgnis
worries	Sorgen
worrisome	beunruhigend
worry	Sorge
worrying	beunruhigend
worryingly	beunruhigend
worse	schlechter
worsen	verschlechtern
worsening	Verschlechterung
worthless	wertlos
worthlessly	wertlos
worthlessness	Wertlosigkeit
wound	Wunde
wounds	Wunden
wrangle	streiten
wrath	Zorn
wreak	anrichten
wreaked	angerichtet
wreaks	weckt
wreck	Wrack
wrest	entreißen
wrestle	ringen
wretch	Unglücklicher
wretched	erbärmlich
wretchedly	elend
wretchedness	Elend
wrinkle	Falten
wrinkled	faltig
wrinkles	Falten
wrip	wrip
wrong	falsch
wrongful	ungerechtfertigt
wrought	bearbeitet
yawn	gähnen
zap	zappen
zapped	gezappt
zaps	zaps
zealot	Eiferer
zealous	eifrig
zealously	eifrig
zombie	Zombie
abundance	Fülle
abundant	reichlich
accessable	zugänglich
accessible	zugänglich
acclaim	Anerkennung
acclaimed	gefeiert
acclamation	Akklamation
accolade	Akkolade
accolades	Auszeichnungen
accommodative	entgegenkommend
accomodative	Unterkunft
accomplish	erreichen
accomplished	erreicht
accomplishment	Leistung
accomplishments	Errungenschaften
accurate	genau
accurately	genau
achievable	erreichbar
achievement	Leistung
achievements	Erfolge
achievible	Erreichbar
acumen	Scharfsinn
adaptable	anpassungsfähig
adaptive	adaptiv
adequate	angemessene
adjustable	einstellbar
admirable	bewundernswert
admirably	bewundernswert
admiration	Bewunderung
admire	bewundern
admirer	Bewunderer
admiring	bewundern
admiringly	bewundernd
adorable	bezaubernd
adore	verehren
adored	angebetet
adorer	Bewunderer
adoring	anbetend
adoringly	verehrend
adroit	geschickt
adroitly	geschickt
adulate	schmeicheln
adulation	Verherrlichung
adulatory	adulierend
advanced	fortgeschritten
advantage	Vorteil
advantageous	vorteilhaft
advantageously	vorteilhaft
advantages	Vorteile
adventuresome	abenteuerlich
adventurous	abenteuerlich
advocate	befürworten
advocated	befürwortet
advocates	Fürsprecher
affability	Freundlichkeit
affable	freundlich
affably	freundlich
affectation	Affektiertheit
affection	Zuneigung
affectionate	zärtlich
affinity	Affinität
affirm	bestätigen
affirmation	Bejahung
affirmative	positiv
affluence	Wohlstand
affluent	wohlhabend
affordable	erschwinglich
affordably	erschwinglich
afordable	erschwinglich
agile	agil
agilely	agil
agility	Beweglichkeit
agreeable	angenehm
agreeableness	Verträglichkeit
agreeably	angenehm
all-around	Überall
alluring	verlockend
alluringly	verlockend
altruistic	altruistisch
altruistically	altruistisch
amaze	überraschen
amazed	erstaunt
amazement	Staunen
amazes	erstaunt
amazing	tolle
amazingly	erstaunlich
ambitious	ehrgeizig
ambitiously	ehrgeizig
ameliorate	verbessern
amenable	zugänglich
amenity	Annehmlichkeit
amiability	Liebenswürdigkeit
amiabily	amiabilly
amiable	liebenswürdig
amicability	Verträglichkeit
amicable	freundschaftlich
amicably	gütlich
amity	Freundschaft
ample	reichlich
amply	reichlich
amuse	amüsieren
amusing	lustig
amusingly	amüsant
angel	Engel
angelic	engelhaft
apotheosis	Apotheose
appeal	Beschwerde
appealing	ansprechend
applaud	applaudieren
appreciable	nennenswert
appreciate	schätzen
appreciated	geschätzt
appreciates	schätzt
appreciative	dankbar
appreciatively	anerkennend
appropriate	angemessen
approve	genehmigen
ardent	glühend
ardently	leidenschaftlich
ardor	Eifer
articulate	artikulieren
aspiration	Aspiration
aspirations	Aspirationen
aspire	streben
assurance	Sicherheit
assurances	Zusicherungen
assure	versichern
assuring	versichern
astonish	erstaunen
astonished	erstaunt
astonishing	erstaunlich
astonishingly	erstaunlich
astonishment	Erstaunen
astound	erstaunlich
astounded	erstaunt
astounding	erstaunlich
astoundingly	erstaunlich
astutely	scharfsinnig
attentive	aufmerksam
attraction	Attraktion
attractive	attraktiv
attractively	attraktiv
attune	stimmen
audible	hörbar
audibly	hörbar
auspicious	glückverheißend
authentic	authentisch
authoritative	autoritativ
autonomous	autonom
available	verfügbar
aver	behaupten
avid	begierig
avidly	eifrig
award	vergeben
awarded	ausgezeichnet
awards	Auszeichnungen
awe	Scheu
awed	beeindruckt
awesome	genial
awesomely	unglaublich
awesomeness	Großartigkeit
awestruck	ehrfürchtig
awsome	fantastisch
backbone	Rückgrat
balanced	ausgewogen
bargain	Schnäppchen
beauteous	schön
beautiful	schön
beautifullly	wunderschön
beautifully	schön
beautify	verschönern
beauty	Schönheit
beckon	winken
beckoned	winkte
beckoning	winkte
beckons	winkt
believable	glaubhaft
believeable	glaubwürdig
beloved	Geliebte
benefactor	Wohltäter
beneficent	wohltätig
beneficial	vorteilhaft
beneficially	nützlich
beneficiary	Begünstigter
benefit	Vorteil
benefits	Leistungen
benevolence	Wohlwollen
benevolent	wohlwollend
benifits	Vorteile
best	Beste
best-known	wohlbekannt
best-selling	meistverkauft
better	besser
beutifully	schön
blameless	untadelig
bless	segnen
blessing	Segen
bliss	Glückseligkeit
blissful	glückselig
blissfully	selig
blithe	Fröhlichkeit
blockbuster	Blockbuster
bloom	blühen
blossom	blühen
bolster	Nackenrolle
bonny	Schön
bonus	Bonus
bonuses	Boni
boom	Boom
booming	boomt
boost	steigern
boundless	grenzenlos
bountiful	freigebig
brainiest	Brainsty
brainy	gescheit
brand-new	Brandneu
brave	mutig
bravery	Mut
bravo	Bravo
breakthrough	Durchbruch
breakthroughs	Durchbrüche
breathlessness	Atemlosigkeit
breathtaking	atemberaubend
breathtakingly	atemberaubend
breeze	Brise
bright	hell
brighten	aufhellen
brighter	heller
brilliance	Brillanz
brilliances	Brillianz
brilliant	brillant
brilliantly	brillant
brisk	lebhaft
brotherly	brüderlich
bullish	bullisch
buoyant	schwimmfähig
cajole	Schmeichelei
calm	Ruhe
calming	beruhigend
calmness	Ruhe
capability	Fähigkeit
capable	fähig
capably	kompetent
captivate	bestechen
captivating	fesselnd
carefree	sorglos
cashback	Rückzahlung
cashbacks	Rücklagen
catchy	eingängig
celebrate	feiern
celebrated	gefeiert
celebration	Feier
celebratory	feierlich
champ	Champion
champion	Champion
charisma	Charisma
charismatic	charismatisch
charitable	wohltätig
charm	Charme
charming	charmant
charmingly	charmant
chaste	keusch
cheaper	billiger
cheer	jubeln
cheerful	heiter
cheery	heiter
cherish	hegen
cherished	geschätzt
cherub	Cherub
chic	schick
chivalrous	ritterlich
chivalry	Ritterlichkeit
civility	Höflichkeit
civilize	zivilisieren
clarity	Klarheit
classic	klassisch
classy	nobel
clean	reinigen
cleaner	Reiniger
cleanliness	Sauberkeit
cleanly	sauber
clear	klar
cleared	gelöscht
clearer	klarer
clearly	deutlich
clears	löscht
clever	klug
cleverly	geschickt
cohere	zusammenhängen
coherence	Kohärenz
coherent	kohärent
cohesive	zusammenhängend
colorful	bunt
comely	Schön
comfort	Komfort
comfortable	gemütlich
comfortably	bequem
comforting	tröstlich
comfy	gemütlich
commend	empfehlen
commendable	lobenswert
commendably	lobenswert
commitment	Engagement
commodious	geräumig
compact	kompakt
compactly	kompakt
compassion	Barmherzigkeit
compassionate	mitfühlend
compatible	kompatibel
competitive	wettbewerbsfähig
complement	ergänzen
complementary	komplementär
complemented	ergänzt
complements	ergänzt
compliant	konform
compliment	Kompliment
complimentary	kostenlos
comprehensive	umfassend
conciliate	versöhnen
conciliatory	versöhnlich
concise	prägnant
confidence	Vertrauen
confident	zuversichtlich
congenial	sympathisch
congratulate	gratulieren
congratulation	Glückwunsch
congratulatory	Glückwunsch
conscientious	gewissenhaft
considerate	rücksichtsvoll
consistent	konsistent
consistently	konsequent
constructive	konstruktiv
consummate	vollendet
contentment	Zufriedenheit
continuity	Kontinuität
contrasty	kontrastreich
contribution	Beitrag
convenience	Bequemlichkeit
convenient	praktisch
conveniently	bequem
convience	Convience
convienient	praktisch
convient	praktisch
convincing	überzeugend
convincingly	überzeugend
cool	cool
coolest	coolste
cooperative	Kooperative
cooperatively	kooperativ
cornerstone	Grundstein
correct	richtig
correctly	korrekt
cost-effective	kosteneffizient
cost-saving	Kosteneinsparung
counter-attack	Gegenangriff
counter-attacks	Gegenangriff
courage	Mut
courageous	mutig
courageously	mutig
courageousness	Mut
courteous	höflich
courtly	höflich
covenant	Bund
cozy	gemütlich
creative	kreativ
credence	Glaubwürdigkeit
credible	glaubwürdig
crisp	knackig
crisper	schärfer
cure	heilen
cure-all	Allheilmittel
cushy	bequem
cute	niedlich
cuteness	Niedlichkeit
danke	danke
danken	danken
daring	gewagt
daringly	wagemutig
darling	Liebling
dashing	schneidig
dauntless	unerschrocken
dawn	Dämmerung
dazzle	blenden
dazzled	geblendet
dazzling	blendend
dead-cheap	tod-billig
decency	Anstand
decent	anständig
decisive	entscheidend
decisiveness	Entschlossenheit
dedicated	gewidmet
defeat	Niederlage
defeated	besiegt
defeats	Niederlagen
defender	Verteidiger
deference	Ehrerbietung
deft	flink
deginified	entgiftet
delectable	köstlich
delicacy	Delikatesse
delicate	zart
delicious	köstlich
delight	Freude
delighted	Erfreut
delightful	herrlich
delightfully	herrlich
delightfulness	Herrlichkeit
dependable	zuverlässig
dependably	zuverlässig
deservedly	verdientermaßen
deserving	verdient
desirable	wünschenswert
desiring	begehrend
desirous	begierig
destiny	Schicksal
detachable	abnehmbar
devout	fromm
dexterous	geschickt
dexterously	geschickt
dextrous	geschickt
dignified	würdevoll
dignify	würdigen
dignity	Würde
diligence	Sorgfalt
diligent	fleißig
diligently	fleißig
diplomatic	diplomatisch
dirt-cheap	spottbillig
distinction	Unterscheidung
distinctive	unverwechselbar
distinguished	unterschieden
diversified	diversifiziert
divine	göttlich
divinely	göttlich
dominate	dominieren
dominated	dominiert
dominates	dominiert
dote	dote
dotingly	zärtlich
doubtless	zweifellos
dreamland	Traumland
dumbfounded	sprachlos
dumbfounding	sprachlos
dummy-proof	dummy-Beweis
durable	dauerhaft
dynamic	dynamisch
eager	eifrig
eagerly	eifrig
eagerness	Eifer
earnest	Ernst
earnestly	ernsthaft
earnestness	Ernst
ease	Leichtigkeit
eased	erleichtert
eases	erleichtert
easier	einfacher
easiness	Leichtigkeit
easing	Lockerung
easy	einfach
ebullience	Überschwänglichkeit
ebullient	überschwänglich
ebulliently	überschwänglich
ecenomical	ecenomisch
economical	wirtschaftlich
ecstasies	Ekstasen
ecstasy	Ekstase
ecstatic	begeistert
ecstatically	ekstatisch
edify	erbauen
educated	gebildet
effective	Wirksam
effectively	effektiv
effectiveness	Wirksamkeit
effectual	wirksam
efficacious	wirksam
efficient	effizient
efficiently	effizient
effortless	mühelos
effortlessly	mühelos
effusion	Erguss
effusive	überschwänglich
effusively	überschwänglich
effusiveness	Überschwänglichkeit
elan	Elan
elate	begeistern
elated	begeistert
elatedly	beschwingt
elation	Begeisterung
electrify	elektrifizieren
elegance	Eleganz
elegant	elegant
elegantly	elegant
elevate	erheben
elite	Elite
eloquence	Beredsamkeit
eloquent	beredt
eloquently	eloquent
embolden	ermutigen
eminence	Eminenz
eminent	herausragend
empathize	einfühlen
empathy	Empathie
empower	ermächtigen
empowerment	Ermächtigung
enchant	verzaubern
enchanted	verzaubert
enchanting	zauberhaft
enchantingly	bezaubernd
encourage	ermutigen
encouragement	Förderung
encouraging	ermutigend
encouragingly	aufmunternd
endear	beliebt
endearing	liebenswert
endorse	befürworten
endorsed	bestätigt
endorsement	Billigung
endorses	bestätigt
endorsing	befürworten
energetic	energetisch
energize	ansporn
energy-efficient	Energieeffizient
engaging	engagiert
engrossing	fesselnd
enhance	verbessern
enhanced	verbessert
enhancement	Erweiterung
enhances	verbessert
enjoy	genießen
enjoyable	angenehm
enjoyably	Genießbar
enjoyed	genossen
enjoying	genießen
enjoyment	Vergnügen
enjoys	genießt
enlighten	erleuchten
enlightenment	Aufklärung
enliven	beleben
ennoble	veredeln
enough	genug
enrapt	entzückt
enrapture	entzücken
enraptured	entzückt
enrich	bereichern
enrichment	Anreicherung
enterprising	unternehmungslustig
entertain	unterhalten
entertaining	unterhaltsam
entertains	unterhält
enthral	begeistern
enthrall	begeistern
enthralled	bezaubert
enthuse	schwärmen
enthusiasm	Begeisterung
enthusiast	Enthusiast
enthusiastic	begeistert
enthusiastically	begeistert
entice	locken
enticed	gelockt
enticing	verlockend
enticingly	verlockend
entranced	verzaubert
entrancing	hinreißend
entrust	anvertrauen
enviable	beneidenswert
enviably	beneidenswert
envious	neidisch
enviously	neidisch
enviousness	Missgunst
envy	Neid
equitable	gerecht
ergonomical	ergonomisch
err-free	fehlerfrei
erudite	gelehrt
ethical	ethisch
eulogize	loben
euphoria	Euphorie
euphoric	euphorisch
euphorically	euphorisch
evaluative	evaluativ
evenly	gleichmäßig
eventful	ereignisreich
everlasting	ewig
evocative	evokativ
exalt	erhöhen
exaltation	Erhöhung
exalted	erhaben
exaltedly	erhaben
exalting	erhaben
exaltingly	exaltierend
examplar	Beispiel
examplary	Beispielhaft
excallent	excallent
exceed	überschreiten
exceeded	übertroffen
exceeding	Überschreitung
exceedingly	überaus
exceeds	übersteigt
excel	übertreffen
exceled	Ausgezeichnet
excelent	ausgezeichnet
excellant	ausgezeichnet
excelled	Ausgezeichnet
excellence	Exzellenz
excellency	Exzellenz
excellent	Ausgezeichnet
excellently	hervorragend
excels	übertrifft
exceptional	außergewöhnlich
exceptionally	außergewöhnlich
excite	anregen
excited	aufgeregt
excitedly	aufgeregt
excitedness	Erregung
excitement	Aufregung
excites	erregt
exciting	aufregend
excitingly	aufregend
exemplar	Exemplar
exemplary	exemplarisch
exhilarate	erheitert
exhilarating	berauschend
exhilaratingly	berauschend
exhilaration	Hochgefühl
exonerate	entlasten
expansive	ausdehnend
expeditiously	zügig
expertly	fachmännisch
exquisite	exquisit
exquisitely	exquisit
extol	verherrlichen
extoll	verherrlichen
extraordinarily	außerordentlich
extraordinary	außergewöhnlich
exuberance	Überschwang
exuberant	überschwänglich
exuberantly	überschwänglich
exult	frohlocken
exultant	jubelnd
exultation	Jubel
exultingly	jubelnd
eye-catch	Blickfang
eyecatch	Blickfang
eyecatching	Blickfang
fabulous	fabelhaft
fabulously	fabelhaft
facilitate	erleichtern
fair	Messe
fairly	ziemlich
fairness	Gerechtigkeit
faith	Glauben
faithful	treu
faithfully	treu
faithfulness	Treue
fame	Ruhm
famed	berühmt
famous	berühmt
famously	berühmt
fancier	Liebhaber
fancinating	fancing
fancy	schick
fanfare	Fanfare
fans	Fans
fantastic	Fantastisch
fantastically	fantastisch
fascinate	faszinieren
fascinating	faszinierend
fascinatingly	faszinierend
fascination	Faszination
fashionable	modisch
fashionably	modisch
fast	schnell
fast-paced	schnelllebig
faster	schneller
faultless	fehlerlos
fav	Liebling
fave	Liebling
favor	Gefallen
favorable	günstig
favored	begünstigt
favorite	Favorit
favorited	bevorzugt
favour	Gefallen
fearless	furchtlos
fearlessly	furchtlos
feasible	möglich
feasibly	machbar
feat	Kunststück
feature-rich	Feature-reich
fecilitous	feigig
feisty	lebhaft
felicitate	beglückwünschen
felicitous	glücklich
felicity	Glückseligkeit
fertile	fruchtbar
fervent	glühend
fervently	inbrünstig
fervid	glühend
fervidly	leidenschaftlich
fervor	Inbrunst
festive	festlich
fidelity	Treue
fiery	feurig
fine	fein
fine-looking	gutaussehend
finely	fein
finer	feiner
finest	feinste
firmer	fester
first-in-class	Erstklassig
first-rate	erstklassig
flashy	auffällig
flatter	schmeicheln
flattering	schmeichelhaft
flatteringly	schmeichlerisch
flawless	makellos
flawlessly	einwandfrei
flexibility	Flexibilität
flexible	flexibel
flourish	blühen
flourishing	blühend
fluent	fließend
flutter	flattern
fond	zärtlich
fondly	liebevoll
fondness	Vorliebe
foolproof	narrensicher
foresight	Voraussicht
formidable	furchtbar
fortitude	Kraft
fortuitous	zufällig
fortuitously	zufällig
fortunate	glücklich
fortunately	glücklicherweise
fortune	Vermögen
fragrant	duftend
free	frei
freed	befreit
freedom	Freiheit
freedoms	Freiheiten
fresh	frisch
fresher	frischer
freshest	frischesten
friendliness	Freundlichkeit
friendly	freundlich
frolic	Scherz
frugal	sparsam
fruitful	fruchtbar
ftw	ftw
fulfillment	Erfüllung
fun	Spaß
futurestic	Zukunftsorientiert
futuristic	futuristisch
gaiety	Fröhlichkeit
gaily	fröhlich
gain	gewinnen
gained	gewonnen
gainful	gewinnbringend
gainfully	gewinnbringend
gaining	Gewinnung
gains	Gewinne
gallant	galant
gallantly	galant
geekier	Geekier
geeky	geeky
gem	Juwel
gems	Edelsteine
generosity	Großzügigkeit
generous	großzügig
generously	großzügig
genial	genial
genius	Genius
gentle	sanft
gentlest	sanfteste
genuine	Original-
gifted	begabtes
glad	froh
gladden	erfreuen
gladly	gern
gladness	Freude
glamorous	glamourös
glee	Freude
gleeful	fröhlich
gleefully	gierig
glimmer	Glimmer
glimmering	schimmernd
glisten	glitzern
glistening	glitzernd
glitter	funkeln
glitz	Glanz
glorify	verherrlichen
glorious	herrlich
gloriously	herrlich
glory	Ruhm
glow	glühen
glowing	glühend
glowingly	begeistert
godlike	gottähnlich
gold	Gold
golden	golden
good	gut
goodly	gut
goodness	Güte
goodwill	Goodwill
goood	Gut
gooood	Gut
gorgeous	Herrlich
gorgeously	herrlich
grace	Anmut
graceful	anmutig
gracefully	anmutig
gracious	gnädig
graciously	gnädig
graciousness	Gnade
grand	großartig
grandeur	Größe
grateful	dankbar
gratefully	dankbar
gratification	Befriedigung
gratified	befriedigt
gratifies	befriedigend
gratify	befriedigen
gratifying	erfreulich
gratifyingly	erfreulich
gratitude	Dankbarkeit
great	groß
greatest	größte
greatness	Größe
grin	Grinsen
groundbreaking	bahnbrechend
guarantee	Garantie
guidance	Beratung
guiltless	schuldlos
gumption	Grips
gush	Schwall
gusto	Gusto
gutsy	mutig
hail	Hagel
halcyon	Halcyon
hale	gesund
hallmark	Kennzeichen
hallmarks	Markenzeichen
hallowed	geheiligt
handier	handlicher
handily	handlich
handsomely	ansehnlich
handy	praktisch
happier	glücklicher
happily	glücklich
happiness	Glück
happy	glücklich
hardier	härter
hardy	winterhart
harmless	harmlos
harmonious	harmonisch
harmoniously	harmonisch
harmonize	harmonisieren
harmony	Harmonie
headway	Fortschritt
heal	heilen
healthful	gesund
healthy	gesund
hearten	ermutigen
heartening	ermutigend
heartfelt	herzlich
heartily	herzlich
heartwarming	herzerwärmend
heaven	Himmel
heavenly	paradiesisch
helped	geholfen
helpful	hilfreich
helping	Portion
hero	Held
heroic	heroisch
heroically	heldenhaft
heroine	Heldin
heroize	heroisieren
heros	Helden
high-spirited	übermütig
hilarious	urkomisch
holy	heilig
homage	Huldigung
honest	ehrlich
honesty	Ehrlichkeit
honor	Ehre
honorable	ehrenhaft
honored	geehrt
honoring	Auszeichnung
hooray	Hurra
hopeful	hoffnungsvoll
hospitable	gastfreundlich
hot	heiß
hug	Umarmung
humane	menschlich
humble	demütigen
humility	Demut
humor	Humor
humorous	humorvoll
humorously	humorvoll
humour	Humor
humourous	humorvoll
ideal	Ideal
idealize	idealisieren
idol	Idol
idolize	vergöttern
idolized	vergöttert
idyllic	idyllisch
illuminate	erleuchten
illuminati	Illuminaten
illuminating	Beleuchtung
illumine	erleuchtet
illustrious	illustre
ilu	Ilu
imaculate	imakulieren
imaginative	einfallsreich
immaculate	makellos
immaculately	tadellos
immense	immens
impartial	unparteiisch
impartiality	Unparteilichkeit
impartially	unparteiisch
impassioned	leidenschaftlich
impeccable	tadellos
impeccably	tadellos
important	wichtig
impress	beeindrucken
impressed	beeindruckt
impresses	beeindruckt
impressive	beeindruckend
impressively	eindrucksvoll
impressiveness	Beeindruckung
improve	verbessern
improved	verbessert
improvement	Verbesserung
improvements	Verbesserungen
improving	verbessernd
incredible	unglaublich
incredibly	unglaublich
indebted	verschuldet
individualized	individualisiert
indulgence	Genuss
indulgent	nachsichtig
industrious	fleißig
inestimable	unschätzbar
inestimably	unschätzbar
inexpensive	preiswert
infallibility	Unfehlbarkeit
infallible	unfehlbar
infallibly	unfehlbar
influential	einflussreich
ingenious	genial
ingeniously	genial
ingenuity	Einfallsreichtum
ingenuous	aufrichtig
ingenuously	naiv
innocuous	harmlos
innovation	Innovation
innovative	innovativ
inpressed	eingedrückt
insightful	aufschlussreich
insightfully	einsichtsvoll
inspiration	Inspiration
inspirational	inspirierend
inspire	inspirieren
inspiring	inspirierend
instantly	sofort
instructive	lehrreich
instrumental	instrumental
integral	Integral-
integrated	integriert
intelligence	Intelligenz
intelligent	intelligent
intelligible	verständlich
interesting	interessant
interests	Interessen
intimacy	Intimität
intimate	intim
intricate	kompliziert
intrigue	Intrigen
intriguing	faszinierend
intriguingly	faszinierend
intuitive	intuitiv
invaluable	unschätzbar
inventive	erfinderisch
invigorate	beleben
invigorating	belebend
invincibility	Unbesiegbarkeit
invincible	unbesiegbar
inviolable	unverletzlich
inviolate	unantastbar
invulnerable	unverwundbar
irreplaceable	unersetzlich
irreproachable	tadellos
irresistible	unwiderstehlich
irresistibly	unwiderstehlich
issue-free	ausgabefrei
jaw-droping	Kiefer-Droping
jaw-dropping	umwerfend
jollify	jonglify
jolly	lustig
jovial	jovial
joy	Freude
joyful	froh
joyfully	freudig
joyous	fröhlich
joyously	freudig
jubilant	jubelnd
jubilantly	jubelnd
jubilate	jubilieren
jubilation	Jubel
jubiliant	jubilierend
judicious	vernünftig
keenly	scharf
keenness	Schärfe
kid-friendly	kinderfreundlich
kindliness	Güte
kindly	freundlich
kindness	Freundlichkeit
knowledgeable	kenntnisreich
kudos	Kudos
laud	loben
laudable	lobenswert
laudably	lobenswert
lavish	verschwenderisch
lavishly	reich
law-abiding	gesetzestreu
lawful	rechtmäßig
lawfully	rechtmäßig
lead	führen
leading	führend
leads	führt
lean	lehnen
led	LED
legendary	legendär
leverage	Hebelwirkung
levity	Leichtfertigkeit
liberate	befreien
liberation	Befreiung
liberty	Freiheit
lifesaver	Lebensretter
light-hearted	unbeschwert
lighter	leichter
likable	sympathisch
like	mögen
liked	gefallen
likes	Likes
liking	Geschmack
lionhearted	Löwenherz
lively	lebhaft
logical	logisch
lovable	liebenswert
lovably	liebenswert
love	Liebe
loved	geliebt
loveliness	Lieblichkeit
lovely	schön
lover	Liebhaber
loves	liebt
loving	liebend
low-cost	kostengünstig
low-priced	günstig
lower-priced	preisgünstiger
loyal	treu
loyalty	Loyalität
lucid	klar
lucidly	klar
luck	Glück
luckier	glücklicher
luckiness	Glück
lucky	Glücklich
lucrative	lukrativ
luminous	leuchtend
lush	üppig
luster	Lüster
lustrous	glänzend
luxuriant	üppig
luxuriate	schwelgen
luxurious	luxuriös
luxuriously	luxuriös
luxury	Luxus
lyrical	lyrisch
magic	Zauber
magical	magisch
magnanimous	großmütig
magnanimously	großmütig
magnificence	Pracht
magnificent	großartig
magnificently	prächtig
majestic	majestätisch
majesty	Majestät
manageable	überschaubar
maneuverable	wendig
marvel	Wunder
marveled	staunte
marvelled	staunte
marvellous	fabelhaft
marvelous	fabelhaft
marvelously	wunderbar
marvelousness	Wunderbarkeit
marvels	Wunder
master	Meister
masterful	Meisterhaft
masterfully	meisterhaft
masterpiece	Meisterstück
masterpieces	Meisterwerke
masters	Meister
mastery	Meisterschaft
matchless	unvergleichlich
mature	reifen
maturely	reiflich
maturity	Reife
meaningful	sinnvoll
memorable	unvergesslich
merciful	barmherzig
mercifully	gnädig
mercy	barmherzig
merit	verdienen
meritorious	verdienstvoll
merrily	fröhlich
merriment	Heiterkeit
merriness	Heiterkeit
merry	fröhlich
mesmerize	hypnotisieren
mesmerized	hypnotisiert
mesmerizes	hypnotisiert
mesmerizing	hypnotisierend
mesmerizingly	hypnotisierend
meticulous	akribisch
meticulously	sorgfältig
mightily	mächtig
mighty	mächtig
mind-blowing	unglaublich
miracle	Wunder
miracles	Wunder
miraculous	Wunder-
miraculousness	Wunderbarkeit
modern	modern
modest	bescheiden
modesty	Bescheidenheit
momentous	bedeutsam
monumental	monumental
monumentally	Monumental
morality	Moral
motivated	motiviert
multi-purpose	Mehrzweck
navigable	schiffbar
neat	ordentlich
neatly	ordentlich
nice	nett
nicely	schön
nicer	schöner
nicest	netteste
nifty	flott
nimble	flink
noble	edel
nobly	edel
noiseless	geräuschlos
non-violence	Gewaltlosigkeit
non-violent	gewaltfrei
noteworthy	bemerkenswert
nourish	nähren
nourishing	nährend
nourishment	Nahrung
novelty	Neuheit
nurturing	pflegend
oasis	Oase
obsession	Obsession
obsessions	Obsessionen
obtainable	erhältlich
openly	offen
openness	Offenheit
optimal	optimal
optimism	Optimismus
optimistic	optimistisch
opulent	opulent
orderly	ordentlich
originality	Originalität
outdo	übertrumpfen
outdone	übertroffen
outperform	übertreffen
outperformed	outperformed
outperforming	outperforming
outperforms	outperforms
outshine	überstrahlen
outshone	überstrahlt
outsmart	überlisten
outstanding	hervorragend
outstandingly	hervorragend
outstrip	übertreffen
outwit	überlisten
ovation	Ovation
overjoyed	überglücklich
overtake	überholen
overtaken	überholt
overtakes	überholt
overtaking	Überholen
overtook	überholte
overture	Ouvertüre
pain-free	schmerzfrei
painless	schmerzlos
painlessly	schmerzlos
palatial	palastartig
pamper	verwöhnen
pampered	verwöhnt
pamperedly	verwöhnt
pamperedness	Verwöhntheit
pampers	verwöhnt
panoramic	Panorama-
paradise	Paradies
paramount	vorrangig
pardon	Pardon
passion	Leidenschaft
passionate	leidenschaftlich
passionately	leidenschaftlich
patient	geduldig
patiently	geduldig
patriot	Patriot
patriotic	patriotisch
peace	Frieden
peaceable	friedlich
peaceful	friedlich
peacefully	friedlich
peacekeepers	Friedenstruppen
peach	Pfirsich
peerless	unvergleichlich
pep	Pep
pepped	gepfeffert
pepping	picken
peppy	schwungvoll
peps	Peps
perfect	perfekt
perfection	Perfektion
perfectly	perfekt
permissible	zulässig
perseverance	Ausdauer
persevere	durchhalten
personages	Persönlichkeiten
personalized	personalisiert
phenomenal	phänomenal
phenomenally	phänomenal
picturesque	malerisch
piety	Frömmigkeit
pinnacle	Höhepunkt
playful	spielerisch
playfully	spielerisch
pleasant	angenehm
pleasantly	angenehm
pleased	zufrieden
pleases	gefällt
pleasing	erfreulich
pleasingly	angenehm
pleasurable	angenehm
pleasurably	genüsslich
pleasure	Vergnügen
plentiful	reichlich
pluses	Pluspunkte
plush	Plüsch-
plusses	Pluspunkte
poetic	poetisch
poeticize	poetisieren
poignant	ergreifend
poise	Haltung
poised	balanciert
polished	poliert
polite	höflich
politeness	Höflichkeit
popular	Beliebt
portable	tragbar
posh	vornehm
positive	positiv
positively	positiv
positives	Positives
powerful	mächtig
powerfully	kraftvoll
praise	loben
praiseworthy	lobenswert
praising	loben
pre-eminent	herausragend
precious	kostbar
precise	präzise
precisely	genau
preeminent	herausragend
prefer	bevorzugen
preferable	bevorzugt
preferably	vorzugsweise
prefered	bevorzugt
preferes	bevorzugt
preferring	bevorzugen
prefers	bevorzugt
premier	Premier
prestige	Prestige
prestigious	angesehen
prettily	hübsch
pretty	ziemlich
priceless	unbezahlbar
pride	Stolz
principled	prinzipientreu
privilege	Privileg
privileged	privilegiert
prize	Preis-
proactive	proaktiv
problem-free	problemlos
problem-solver	Problemlöser
prodigious	erstaunlich
prodigiously	ungeheuer
prodigy	Wunder
productive	produktiv
productively	produktiv
proficient	kompetent
proficiently	kompetent
profound	tiefgreifend
profoundly	zutiefst
profuse	reichlich
profusion	Fülle
progress	Fortschritt
progressive	progressiv
prolific	fruchtbar
prominence	Bedeutung
prominent	prominent
promise	versprechen
promised	versprochen
promises	Versprechen
promising	vielversprechend
promoter	Promoter
prompt	prompt
promptly	sofort
proper	richtig
properly	richtig
propitious	günstig
propitiously	günstig
pros	Profis
prosper	gedeihen
prosperous	wohlhabend
prospros	Prospros
protect	schützen
protection	Schutz
protective	schützend
proud	stolz
proven	bewiesen
proves	beweist
providence	Vorsehung
proving	beweisen
prowess	Fähigkeiten
prudence	Klugheit
prudent	umsichtig
prudently	umsichtig
punctual	pünktlich
pure	rein
purify	reinigen
purposeful	zielstrebig
quaint	urig
qualified	qualifiziert
qualify	qualifizieren
quicker	schneller
quiet	ruhig
quieter	leiser
radiance	Glanz
radiant	strahlend
rapid	schnell
rapport	Rapport
rapt	begeistert
rapture	Entrückung
raptureous	bezaubernd
raptureously	verzückend
rapturous	begeistert
rapturously	rauschhaft
rational	rational
reachable	erreichbar
readable	lesbar
readily	leicht
ready	bereit
reaffirm	bekräftigen
reaffirmation	Bestätigung
realistic	realistisch
realizable	realisierbar
reasonable	angemessen
reasonably	vernünftig
reasoned	vernünftig
reassurance	Beruhigung
reassure	beruhigen
receptive	empfänglich
reclaim	zurückfordern
recomend	empfehlen
recommend	empfehlen
recommendation	Empfehlung
recommendations	Empfehlungen
recommended	empfohlen
reconcile	versöhnen
reconciliation	Versöhnung
record-setting	Rekordeinstellung
recover	genesen
recovery	Wiederherstellung
rectification	Berichtigung
rectify	beheben
rectifying	berichtigen
redeem	einlösen
redeeming	einlösend
redemption	Erlösung
refine	verfeinern
refined	raffiniert
refinement	Raffinesse
reform	Reform
reformed	reformiert
reforming	Reformierung
reforms	Reformen
refresh	Aktualisierung
refreshed	aktualisiert
refreshing	erfrischend
refund	Rückerstattung
refunded	zurückerstattet
regal	Regal
regally	königlich
regard	betrachten
rejoice	jubeln
rejoicing	Jubel
rejoicingly	freuend
rejuvenate	verjüngen
rejuvenated	verjüngt
rejuvenating	verjüngend
relaxed	entspannt
relent	nachgeben
reliable	zuverlässig
reliably	zuverlässig
relief	Linderung
relish	genießen
remarkable	bemerkenswert
remarkably	bemerkenswert
remedy	Abhilfe
remission	Remission
remunerate	honorieren
renaissance	Renaissance
renewed	erneuert
renown	Ruhm
renowned	berühmt
replaceable	austauschbar
reputable	seriös
reputation	Ruf
resilient	belastbar
resolute	entschlossen
resound	erklingen
resounding	hallend
resourceful	einfallsreich
resourcefulness	Einfallsreichtum
respect	Respekt
respectable	respektabel
respectful	respektvoll
respectfully	respektvoll
respite	Aufschub
resplendent	strahlend
responsibly	verantwortungsbewusst
responsive	ansprechend
restful	erholsam
restored	restauriert
restructure	umstrukturieren
restructured	umstrukturiert
restructuring	Umstrukturierung
retractable	einziehbar
revel	schwelgen
revelation	Offenbarung
revere	verehren
reverence	Ehrfurcht
reverent	andächtig
reverently	ehrfürchtig
revitalize	revitalisieren
revival	Wiederbelebung
revive	beleben
revives	belebt
revolutionary	Revolutionär
revolutionize	revolutionieren
revolutionized	revolutioniert
revolutionizes	revolutioniert
reward	Belohnung
rewarding	lohnend
rewardingly	belohnend
rich	Reich
richer	reicher
richly	reich
richness	Reichtum
right	Recht
righten	righten
righteous	gerecht
righteously	rechtschaffen
righteousness	Gerechtigkeit
rightful	rechtmäßig
rightfully	rechtmäßig
rightly	richtig
rightness	Richtigkeit
risk-free	risikolos
robust	robust
rock-star	Rockstar
rock-stars	Rockstars
rockstar	Rockstar
rockstars	Rockstars
romantic	romantisch
romantically	romantisch
romanticize	romantisieren
roomier	geräumiger
roomy	geräumig
rosy	rosig
safe	sicher
safely	sicher
sagacity	Klugheit
sagely	weise
saint	Heilige
saintliness	Heiligkeit
saintly	heilig
salutary	heilsam
salute	Gruß
sane	gesund
satisfactorily	befriedigend
satisfactory	befriedigend
satisfied	zufrieden
satisfies	erfüllt
satisfy	erfüllen
satisfying	befriedigend
satisified	zufriedengestellt
saver	Sparer
savings	Ersparnisse
savior	Retter
savvy	kapieren
scenic	szenisch
seamless	nahtlos
seasoned	gewürzt
secure	sichern
securely	sicher
selective	selektiv
self-determination	Selbstbestimmung
self-respect	Selbstachtung
self-satisfaction	Selbstzufriedenheit
self-sufficiency	Selbstversorgung
self-sufficient	autark
sensation	Sensation
sensational	sensationell
sensationally	sensationell
sensations	Empfindungen
sensible	sinnvoll
sensibly	vernünftig
sensitive	empfindlich
serene	heiter
serenity	Gelassenheit
sexy	sexy
sharp	Scharf
sharper	schärfer
sharpest	schärfste
shimmering	schimmernd
shimmeringly	schimmernd
shine	scheinen
shiny	glänzend
silent	Leise
simpler	einfacher
simplest	einfachste
simplified	vereinfacht
simplifies	vereinfacht
simplify	vereinfachen
simplifying	vereinfacht
sincere	aufrichtig
sincerity	Aufrichtigkeit
skill	Fertigkeit
skilled	geschickt
skillful	geschickt
skillfully	geschickt
slammin	Slammin
sleek	glatt
slick	glatt
smart	Clever
smarter	schlauer
smartest	schlaueste
smartly	schlau
smile	Lächeln
smiles	lächelt
smiling	lächelnd
smilingly	lächelnd
smitten	geschlagen
smooth	glatt
smoother	glatter
smoothes	glättet
smoothest	glatt
smoothly	glatt
snappy	bissig
snazzy	schlau
sociable	gesellig
soft	weich
softer	weicher
solace	Trost
solicitous	besorgt
solicitously	besorgt
solid	solide
solidarity	Solidarität
soothe	beruhigen
soothingly	beruhigend
sophisticated	anspruchsvoll
soulful	gefühlvoll
soundly	solide
soundness	Solidität
spacious	geräumig
sparkle	funkeln
sparkling	funkelnd
spectacular	spektakulär
spectacularly	spektakulär
speedily	schnell
speedy	schnell
spellbind	Bindebinde
spellbinding	faszinierend
spellbindingly	faszinierend
spellbound	gebannt
spirited	temperamentvoll
spiritual	geistig
splendid	herrlich
splendidly	herrlich
splendor	Pracht
spontaneous	spontan
sporty	sportlich
spotless	makellos
sprightly	lebhaft
stability	Stabilität
stabilize	stabilisieren
stable	stabil
stainless	rostfrei
standout	auffallen
stately	stattlich
statuesque	Statuenhaft
staunch	stillen
staunchly	standhaft
staunchness	Standhaftigkeit
steadfast	standhaft
steadfastly	standhaft
steadfastness	Standhaftigkeit
steadiness	Gleichmäßigkeit
steady	stetig
stellar	stellar
stellarly	hervorragend
stimulate	stimulieren
stimulates	stimuliert
stimulating	anregend
stimulative	stimulierend
stirringly	gerührt
straighten	begradigen
straightforward	einfach
streamlined	gestrafft
striking	auffällig
strikingly	auffallend
striving	Streben
strong	stark
stronger	stärker
stunned	betäubt
stunning	atemberaubend
stunningly	atemberaubend
stupendous	gewaltig
stupendously	stupend
sturdier	robuster
sturdy	robust
stylish	stilvoll
stylishly	stilvoll
stylized	stilisiert
suave	süffig
sublime	sublimieren
subsidize	subventionieren
subsidized	subventioniert
subsidizes	subventioniert
subsidizing	Subventionierung
substantive	inhaltlich
succeed	gelingen
succeeded	gelungen
succeeding	Erfolg
succes	Erfolg
success	Erfolg
successes	Erfolge
successful	erfolgreich
successfully	erfolgreich
suffice	genügen
sufficient	ausreichend
sufficiently	ausreichend
suitable	geeignet
sumptuous	üppig
sumptuously	prächtig
sumptuousness	Pracht
super	Super
superb	hervorragend
superbly	hervorragend
superior	überlegen
superiority	Überlegenheit
supple	geschmeidig
support	Unterstützung
supported	unterstützt
supporter	Fan
supporting	unterstützend
supportive	unterstützend
supports	unterstützt
supremacy	Vorherrschaft
supreme	höchste
supremely	äußerst
supurb	supurb
supurbly	übertrieben
surmount	überwinden
surpass	übertreffen
surreal	surreal
survival	Überleben
survivor	Überlebende
sustainability	Nachhaltigkeit
sustainable	nachhaltig
swank	protzig
swankier	schicker
swankiest	Protzigste
swanky	mondän
sweeping	fegen
sweet	Süss
sweeten	versüßen
sweetheart	Schatz
sweetly	süß
sweetness	Süße
swift	schnell
swiftness	Schnelligkeit
talent	Talent
talented	talentiert
talents	Talente
tantalize	quälen
tantalizing	verlockend
tantalizingly	verlockend
tempt	versuchen
tempting	verlockend
temptingly	verführerisch
tenacious	zäh
tenaciously	hartnäckig
tenacity	Beharrlichkeit
tender	zärtlich
tenderly	zärtlich
terrific	großartig
terrifically	unglaublich
thank	danken
thankful	dankbar
thinner	Verdünner
thoughtful	nachdenklich
thoughtfully	nachdenklich
thoughtfulness	Nachdenklichkeit
thrift	Sparsamkeit
thrifty	sparsam
thrill	Nervenkitzel
thrilled	begeistert
thrilling	spannend
thrillingly	aufregend
thrills	Nervenkitzel
thrive	gedeihen
thriving	blühend
tickle	kitzeln
tidy	aufgeräumt
time-honored	altehrwürdig
timely	rechtzeitig
tingle	kribbeln
titillate	kitzeln
titillating	kitzelnd
titillatingly	kitzelnd
togetherness	Zusammengehörigkeit
tolerable	erträglich
toll-free	Zollfrei
top	oben
tops	Oberteile
tough	zäh
tougher	härter
traction	Traktion
tranquil	still
tranquility	Ruhe
transparent	transparent
treasure	Schatz
tremendously	unglaublich
trendy	modisch
triumph	Triumph
triumphal	Siegeszug
triumphant	triumphierend
triumphantly	triumphierend
trivially	trivial
trophy	Trophäe
trouble-free	störungsfrei
trump	Trumpf
trumpet	Trompete
trust	Vertrauen
trusted	Vertrauenswürdige
trusting	vertrauend
trustingly	vertrauensvoll
trustworthiness	Vertrauenswürdigkeit
trustworthy	vertrauenswürdig
trusty	vertrauenswürdig
truthful	wahrheitsgemäß
truthfully	wahrheitsgemäß
truthfulness	Wahrhaftigkeit
twinkly	funkelnd
ultra-crisp	ultra-knackig
unabashed	unverfroren
unabashedly	ungeniert
unaffected	unberührt
unassailable	unangreifbar
unbeatable	unschlagbar
unbiased	unvoreingenommen
unbound	ungebunden
uncomplicated	unkompliziert
unconditional	bedingungslos
undamaged	unbeschädigt
undaunted	unerschrocken
understandable	verständlich
undisputable	unbestreitbar
undisputably	unbestritten
undisputed	unbestritten
unencumbered	unbelastet
unequivocal	eindeutig
unequivocally	eindeutig
unfazed	unbeeindruckt
unfettered	entfesselt
unforgettable	unvergesslich
unity	Einheit
unlimited	unbegrenzt
unmatched	unübertroffen
unparalleled	beispiellos
unquestionable	unbestreitbar
unquestionably	zweifellos
unreal	unwirklich
unrestricted	uneingeschränkt
unrivaled	konkurrenzlos
unselfish	selbstlos
unwavering	unerschütterlich
upbeat	optimistisch
upgradable	aktualisierbar
upgradeable	aufrüstbar
upgraded	aktualisiert
upheld	aufrechterhalten
uplift	erheben
uplifting	erhebend
upliftingly	erhebend
upliftment	Anhebung
upscale	gehoben
usable	verwendbar
useable	brauchbar
useful	sinnvoll
user-friendly	benutzerfreundlich
valiant	tapfer
valiantly	tapfer
valor	Tapferkeit
valuable	wertvoll
variety	Vielfalt
venerate	verehren
verifiable	überprüfbar
veritable	veritable
versatile	vielseitig
versatility	Vielseitigkeit
vibrant	beschwingt
vibrantly	vibrierend
victorious	siegreich
victory	Sieg
viewable	Sichtbar
vigilance	Wachsamkeit
vigilant	wachsam
virtue	Tugend
virtuous	tugendhaft
virtuously	tugendhaft
visionary	visionär
vivacious	lebhaft
vivid	lebhaft
vouch	bürgen
vouchsafe	gewähren
warm	warm
warmer	Wärmer
warmhearted	warmherzig
warmly	herzlich
warmth	Wärme
wealthy	reich
well	Gut
well-balanced	ausgewogen
well-behaved	brav
well-being	Wohlbefinden
well-bred	wohlerzogen
well-regarded	geschätzt
well-wishers	Gratulanten
wellbeing	Wohlbefinden
whoa	whoa
wholesome	gesund
whooa	Whooa
whoooa	Whoooa
wieldy	handlich
willing	bereit
willingly	bereitwillig
willingness	Bereitschaft
win	Sieg
windfall	Glücksfall
winnable	gewinnbar
winner	Gewinner
winners	Gewinner
winning	gewinnen
wins	Gewinnt
wisdom	Weisheit
wise	weise
wisely	weise
witty	witzig
won	gewonnen
wonder	Wunder
wonderful	wunderbar
wonderfully	wunderbar
wonderous	wundersam
wonderously	wundersam
wonders	Wunder
wondrous	wundersam
woo	umwerben
work	Arbeit
workable	praktikabel
works	funktioniert
world-famous	weltberühmt
worth	wert
worth-while	lohnend
worthiness	Würdigkeit
worthwhile	lohnend
worthy	würdig
wow	Beeindruckend
wowed	begeistert
wowing	wowing
wows	wows
yay	Yay
youthful	jugendlich
zeal	Eifer
zenith	Zenit
zest	Zitrusschale
zippy	flink
-	-
very	sehr
very	ganz
incredibly	unglaublich
absolutely	durchaus
awfully	furchtbar
enormously	großmächtig
extremely	überaus
horribly	schrecklich
seriously	ernst
pretty	ziemlich
too	zu
really	wirklich
most	meist
more	mehr
-	-
no	nein
not	nicht
can't	nicht
won't	nicht
doesn't nicht
don't	nicht
shouldn't	nicht
n't	nicht
didn't	nicht
couldn't	nicht
wouldn't	nicht
-	-
little	wenig
enough	genug
enough	reichend
-	-
can	kann
can	kannst
can	können
could	konnte
could	konnten
could	könnte
could	könnten
might	vielleicht
should	sollten
should	sollte
