a ver si @selectavision anuncia pronto en cines la nueva pelicula de	URL	mazinger z	2
la única ciudad en la que , cuando me voy , se me rompe el alma : ( @	URL	sagrada familia	2
@_paisajes_ :	( barcelona) . PIC ojalá aquí otra vez @sansanper91	sagrada familia	2
mañana turisticaa ! parc güell ,	, el zoo(aunq sin ver a los delfines !! ) , passeig de gràcia ...	sagrada familia	2
en #vueling rumbo a	sobre un mar de nubes PIC	santiago de compostela	2
hermosa vista de la catedral de	. @cafe… URL …	santiago de compostela	2
	existe !!! :p ( at @aenaaeropuertos ) [ pic ] — URL	santiago de compostela	2
¡hasta el lunes carrefour ! me voy para #	:d PIC	santiagodecompostela	2
@tony__aguilar tony tienes que venir a	algun dia !	santiago de compostela	2
@angelaviye : por fin aquiiiiiii #	:d PIC ¡bieeeeen ! espero q hayais disfrutado chiqis @laura93enfer	santiagodecompostela	2
@alvarorrego llevame si vas a	! :d	santiago de compostela	2
@sssalmi @ayelenmulet callense ustedes . es genial el		big ben	2
@	clock : 15 minutes .... / me encantaria estar alli !!!	big_ben	2
puta steelers perdimos hiso falta el		big ben	2
torre isabel ii me gusta mas		big ben	2
que bella eres rt @chiqui_delgado : me la llevo ! @trocadero -	- paris URL	eiffel tower	2
imposible no tener hambre (@mercat de sant josep - @la_	in barcelona ) URL	boqueria	2
la	, ramblas , plaça catalunya , que recuerdos ((((((((( < 3	boqueria	2
@bretesesamo @anilor venir venir !!!! podemos ir a la rambla , a barceloneta , a la	, a la ovella negra	boqueria	2
mi vida a cambio de una visita al		louvre	2
abuelita rosangela me puedes llevar al museo de	paris porfis	louvre	2
nos fuimos rt @tinabreu97 : mami , llévame al museo del		louvre	2
karina va al	:-( #envidia .	louvre	2
jo , quiero ir al		parc güell	2
uff rt @irinagz : amaneci con ganas de teletransportarme a		parc güell	2
mañana turisticaa !	, sagrada familia , el zoo(aunq sin ver a los delfines !! ) , passeig de gràcia ...	parc güell	2
llevadme a ver la		sagrada familia	2
ojalá ir al	, ojalá ir al camp nou , ojalá ir al parque güell , ojalá ir a barcelonaaaa	tibidabo	2
jo , quiero ir al		parc güell	2
deseando volver a parís , sólo estuve estuve una vez (( #	PIC	torreeiffel	2
i will rt @carolinabc_ : quiero ir rt @picslncreibles :	en parís , francia . PIC	torre eiffel	2
yo quierooo @cnnee : la	estrena un piso de cristal que da vértigo URL	torre #eiffel	2
quiero llorar a ver la	alguien regréseme a europa ya	torre eiffel	2
que ganitas de volver #paris ' 14 #	URL	torreeiffel	2
dios , que bella la	PIC	torre eiffel	2
comiendo y con buena música @la	mercat URL …	boqueria	2
con el puppy en bilbao #	# @guggenheim modern art museum URL	guggenheim	2
domingo relajante #	@museo guggenheim bilbao URL …	guggenheim	2
algun dia te visitare ! :d museo	de bilbao .	guggenheim	2
hoy fue un buen día en bilbao ! @museo	URL	guggenheim	2
ultimo dia en london , pero gran dia : visita a	, mercadillo d camdem ... y pasar la noche al aeropuerto	buckingham palace	2
@rgaggero una maravilla la	! vayan al park guell ! yo no alcancé	sagrada familia	2
por poco no cuento la visita d la	!! q vertigooo !! ( PIC	sagrada familia	2
@chezmaferrr siiii a mi me impresiono la	!!! quiero regresar !!	sagrada familia	2
@carolsanz q locura ! tan bella mi	de gaudi .	sagrada familia	2
de camino a	! ultimo dia	tibidabo	2
hoy vi un sofa con mi	!!!! *-* pero ni vendiendo mi celular lo compro no llego ni al cuadro .	torre eiffel	2
@cnnee : la	estrena un piso de cristal que da vértigo URL debe ser lo mejor	torre #eiffel	2
amo tanto a la		torre eiffel	2
@jottacrz llevame a ver la	* --- *prometo no hacer bulto	torre eiffel	2
ya quiero tener mi foto con la		torre eiffel	2
que divina es la	! y mi amigo la esta re gozando ! PIC	torre eiffel	2
me quiero tatuar la		torre eiffel	2
quiero una foto con la	!!!	torre eiffel	2
@ml_2901 si igualito ! - . - ( nooo ! a ki me traes la	pero la verdadera e.e !	torre eiffel	2
@kirstiealleii : quiero ir a paris a la	ves montecarlo bifi ?	torre eiffel	2
quiero volver a ir a la	(	torre eiffel	2
quiero ir a la	.	torre eiffel	2
quiero ir a la	:-(	torre eiffel	2
quisiera ir a francia a conocer la	.	torre eiffel	2
@ampitowi @jugegi @solecansino @elenitafenty yo quiero ver la	chicas no nos podemos ir de ahi sin verlaaaaaaa	torre eiffel	2
quiero volver ir a ver la	de noche	torre eiffel	2
regresando del alucinante	bilbao (@hesperia donosti hotel - @nh_hotel_group ) URL	guggenheim	2
así disfruta @pablocarro17 de la visita al museo	de bilbao #adolescenciamaravillosa :-) PIC	guggenheim	2
@nereaunzalu y yoo nerea ! me lo estoy pasando bien en bilbao viendo el	.. pronto nos vemos mi amor	guggenheim	2
sin duda la exposición del	de bilbao de l’art en guerre tiene una pinta maravillosa . una pena no poder disfrutarla	guggenheim	2
quién tuviera tiempo y dinero para ir hasta bilbao a ver la exposición de schiele en el	URL ? utm_source =p ais&utm_medium =d isplay&utm_content=300x250&utm_campaign=eshiele …	guggenheim	2
en bilbao tienen el	, una maravilla . en avilés : el centro niemeyer , otro lujo . en santander tenemos una grua de piedra . :-(	guggenheim	2
rt @mvdsister : lloviendo en bilbao , dia especial para visitar el	- fantastico !	guggenheim	2
veo	y extraño tanto london	buckingham palace	2
me encanta el	, pero es muy caro entrar aunque aquí te cobran por todo .	buckingham palace	2
yo me kiero casar en el	y con el principe guillermo	buckingham palace	2
lo cual demuestra que en el pedestrismo está el secreto de la delgadez . lástima que acá no tenemos una	.	champs elysees	2
extrañar las meriendas en	URL	champs elysees	2
en navidad fue horrible yo comiendo árabe y a todo le tenía asco , jajajajaja . pero fue lindo cuando fuimos a les	y	champs elysees	2
ponen aux	de fondo y mis ojos se ponen llorosos quiero regresaaaar !	champs elysees	2
quiero estar paseando por les	yaaaaa , y no aquí	champs elysees	2
oh	! ( pero en mi caso no encontré el amor )	champs elysees	2
nada mejor que saber q mi ultimo dia en francia estare en	y en la tour eiffel @susyguerra97 #nomequieroir	champs elysees	2
na ' que tengo trabajo y clase hasta las 9 , mientras @elivares5 se pasea por les	, envidia	champs elysees	2
@ninnaline como extraño nuestros brunchs de domingo en laduree !!! seguidos por shopping o cine en	... paris rocks ...	champs elysees	2
quiero estar en los	ahora .	champs elysees	2
hace un chorro de frío aquí en parís , pero me encanta andar caminando por	, está tan bonit ... awww ya me desperté	champs-elysees	2
@ginasommelier // cuidate mucho y disfruta !! como extraño caminar los		champs elysees	2
últimos 10kms del tdf2010 disfrute el paseito por los		champs-elysees	2
@esojozorep	es como bella vista pa mi . pffffffff quiero la virgin megastore	champs elysees	2
@davo0202 nada muy típico ... si , ya fui al mercado de la	: fantástico . búscalo en google , te va a encantar .	boqueria	2
vistas espectaculares de londres desde el	... tarde emotiva :-(	london eye	2
me he montado en el	porque cuando fui hace 4 años no pude y ha sido muy guay PIC	london eye	2
las vistas desde el	son espectaculares . pero vaya frío estamos pasando @abelpucela y yo PIC	london eye	2
no puedo morir sin montar en el	:-(	london eye	2
me obsesioné con la	.	torre eiffel	2
@haiti1990 en	bilbao . eso es arte ! by nandorubalcava URL	guggenheim	2
museo	bilbao . luces y sombras , experimentando sensaciones con andy warhol . #fotografía #huawei ... PIC	guggenheim	2
	!! visita express a bilbao PIC	guggenheim	2
lugares para visitar : museo	bilbao URL	guggenheim	2
impresionante !! :d #bilbao (@museo	w/ 10 others ) [ pic] : URL	guggenheim	2
en el	. precioso bilbao PIC	guggenheim	2
	, stockholm . los mejores #paisajes de todo el #mundo para ti PIC PIC	gamla stan	2
llevadme a ver la		sagrada familia	1
@tomasnavarropsi @patri_psicologa sobre qué hora será ese #psicorunning en #	? no se si podré ir (( que rabia !!	santiagodecompostela	1
llevadme a ver la		sagrada familia	1
gentes de	, acudid URL …	santiago de compostela	1
apuntad : 20 de abril en	URL …	santiago de compostela	1
noche de luna llena hoy en	URL	santiago de compostela	1
@17blackkleigh si eres de	animate ! :d URL	santiago de compostela	1
@sonymusicspain ... q venga @_maluoficial_a firmar discos al corte ingles de	..... ))))	santiago de compostela	1
“ @telediariogt : fuegos pirotécnicos iluminaron el	para dar la bienvenida al 2015 . PIC ” @vale_ortega	big ben	1
{ mi	brilla mas que mi futuro . }	big ben	1
vamos a tener el instagram petao de fotos del	, picadilly , tower bridge ... mierda	big ben	1
@emi_olexyn de que te reis rubio ? dame mi		big ben	1
@kalushafilms @espnsutcliffe @alvaronflmartin le falta línea ofensiva , la actual es ofensiva pero para	y fanaticos ...	bigben	1
no me capturen a		big ben	1
quise copiar al	, perdón .	big ben	1
quiero el	de foam que lleva en la chirigotaaaa !!!!!	big ben	1
greipel ganó en	. terminó el tour . #tdf	champs-elysees	1
embajada de qatar frente a al arco del triunfo ! en el	! #arabes #millonarios URL	champs elysees	1
@allanhavok :o !!! </3 al menos tráemeee el #típico llavero #	si te vaasss a parís ! : 3	eiffeltower	1
@txemistry qué va txemistry ... no subí al	...	london eye	1
oh esta es mi favorita del	PIC	louvre	1
soñé que iba al	mis goals en la vida	louvre	1
quién me lleva al museo smithsonian , al	o el hermitage ??	louvre	1
@llamamecristina en un hotel cerca del	que se llama washington operaaa peru mañana me voy .	louvre	1
@bvlxp pero sí es , está en	PIC	parc güell	1
me perdí buscando el		parc güell	1
camp nou ,	, corte ingles , rambla catalunya . quiero llorar	parc güell	1
la lizard ! jajaja me photobombearon #	#barçatits URL	parcgüell	1
titooooooo rt @anaceciliacm : invitado especial en	PIC	parc güell	1
	apagada por ataque en barcelona PIC	torre eiffel	1
@sebtsb estuve el viernes en la		torre eiffel	1
perdí mi llavero de la		torre eiffel	1
@bennsuedefk @chloexwells el mío sale la	no me hagáis sufrir	torre eiffel	1
@ce_elee la	eres tú :-(	torre eiffel	1
perdí mi cadenita de la		torre eiffel	1
@cnnee : la	estrena un piso de cristal que da vértigo URL	torre #eiffel	1
@richardbaez1100 fuiste al	?	big ben	1
@wilhelmeditor asi como a gaudi le parecia que siempre le faltaba un detalle ... y murio sin terminar la	...	sagrada familia	1
ruffilio esta en la	y no me invito #dondeestaruffilio URL …	torre eiffel	1
mi prima tiene una foto en la	con su novio . ya voyyy a ir a paris con un chongo , van a ver	torre eiffel	1
yo tenia q ser chilena q verguenza q una chilena alla rallado la	( dejan super mal al pais	torre eiffel	1
me siento como si la	callera sobre mi : ´(	torre eiffel	1
se cruza bailarina frente a la	con el sol a favor , alcanzo a sacarle una foto y uds . no dan ni like URL	torre eiffel	1
veo la	desde mi balcon , si claro , yo ni balcon tengo	torre eiffel	1
google te lleva por un paseo virtual a la	URL … ya si no me llevan !	torre eiffel	1
ver la	solo por television	torre eiffel	1
la	tan cerca pero tan lejos PIC	torre #eiffel	1
museo	de bilbao . la mascota pupi , siempre vigilante hoy en discreto tono verde invernal URL	guggenheim	1
los que estáis viendo a bob dylan en el	bilbao . malas personas , yo no he podido ( la verdad que por tonto) .	guggenheim	1
+_+ rt @ryukenichi : como el moma , el	de bilbao o la ópera de sydney < -- cuanto daño ... . URL	guggenheim	1
@marianacabralmx pues si tle quieres venir a bilbao a ver el	, te invito … sino un dia por skype : arketipo.net :-(	guggenheim	1
alguien se metió a	con una espada ???!?!?! ¿¿ y atacó a los guardias y	buckingham palace	1
a ver . que tiene truco . tengo que afrontar más o menos los mismos gastos que la reina isabel en	.	buckingham palace	1
en	esperando a la reina , pero nos dijeron que estaba de vacaciones #london … URL	buckingham palace	1
buenas noches , mañana	buckingham palace y a casa	london eye	1
sabeis que ? he estado en londres y el dia en el que niall va a	, yo fui el dia antes y no le vi .. me ha dado coraje : ´(	buckingham palace	1
en el	esperando un cambio d guardia ... que no llega !!!!: -( URL	buckingham palace	1
hoy visita al	y al natural history museum ... primera semana agotada demasiado rapido va esto	buckingham palace	1
@xmmallo @jlcudeiro ni me hables . yo en londres si ascndemos ese día , no m va a quedar más remedio q subirme al techo d		buckingham palace	1
@gyorgo7 @jisas15 @msousa91 xdddddddddd ha sido angelines con una valla en	( tendría gracia si conociérais a angelines )	buckingham palace	1
no vamos a tener fotos de la visita de gillian a	??? :-(	buckingham palace	1
	y cambio de guardia real , hyde park y oxford street . y me quedé sin mi crepe de nutella de despedida @tony8921	buckingham palace	1
y también quiero ir a	vestida sólo con una sábana , pero creo que @greendogbex no me va a dejar	buckingham palace	1
@jjorge_kennedy ya estoy de vuelta para mi desgracia muy fuerte que nos encontráramos en el	!	buckingham palace	1
el oficial que murió en el ataque a los	además de activista por los derechos gay era bastante atractivo .	champs-elysees	1
@joe_trouble hoy caminando por	vi un five guys y estaba por entrar gracias a tu consejo y aún estaba en construcción	champs-elysees	1
tengo una foto como la de wintour en maison laduree que subió el times , solo que la mía es en	no en ny	champs elysees	1
un día estás comprando en	de parís y al otro en santa f de la cdmx ... dios da , dios quita	champs elysees	1
@odiositora me gusta ese banner de lv en	pero me hace gastar mucha plata	champs elysees	1
mi ultimo día en europa		champs elysees	1
ahora que lo veo .. cuando vi el f1 de red bull en	era muy seguro que ahí estaba la tienda .. y por la prisa no la pude ver	champs-elysees	1
yo he estado en parís , les	— yo también , pero en invierno . quisiera poder ir en primavera ( URL	champs elysees	1
lo único qué me duele es qué tenía está imagen en mi mente de qué paseábamos a nuestros hijos en la avenida les	.	champs-elysees	1
@mikediaz_20 mjú !!! hoy iba decidido a la tienda del psg en	y cuando llegué ya estaban cerrando . (((((	champs elysees	1
@georginacanse es que jetlag + caminar de la torre al arco y todo	hasta louvre y de ahí a la torre de nuevo fue mortal :	champs elysees	1
quiero volver a la disney store de	, parís con mi albani	champs elysees	1
@jacqueliine98 estoy en la	atras del britanico vez me tienes que hablar mas seguidoo	champs elysees	1
@reginasotres (((((( ya tan rapido ? ((( bueno es marca alemana asi que seguro en	o en lafayette !	champs-elysees	1
@jo_aguirre @horaverde929 jajajaja nooo !! eso fue clásico ! me siento como paseando por los	nooop , cadena ! q mal jaja	champs elysees	1
@marian_frias he leido q ryanair te ha dejado en tierra ... a ver si por una casualidad , te veo por	:p y me alegras el dia	champs elysees	1
paseo por	y todo lleno de alemanes imposible no acordarse de la enanana te echo de menos inmigrante @mcoorbacho_s	champs elysees	1
me estan dando unfollow , cada unfollow que me hacen provoca que una millonaria francesa pierda su cheque en les		champs elysees	1
nos llevaron a comprar a les	y nos dejaron libres por 4 horas , me duelen horriblemente los pies de tanto caminar	champs elysees	1
en paris hace frío y yo sin un abrigo nice para lucir en les		champs elyseès	1
zayn ha estado hoy paseando por la avenida de les	, yo estuve allí paseando hace 2 semanas , ¿por qué no fue hace 2semanas ? (	champs elysees	1
awww debemos volver jejeje a esta hora caminábamos por	rt @mariovocalsong : parís hace 6 meses te veias espectacular !	champs-elysees	1
loco vengan a	en frente de river me re aburro	champs elysees	1
@esejp bueno , cuando sea rico y famoso mandaré poner muchas lucesitas como en	. eso si no se acaba el mundo antes .	champs elysees	1
“ @miguiadeparis : concierto de música clásica en le théâtre de	#parís URL e-des-champs-elysees . html … ” -yo quiero -	champs elysees	1
@ilidi sabes q fui a los	y de las cosas q pense fue ! aqui es donde le dieron los premios a armstrong ! gran referente #sad	champs-elysees	1
@annic46 me da mucha penita , tengo vacaciones pero ... ir ahora y en navidad es mucho ! yo te espero aquí y lo celebramos en		champs elysees	1
@aldoboots sii y te estoy esperando para que me entregues mi collar de perlas en los		champs elysees	1
@paoo_vii8 síííí ! y sufro muchoo ! para colmo , mi escritor francés favorito va a estar en	firmando autógrafos !	champs-elysees	1
@soymilkman hey ! fui al h&m de	y no encontré nada de esa edición , creo que ya se acabó	champs-elysees	1
quiero ser como esas japonesas que entran a louis vuitton de	y compran miiiil bolsos	champs elysees	1
ultimo paseo con @verouy en paris por	!! te extrañare amigaaa	champs elysees	1
y por ultima noche parisina una vez mas rumbo a	a echar trago . juai not ? ya casi me tienes d vuelta @iliabv : *	champs elysees	1
@juanoyervides quiero el sls amg quien me lo patrocina ? // goey ya sé !! lo tienen en exhibición en	... otra cosa	champs elysees	1
hace exactamente un anio estaba vuelta loca en	haciendo mis ultimas compras antes de regresar a mexicooo	champs elysees	1
quisiera tanto ir a la inauguración de h&m en		champs elysees	1
anoche soñé que vivía en barcelona , en un depto chiquito , sobre la rambla a pasitos del mercado de la	. pero no , estoy acá .	boqueria	1
último dia de vacaciones !! ( vamos a desayunar a la	y después ave para madrid . goo	boqueria	1
@noe_liagp @sandriuss89 @vaiolet13 yo tambien quiero volver , para poder ir a la	y coger un empacho de bombones	boqueria	1
@albertobarbas sí , cerca de la	y un salón recreativo que había al lado . enrique tomás va a montar el museo del jamón de 2100m2	boqueria	1
no me deja tuitear la foto de los zumitos del mercat de la	, llevo toda la tarde intentandolo jee	boqueria	1
otro año sin sonar :-( richie pinchando ahora en la	...	boqueria	1
esta tarde @richiehawtin estará en barcelona en el mercado de la	, mataría por poder estar ayi .	boqueria	1
no encuentro salami en la	. dice el charcutero que no se vende ¡pero si es #mibocatafavorito	boqueria	1
groupon me sigue llegando por mas que lo cancelo . ahora ofertas en la		boqueria	1
mañana lunes pero me voy de excursión a barcelona , al mercat de la	, pero solo tres 4 horas .... pero la 4 horas restantes	boqueria	1
en la	y yo sin mi cámara .	boqueria	1
@saskiasantana ya pero no me da ttiempo es que hoy mis padres quieren comprar marisco en la	y hacerlo en el apartamento	boqueria	1
desayunando en la	bcn y a pocas horas de volver a casa , con pocas ganas de marcharme	boqueria	1
@nicoriva manana , lluvia si vas a la	, hay catas ( gratuitas ) de comida de la region italiana campania hoy , sab y dom	boqueria	1
el de la esquina superior izquierda es el	pero no se nota mucho en la foto PIC	london eye	1
hoy he visto el	, que hacía tiempo que no lo veía ... aunque solo de paso PIC	london eye	1
ya hemos ido al	y no me he echado una foto así	london eye	1
@romigmzz te subiste al	? yo no xq me dio alto cagaso jajajaja	london eye	1
@memobarba y yo pensando que era		london eye	1
ok expliquenme quien se atreve a amenazar la	?? </3	torre eiffel	1
quiero volver a ir a londres , no me tome foto en el		big ben	1
@genejean sounds like fun ! i have been to	myself :-) @medievaltrees @dannj2	buckingham palace	1
fuiste a	algunha vez ? y si fuiste te gusto galicia ? ( @lorenacastell live on URL )	santiago de compostela	1
a ver el musical de mecano , hoy no me puedo levantar ! :d luis maitane (@museo	in bilbao , bizkaia ) URL ? s=rcseb7woswnh-vn7xi7qbcrcjfa&ref=tw …	guggenheim	1
la foto es mía !!! @zurfers : el	de bilbao , españa | the guggenheim in bilbao , spain ( by @clarita_vs ) URL	guggenheim	1
bilbao ,	, araña y sol URL . php ? fbid =10201777028884479&set =o . 325048857538709&type=1&theater … vía facebook saludos vecinos : )	guggenheim	1
fantástico pic ! mil gracias x todo , my friend ! :-) ) @apardo59 : #laguiamichelin2014 en	bilbao PIC	guggenheim	1
jajaja ! :-) ))) @gastrorosarivas : bibendum pasó la noche en el	bilbao #michelin2014 ' davidxo ' night ... PIC	guggenheim	1
#guiamichelin2014 :-) ) mt @apardo59 el team que pilotará la nave de #laguiamichelin2014 en	bilbao PIC	guggenheim	1
ya en bilbao , hotel con vistas al	y la ria @victort_a @mediavilla91 @ulloajm @edun_p PIC	guggenheim	1
URL . php ? f bid=10150961361840620&set=a . 10150961356105620.527956 . 57579540619&type=3&theater … una obra mia en	bilbao quien iba a pensarlo .... madre mia ... mi foto es las mas darki .... :p i love puppy !	guggenheim	1
uuuuuhhhhh ... la fortaleza	de #oslo tiene fantasmas ... PIC	akershus	1
@tomasnavarropsi @patri_psicologa sobre qué hora será ese #psicorunning en #	? no se si podré ir (( que rabia !!	santiagodecompostela	0
acaban la	antes del gol 500 de messi .	sagrada familia	0
	. larga cola para entrar :-( PIC	sagrada familia	0
adiós , tengo que ir a		sagrada familia	0
solo ami me levantan a esta hora para ir a la		sagrada familia	0
a la	le salía humo negro	sagrada familia	0
a miiii , quiero ver a	antes de que se retire	bigben	0
@ciskool / ayñ tenía que mamar	!	big ben	0
@anfieldgt qué le pasó a	?	bigben	0
el '	' ya no suena a la hora correcta . URL …	big ben	0
el	de mi tl da la hora de ny .	big ben	0
me parece a mí o el	dejó de twittear :' (	big ben	0
que hueva si se va	la próxima temporada	big ben	0
ya valió madres , ay		big ben	0
@nflmx : los steelers no descartan reclutar a un quarterback , ¿’	' en riesgo ? URL nooo	big ben	0
@mariluzbaeza5 @mmarbonillo	si que es dificil , aqui solo hay una opcion , hablar del big ben	big ben	0
ir a	es perder mucha plata	big ben	0
adiós al mvp de		big ben	0
puta madre se lesionó el	: (	big ben	0
mi	para mi maqueta quedoo feoo	big ben	0
la	, una slot machine :-( URL	boqueria	0
cerrado por vacaciones hasta el 28 .... ( @mercat la	, barcelona URL	boqueria	0
tío que se va a inundar el		louvre	0
buuu el universal - cultura - el	cierra por manifestación de sus vigilantes UR L.h tml … via @el_universal_mx	louvre	0
entrades al	de 7 a 8€ a partir de l'octubre...	parc güell	0
a partir de octubre de 2013 habrá que pagar más de 5€ por visitar el	PIC	parc güell	0
tristemente esta es mi reseña de la	. PIC	torre eiffel	0
4hrs para subir la	mejor contrato alguien que haga fila por mi . PIC	torre eiffel	0
#francia impactante la foto de la #	quemandose URL …	torreeiffel	0
me da cosita ver la	apagada	torre eiffel	0
es tan triste ver a la	apagada URL …	torre eiffel	0
la	se apaga #parís URL #prayforparis	torre eiffel	0
lo malo de la	URL	torre eiffel	0
@javi_ceuti : entramos al	@maria_yeah PIC q envidiaaa zorrones !! yo no me pude montar	london eye	0
colas kilometricas para ver la	, PIC	sagrada familia	0
mi	se esta transformando en la torre de pisa PIC	torre eiffel	0
mi	ahora parece torre de pisa	torre eiffel	0
@noticiasvenezue : la	continúa cerrada por huelga URL ? utm_campaign=twitter&utm_medium=twitter&utm_source=twitter … :-(	torre eiffel	0
la	produce muchisisisisisisisima plata !!!!	torre eiffel	0
creo que si tengo un gran trauma con la		torre eiffel	0
a la porra la	, a cambiarle el vidrio . el vetusto papiro egipcio sobrevive a todo !!! PIC	tour eiffel	0
@noticiasvenezue : la	continúa cerrada por huelga URL ? utm_campaign=twitter&utm_medium=twitter&utm_source=twitter … :-(	torre eiffel	0
hostia , que putada lo del		big ben	0
estuve esperando a que cargara y nada , que no puede estar el	en obras por tos los laos	big ben	0
si vas que sea cuando el	no esté todo tapado por dios sigo con bronca ay gracias jiji	big ben	0
para mi mala suerte , al	lo estan remodelando y se mira bien culero	big ben	0
punyeta món ! visito #london por primera vez y ... el #	está en obras ! ¡lo nunca visto ! qué mala suerte	bigben	0
duele decirlo , pero creo que	ya dio lo que tenía que dar	big ben	0
esto ya no es cierto . el	está silenciado URL …	big ben	0
así fueron las últimas campanadas del	URL 01659625697281 … no nos tocará .. @mmmdolores @juanrge	big ben	0
va a sonar ahora el	por última vez hasta dentro de 4 años	big ben	0
ya no estoy feliz va a estar en reparación el	por 4 años	bigben	0
el	dejará de sonar sus campanas 4 años	big ben	0
hoy estuve en el museo	de bilbao , vi una exhibición nazi , cualquier parecido con la realidad venezolana es pura coincidencia :-(	guggenheim	0
¡¿julieta venegas en el	de bilbao ?! … #wtf … la vida no vale nada…	guggenheim	0
la foto de hoy .: museo	en bilbao . a este paso , coctel molotov incluido en el precio ... PIC	guggenheim	0
bueno ya he visto	por la noche , que jaleo de coches y gente ... y las fotos ademas quedaron mal	buckingham palace	0
se suspendió la ceremonia de prender las luces de	((( al cabo que ni me gusta dujardin .	champs elysees	0
como cuando me cargo en		champs elysees	0
¡feliz 14 de julio , amigos franchutes ! hace un año estaba en el desastre en		champs elysees	0
en	fué imposible de entrar una cola de dos cuadras y lo mismo punto pie . fué horrible #blackfridayasu	champs elysees	0
	de reforma esta perdiendo el estilo	champs-elysees	0
@sogtulakk si es terrible con este calor ser devorada por turistas en		champs elysees	0
en la	los animales son plaga ? definitivamente no volveré a ese restaurante por lo menos no al de menga	boqueria	0
ayer fue el día internacional del gato y yo los amo y tuve una mala experiencia en la	de menga	boqueria	0
mucho frío y mucha gente .. y sin mis jirafas (@mercat de la	w/ 4 others ) [ pic] : URL	boqueria	0
una pena que este cerrado yo que quería mi zumo de frambuesa ... (@mercado de la	) URL	boqueria	0
la	cierra los domingos (((( (@mercat de la boqueria ) URL	boqueria	0
@fernandosainz ¿que va a cerrar el bulli ? no puede ser , la	no será la misma . qué ganas tengo de regresar a 2008 .	boqueria	0
muero mucho por subirme al	pero es muy muy muy caro	london eye	0
mal tiempo para subir al #	tenemos por aquí espero que lo disfrutes aunque sea en gris	londoneye	0
el	te guiña , mueren cientos de sus pasajeros	london eye	0
cuando conoci el	era el british airways london eye , agora es el coca cola london eye …	london eye	0
( omg ! rt :“ @mkdirecto : coca-cola	será el nuevo nombre de la noria más famosa del mundo URL ”	london eye	0
	en remodelacion hasta el infinito PIC	big ben	0
en el hotel domine de bilbao @hotelessilken lástima q no tengo vista al	:-( #riojatrip PIC	guggenheim	0
