abound	bugne
abounds	bugner
abundance	overflod
abundant	rigelig
accessible	tilgængelig
acclaim	anerkendelse
acclaimed	anmelderroste
acclamation	akklamation
accolade	hyldest
accolades	anerkendelser
accommodative	lempelige
accomplish	opnå
accomplished	gennemført
accomplishment	realisering
accomplishments	resultater
accurate	nøjagtig
accurately	nøjagtigt
achievable	opnåelige
achievement	præstation
achievements	resultater
acumen	købmandskab
adaptable	tilpasningsdygtige
adaptive	adaptive
adequate	tilstrækkelig
adjustable	justerbar
admirable	beundringsværdig
admirably	beundringsværdigt
admiration	beundring
admire	beundre
admirer	beundrer
admiring	beundrende
admiringly	beundrende
adorable	yndig
adore	tilbede
adored	forgudet
adorer	tilbeder
adoring	tilbedende
adoringly	tilbedende
adroit	behændig
adroitly	behændigt
adulation	beundring
advanced	fremskreden
advantage	fordel
advantageous	fordelagtige
advantageously	fordelagtigt
advantages	fordele
adventuresome	eventyrlystne
adventurous	eventyrlystne
advocate	fortaler
advocated	fortaler
advocates	fortalere
affable	flink
affably	elskværdigt
affectation	krukkeri
affection	kærlighed
affectionate	kærlig
affinity	tilhørsforhold
affirm	bekræfte
affirmation	bekræftelse
affirmative	bekræftende
affluence	overflod
affluent	velhavende
affordable	overkommelige
affordably	billigt
agile	adræt
agility	smidighed
agreeable	behagelig
agreeably	behageligt
alluring	dragende
alluringly	besnærende
altruistic	uselvisk
altruistically	uegennyttigt
amaze	forbløffe
amazed	forbløffet
amazement	forbløffelse
amazes	overrasker
amazing	fantastiske
amazingly	forbavsende
ambitious	ambitiøs
ambitiously	ambitiøst
ameliorate	lindre
amenable	modtagelig
amiable	elskværdig
amicability	venskabelig
amicable	venskabelig
amicably	mindelighed
amity	amity
ample	rigelig
amply	rigeligt
amuse	underholde
amusing	underholdende
angel	engel
angelic	engleblid
apotheosis	apoteose
appeal	appel
appealing	tiltrækkende
applaud	klappe
appreciable	mærkbar
appreciated	værdsat
appreciates	værdsætter
appreciative	anerkendende
appreciatively	anerkendende
appropriate	passende
approval	godkendelse
approve	godkende
ardent	glødende
ardently	brændende
ardor	iver
articulate	artikulere
aspiration	forhåbning
aspirations	forhåbninger
aspire	stræbe
assurance	forsikring
assurances	forsikringer
assure	forsikre
assuredly	sandelig
assuring	sikre
astonish	forbavse
astonished	forbløffet
astonishing	forbavsende
astonishingly	forbavsende
astonishment	forbavselse
astound	forbavse
astounded	forbløffet
astounding	forbløffende
astoundingly	forbavsende
attentive	opmærksom
attraction	attraktion
attractive	tiltrækkende
attractively	smukt
attune	afstemme
audible	hørbar
audibly	hørbart
auspicious	lovende
authentic	autentisk
authoritative	autoritativ
autonomous	autonom
available	ledig
avid	ivrig
avidly	begærligt
award	pris
awarded	tildelt
awards	priser
awe	ærefrygt
awed	imponeret
awesome	fantastisk
backbone	rygrad
balanced	afbalanceret
bargain	forhandle
beauteous	skønne
beautiful	smuk
beautifully	smukt
beautify	forskønne
beauty	skønhed
beckon	vinke
beckoned	vinkede
beckoning	vinkende
beckons	vinker
believable	troværdig
beloved	elskede
benefactor	velgører
beneficial	gavnlig
beneficiary	støttemodtager
benefit	fordel
benefits	fordele
benevolence	velvilje
benevolent	velvillige
benifits	kvalifiicere
best	bedst
best-selling	bedstsælgende
better	bedre
bless	velsigne
blessing	velsignelse
bliss	lyksalighed
blissful	salig
blissfully	saligt
blithe	blithe
bloom	flor
blossom	blomst
bolster	styrke
bonuses	bonusser
booming	blomstrende
boost	løft
boundless	grænseløs
bountiful	sprudlende
brainy	hjernemæssig
brave	modig
bravery	tapperhed
breakthroughs	gennembrud
breathlessness	åndenød
breathtaking	betagende
breathtakingly	åndeløst
breeze	brise
bright	lyse
brighten	lysne
brighter	lysere
brightest	lyseste
brilliance	glans
brilliant	strålende
brilliantly	glimrende
brisk	rask
brotherly	broderlig
buoyant	opdrift
cajole	lokke
calm	berolige
calming	beroligende
calmness	stilhed
capability	evne
capably	dygtigt
captivate	fange
captivating	fængslende
carefree	sorgløs
catchy	iørefaldende
celebrate	fejre
celebrated	fejret
celebration	fest
celebratory	festlig
charisma	karisma
charismatic	karismatisk
charitable	velgørende
charm	charme
charming	charmerende
charmingly	charmerende
chaste	kysk
cheaper	billigere
cheapest	billigste
cheer	opmuntre
cheerful	glad
cheery	muntre
cherish	værdsætte
cherished	skattede
cherub	kerub
chivalrous	ridderlig
chivalry	ridderlighed
civility	høflighed
civilize	civilisere
clarity	klarhed
classic	klassisk
classy	klassiske
clean	ren
cleaner	renere
cleanest	reneste
cleanliness	renhed
cleanly	rent
clear	klar
clear-cut	klare
cleared	ryddet
clearer	klarere
clearly	klart
clears	rydder
clever	dygtig
cleverly	behændigt
coherence	sammenhæng
coherent	sammenhængende
cohesive	sammenhængende
colorful	farverig
comfort	komfort
comfortable	komfortabel
comfortably	komfortabelt
comforting	trøstende
commend	rose
commendable	prisværdigt
commendably	prisværdigt
commitment	forpligtelse
compact	kompakt
compactly	kompakt
compassion	medfølelse
compassionate	medfølende
compatible	kompatibel
competitive	konkurrencedygtig
complement	supplement
complementary	komplementær
complemented	suppleret
complements	supplerer
compliant	kompatibel
compliment	kompliment
complimentary	gratis
comprehensive	omfattende
conciliate	formilde
conciliatory	forsonlig
concise	kortfattet
confidence	tillid
confident	selvsikker
congenial	sympatisk
congratulate	lykønske
congratulation	lykønskning
congratulations	tillykke
congratulatory	komplimenterende
conscientious	samvittighedsfuld
considerate	hensynsfuld
consistent	konsekvent
consistently	konsekvent
constructive	konstruktiv
consummate	djævleblændt
contentment	tilfredshed
continuity	kontinuitet
contrasty	kontrastrige
contribution	bidrag
convenience	bekvemmelighed
convenient	praktisk
conveniently	bekvemt
convincing	overbevisende
convincingly	overbevisende
coolest	fedeste
cooperative	samarbejdsvillig
cooperatively	kooperativt
cornerstone	hjørnesten
correct	korrekt
correctly	korrekt
cost-effective	omkostningseffektiv
cost-saving	omkostningsbesparende
counter-attack	modangreb
counter-attacks	modangreb
courage	mod
courageous	modig
courageously	modigt
courteous	høflig
courtly	høviske
covenant	pagt
cozy	hyggelig
creative	kreativ
credence	tiltro
credible	troværdig
crisp	sprød
crisper	skarpere
cure	helbrede
cure-all	helbrede-all
cushy	loppetjans
cute	nuttet
cuteness	nuttethed
danke	danke
danken	danken
daring	vovemod
daringly	modigt
darling	skat
dashing	flot
dauntless	uforfærdede
dawn	daggry
dazzle	blænde
dazzled	blændet
dazzling	blændende
dead-cheap	dead-billige
decency	anstændighed
decent	anstændig
decisive	afgørende
decisiveness	beslutsomhed
dedicated	dedikeret
defeat	nederlag
defeated	besejret
defeating	besejre
defeats	nederlag
defender	forsvarer
deference	respekt
deft	behændig
delectable	liflig
delicacy	delikatesse
delicate	delikat
delicious	lækker
delight	glæde
delighted	glad
delightful	dejlig
delightfully	dejligt
dependable	pålidelig
dependably	pålideligt
deservedly	fortjent
deserving	fortjener
desirable	ønskelig
desiring	ønsker
destiny	skæbne
detachable	aftagelig
devout	fromme
dexterous	behændig
dexterously	behændigt
dignified	værdig
dignify	hædre
dignity	værdighed
diligent	flittig
diligently	flittigt
diplomatic	diplomatisk
distinction	forskel
distinctive	karakteristisk
distinguished	skelnes
diversified	diversificeret
divine	guddommelig
divinely	guddommeligt
dominate	dominere
dominated	domineret
dominates	dominerer
dote	tilbede
dreamland	drømmeland
dumbfounded	lamslået
dummy-proof	dummy-bevis
durable	holdbar
dynamic	dynamisk
eager	ivrige
eagerly	ivrigt
eagerness	iver
earnest	alvor
earnestly	inderligt
earnestness	alvor
ease	lethed
eased	lempet
eases	lettes
easier	nemmere
easiest	nemmeste
easiness	lethed
easing	lempelse
easy	let
ebullient	sprudlende
economical	økonomisk
ecstasies	ekstaser
ecstatic	ekstatisk
ecstatically	ekstatisk
edify	opbygger
educated	uddannet
effective	effektiv
effectively	effektivt
effectiveness	effektivitet
effectual	virkningsfulde
efficacious	virkningsfuldt
efficient	effektiv
efficiently	effektivt
effortless	nemt
effortlessly	ubesværet
effusive	overstrømmende
effusively	overstrømmende
elated	opstemt
elation	opstemthed
electrify	elektrificere
elegantly	elegant
elevate	ophøje
eloquence	veltalenhed
eloquent	veltalende
eloquently	veltalende
eminent	fremtrædende
empathize	empati
empathy	empati
empower	bemyndige
enchant	fortrylle
enchanted	fortryllet
enchanting	fortryllende
enchantingly	fortryllende
encourage	tilskynde
encouragement	opmuntring
encouraging	opmuntrende
encouragingly	opmuntrende
endearing	indtagende
endorse	godkende
endorsed	godkendt
endorsement	godkendelse
endorses	tilslutter
endorsing	godkende
energetic	energisk
energy-efficient	energieffektiv
energy-saving	energibesparende
engaging	engagerende
engrossing	medrivende
enhance	forbedre
enhanced	forbedret
enhances	forbedrer
enjoyable	fornøjelig
enjoyably	fornøje
enjoyed	nydt
enjoying	nyder
enjoyment	nydelse
enjoys	nyder
enlighten	oplyse
enlightenment	oplysning
enliven	oplive
ennoble	forædle
enough	nok
enrapture	henrykke
enraptured	henrykte
enrich	berige
enrichment	berigelse
enterprising	initiativrige
entertain	underholde
entertaining	underholdende
entertains	underholder
enthral	begejstre
enthrall	begejstre
enthralled	betaget
enthuse	begejstre
enthusiasm	entusiasme
enthusiast	entusiast
enthusiastic	entusiastisk
enthusiastically	entusiastisk
entice	lokke
enticed	lokket
enticing	lokkende
entranced	henrykte
entrancing	fortryllende
entrust	overdrage
enviable	misundelsesværdig
enviably	misundelsesværdigt
envious	misundelig
enviously	misundeligt
envy	misundelse
equitable	retfærdig
ergonomical	ergonomisk
erudite	lærd
ethical	etisk
eulogize	lovprise
euphoria	eufori
euphoric	euforisk
euphorically	euforisk
evaluative	evaluerende
evenly	jævnt
eventful	begivenhedsrig
everlasting	evig
evocative	stemningsfulde
exalt	ophøje
exaltation	ophøjelse
exalted	ophøjet
exalting	ophøjende
exceed	overstige
exceeded	overskredet
exceeding	overstiger
exceedingly	overordentlig
exceeds	overstiger
excel	excel
excellant	atmosphere
excellence	ekspertise
excellency	excellence
excellent	fremragende
excellently	glimrende
excels	brillerer
exceptional	enestående
exceptionally	usædvanligt
excite	ophidse
excited	begejstret
excitedly	ophidset
excitement	spænding
excites	ophidser
exciting	spændende
exemplary	eksemplarisk
exhilarating	spændende
exhilaration	opstemthed
exonerate	frikende
expansive	ekspansiv
expeditiously	hurtigt
expertly	mesterligt
exquisite	udsøgt
exquisitely	udsøgt
extol	berømme
extraordinarily	ekstraordinært
extraordinary	ekstraordinær
exuberance	overflod
exuberant	overstrømmende
exuberantly	overstrømmende
exult	juble
exultant	jublende
exultation	jubel
eye-catch	eye-fangst
eye-catching	iøjnefaldende
eyecatching	iøjnefaldende
fabulous	fabelagtig
fabulously	fabelagtigt
facilitate	lette
fair	retfærdig
fairly	temmelig
faith	tro
faithful	trofast
faithfully	trofast
faithfulness	trofasthed
fame	berømmelse
famed	berømt
famous	berømt
famously	berømt
fancier	amatør
fans	ventilatorer
fantastic	fantastisk
fantastically	fantastisk
fascinate	fascinere
fascinating	spændende
fascinatingly	fascinerende
fashionably	moderigtigt
fast	hurtig
fast-paced	hurtig
faster	hurtigere
fastest	hurtigste
faultless	fejlfri
fav	functionality
favor	favorisere
favorable	gunstig
favored	foretrak
favorite	favorit
favorited	favoriseret
favour	favorisere
fearless	frygtløs
fearlessly	frygtløst
feasible	gennemførlig
feasibly	indpasses
feat	bedrift
feature-rich	feature-rige
feisty	iltre
felicitous	heldig
fertile	frodige
fervent	glødende
fervently	inderligt
fervid	brændende
fervor	iver
festive	festlig
fidelity	troskab
fiery	fyrig
fine	bøde
finely	fint
finer	finere
finest	fineste
firmer	fastere
first-in-class	første-in-class
flashy	prangende
flatter	smigre
flattering	flatterende
flawless	fejlfri
flawlessly	fejlfrit
flexibility	fleksibilitet
flexible	fleksibel
flourish	blomstre
flourishing	blomstrende
fluent	flydende
flutter	flagren
fondly	kærligt
fondness	forkærlighed
foolproof	idiotsikker
foremost	fremmest
foresight	fremsyn
formidable	formidabel
fortitude	fatning
fortuitous	tilfældige
fortuitously	tilfældigt
fortunate	heldig
fortunately	heldigvis
fortune	formue
fragrant	duftende
free	gratis
freed	befriet
freedom	frihed
freedoms	friheder
fresh	frisk
fresher	friskere
freshest	friskeste
friendliness	venlighed
friendly	venlige
frolic	løssluppenhed
frugal	sparsommelige
fruitful	frugtbart
fulfillment	opfyldelse
fun	sjovt
futuristic	futuristisk
gaiety	munterhed
gaily	muntert
gain	gevinst
gained	vundet
gainful	lønnet
gainfully	lønnet
gaining	vinder
gains	gevinster
gallant	galant
gallantly	galant
galore	massevis
geeky	nørdet
gem	perle
gems	perler
generosity	gavmildhed
generous	gavmild
generously	generøst
genius	geni
gentle	mild
gentlest	blideste
genuine	ægte
gifted	begavede
gladden	gladden
gladly	gladeligt
gladness	glæde
glamorous	glamourøse
glee	skadefryd
gleeful	skadefro
gleefully	triumferende
glimmer	glimt
glimmering	glimtende
glisten	skinne
glistening	glinsende
glorify	forherlige
glorious	herlige
gloriously	herligt
glory	ære
glow	glød
glowing	glødende
glowingly	glødende
god-given	gudgivne
god-send	gud-sende
godsend	gave
gold	guld
golden	gylden
good	godt
goodly	prægtigt
goodness	godhed
gorgeous	smukke
gorgeously	smukt
grace	nåde
graceful	yndefuld
gracefully	yndefuldt
gracious	nådig
graciously	nådigt
graciousness	elskværdighed
grand	grand
grandeur	storhed
grateful	taknemmelig
gratefully	taknemmeligt
gratification	tilfredsstillelse
gratified	tilfredsstillet
gratifies	tilfredsstiller
gratify	tilfredsstille
gratifying	glædeligt
gratifyingly	opmuntrende
gratitude	taknemmelighed
great	store
greatest	størst
greatness	storhed
groundbreaking	banebrydende
guarantee	garanti
guidance	vejledning
guiltless	uskyldig
gumption	gåpåmod
gush	vælde
gutsy	modige
hail	hagl
halcyon	halcyon
hallmark	adelsmærke
hallmarks	kendetegnende
hallowed	hellige
handily	behændigt
handsome	smuk
handsomely	klækkeligt
handy	praktisk
happier	gladere
happily	lykkeligt
happiness	lykke
happy	lykkelig
hard-working	hårdtarbejdende
hardy	hårdfør
harmless	uskadelig
harmonious	harmonisk
harmoniously	harmonisk
harmonize	harmonisere
harmony	harmoni
headway	hovedvej
heal	hele
healthful	sunde
heartening	opmuntrende
heartfelt	inderligt
heartily	hjerteligt
heartwarming	rørende
heaven	himmel
heavenly	himmelske
helped	hjulpet
helpful	nyttig
helping	hjælpe
hero	helt
heroic	heroisk
heroically	heroisk
heroine	heltinde
holy	hellig
homage	hyldest
honest	ærlig
honesty	ærlighed
honor	Ære
honorable	hæderlig
honored	hædret
honoring	honorering
hooray	hurra
hopeful	håbefuld
hospitable	gæstfri
hot	hed
hottest	hotteste
hug	knus
humane	human
humble	ydmyg
humility	ydmyghed
humorous	humoristisk
humorously	humoristisk
humour	humor
humourous	humoristisk
ideal	ideel
idealize	idealisere
ideally	ideelt
idolize	forgude
idolized	forgudede
idyllic	idyllisk
illuminate	belyse
illuminating	lysende
illumine	oplyse
illustrious	hæderkronede
ilu	ilu
imaginative	fantasifulde
immaculate	ulastelig
immaculately	ulasteligt
immense	umådelig
impartial	upartisk
impartiality	upartiskhed
impartially	upartisk
impassioned	lidenskabelig
impeccable	upåklagelig
impeccably	upåklageligt
important	vigtig
impress	imponere
impressed	imponeret
impresses	imponerer
impressive	imponerende
impressively	imponerende
improve	forbedre
improved	forbedret
improvement	forbedring
improvements	forbedringer
improves	forbedrer
improving	forbedring
incredible	utrolig
incredibly	utroligt
indebted	forgældede
individualized	individualiseret
indulgence	overbærenhed
indulgent	overbærende
industrious	flittig
inestimable	uvurderlig
inestimably	uvurderligt
inexpensive	billig
infallibility	ufejlbarlighed
infallible	ufejlbarlig
infallibly	ufejlbarligt
influential	indflydelsesrig
ingenious	genial
ingeniously	sindrigt
ingenuity	opfindsomhed
ingenuous	troskyldig
ingenuously	uskyldigt
innocuous	harmløs
innovative	innovativ
insightful	indsigtsfuld
insightfully	indsigtsfuldt
inspirational	inspirerende
inspire	inspirere
inspiring	inspirerende
instantly	øjeblikkeligt
instructive	lærerigt
instrumental	medvirkende
integral	integreret
integrated	integreret
intelligence	intelligens
intelligible	forståelig
interesting	interessant
interests	interesser
intimacy	intimitet
intimate	intim
intricate	indviklet
intrigue	intrige
intriguing	spændende
intuitive	intuitiv
invaluable	uvurderlig
inventive	opfindsomme
invigorating	styrkende
invincibility	uovervindelighed
invincible	uovervindelig
inviolable	ukrænkelig
inviolate	ukrænkelige
invulnerable	usårlig
irreplaceable	uerstattelige
irreproachable	uangribelig
irresistible	uimodståelig
irresistibly	uimodståeligt
issue-free	problem-fri
jaw-droping	kæbe-droping
jaw-dropping	sensationel
joy	glæde
joyful	glad
joyfully	glæde
joyous	glad
jubilant	jublende
jubilantly	jublende
jubilate	jubilate
jubilation	jubel
judicious	velovervejet
justly	retfærdigt
keen	opsat
keenly	opmærksomt
keenness	uroligt
kid-friendly	børnevenlige
kindliness	venlighed
kindly	venligt
kindness	venlighed
knowledgeable	vidende
laud	prise
laudable	prisværdigt
laudably	prisværdigt
lavish	overdådige
lavishly	overdådigt
law-abiding	lovlydige
lawful	lovlig
lawfully	lovligt
leading	førende
leads	kundeemner
lean	læne
legendary	legendariske
leverage	gearing
levity	letsindighed
liberate	befri
liberation	befrielse
liberty	frihed
lifesaver	livredder
light-hearted	munter
likable	vellidte
liking	smag
lionhearted	lionhearted
lively	livlig
logical	logisk
long-lasting	langvarig
lovable	elskelig
love	elsker
loved	elskede
loveliness	skønhed
lovely	dejlig
lover	elsker
loves	elsker
loving	kærlig
low-cost	lavpris
lower-priced	lavere-priced
loyalty	loyalitet
lucid	klar
lucidly	anskueligt
luck	held
luckier	heldigere
luckiest	heldigste
lucky	heldig
lucrative	lukrativ
luminous	lysende
lush	frodig
luster	glans
lustrous	skinnende
luxuriant	frodig
luxuriate	svælge
luxurious	luksuriøs
luxuriously	luksuriøst
luxury	luksus
lyrical	lyriske
magic	magi
magical	magiske
magnanimous	storsindet
magnanimously	høimodigen
magnificence	pragt
magnificent	storslået
magnificently	storslået
majestic	majestætisk
majesty	majestæt
manageable	håndterbar
maneuverable	manøvredygtig
marvel	vidunder
marveled	undrede
marvelled	undrede
marvellous	vidunderlig
marvelous	vidunderlig
marvelously	vidunderligt
marvels	vidundere
master	mestre
masterful	mesterlige
masterfully	mesterligt
masterpiece	mesterværk
masterpieces	mesterværker
masters	mestre
mastery	beherskelse
matchless	mageløs
mature	moden
maturely	modent
maturity	modenhed
meaningful	meningsfuld
memorable	mindeværdige
merciful	barmhjertig
mercifully	nådigt
mercy	barmhjertighed
merit	fortjeneste
meritorious	fortjenstfulde
merrily	lystigt
merriment	lystighed
merry	lystig
mesmerize	tryllebinde
mesmerized	tryllebundet
mesmerizing	hypnotiserende
meticulous	omhyggelig
meticulously	omhyggeligt
mightily	bravt
mighty	mægtig
miracle	mirakel
miracles	mirakler
miraculous	mirakuløs
miraculously	mirakuløst
modern	moderne
modest	beskedne
modesty	beskedenhed
momentous	betydningsfuld
monumental	monumentale
monumentally	monumentalt
morality	moral
motivated	motiveret
navigable	sejlbar
neat	pæn
neatest	sobre
neatly	pænt
nice	pæn
nicely	pænt
nicer	pænere
nicest	pæneste
nifty	fiks
nimble	adræt
noble	adelig
nobly	ædelt
noiseless	lydløs
non-violence	ikke-vold
non-violent	ikke-voldelig
notably	især
noteworthy	bemærkelsesværdigt
nourish	nære
nourishing	nærende
nourishment	næring
novelty	nyhed
nurturing	pleje
oasis	oase
obsession	besættelse
obsessions	tvangstanker
obtainable	opnåelig
openly	åbent
openness	åbenhed
optimism	optimisme
optimistic	optimistisk
orderly	velordnet
originality	originalitet
outdo	overgå
outdone	overgået
outperform	udkonkurrerer
outperformed	udkonkurrerede
outperforms	udkonkurrerer
outshine	overstråle
outshone	overskygget
outsmart	snyde
outstanding	fremragende
outstandingly	fremragende
outstrip	distancere
outwit	overliste
overjoyed	himmelhenrykt
overtake	overhale
overtaken	overhalet
overtakes	overhaler
overtaking	overhaling
overtook	overhalede
overture	ouverture
pain-free	smerte-fri
painless	smertefri
painlessly	smertefrit
palatial	statelige
pamper	forkæle
pampered	forkælet
panoramic	panoramisk
paradise	paradis
paramount	altoverskyggende
passion	lidenskab
passionate	lidenskabelig
passionately	lidenskabeligt
patience	tålmodighed
patiently	tålmodigt
patriotic	patriotisk
peace	fred
peaceable	fredelige
peaceful	fredelig
peacefully	fredeligt
peacekeepers	fredsbevarere
peach	fersken
perfect	perfekt
perfection	fuldkommenhed
perfectly	perfekt
permissible	tilladelig
perseverance	udholdenhed
personages	personager
personalized	personlig
phenomenal	fænomenal
phenomenally	fænomenalt
picturesque	maleriske
piety	fromhed
pinnacle	tinde
playful	legende
playfully	legende
pleasant	behagelig
pleasantly	glædeligt
pleased	tilfreds
pleases	behager
pleasing	behagelig
pleasingly	glædelig
pleasurable	lystbetonet
pleasurably	nydende
pleasure	fornøjelse
plentiful	rigelig
pluses	plusser
plush	plys
plusses	plustegn
poetic	poetisk
poignant	gribende
poised	klar
polished	poleret
polite	høflig
politeness	høflighed
popular	populær
portable	transportabel
positive	positiv
positively	positivt
positives	positiver
powerful	magtfulde
powerfully	effektfuldt
praise	ros
praiseworthy	rosværdigt
praising	rose
pre-eminent	fremtrædende
precious	kostbar
precise	præcis
precisely	præcist
preeminent	fremtrædende
prefer	foretrække
preferable	foretrækkes
preferably	helst
prefered	foretrak
preferring	foretrækker
prefers	foretrækker
prestigious	prestigefyldte
prettily	nydeligt
pretty	smuk
priceless	uvurderlig
pride	stolthed
principled	principfast
privilege	privilegium
privileged	privilegeret
prize	præmie
proactive	proaktiv
problem-free	problemfri
prodigious	uhyre
prodigiously	uhyre
prodigy	vidunderbarn
productive	produktiv
productively	produktivt
proficient	dygtig
proficiently	dygtig
profound	dybtgående
profoundly	dybt
profuse	rigelig
profusion	overflod
progress	fremskridt
progressive	progressiv
prolific	frodig
prominence	fremtrædende
prominent	fremtrædende
promise	løfte
promised	lovede
promises	løfter
promising	lovende
promoter	promotor
prompt	hurtig
promptly	omgående
proper	passende
properly	korrekt
propitious	gunstigt
pros	proffer
prosper	trives
prosperity	velstand
prosperous	blomstrende
protect	beskytte
protection	beskyttelse
protective	beskyttende
proud	stolt
proven	bevist
proves	beviser
providence	forsyn
proving	bevise
prowess	dygtighed
prudence	forsigtighed
prudent	forsigtig
prudently	forsigtighed
punctual	punktlig
pure	ren
purify	rense
purposeful	målbevidst
quaint	maleriske
qualified	kvalificeret
qualify	kvalificere
quicker	hurtigere
quiet	rolige
quieter	roligere
radiance	udstråling
radiant	strålende
rapid	hurtig
rapt	åndeløs
rapture	ekstase
rapturously	henrykt
rational	rationel
razor-sharp	knivskarp
reachable	nås
readable	læselig
readily	let
ready	parat
reaffirm	bekræfte
reaffirmation	bekræftelse
realistic	realistisk
realizable	realiserbare
reasonable	rimelig
reasonably	rimelighed
reasoned	begrundet
reassurance	forsikring
reassure	berolige
receptive	modtagelig
reclaim	genvinde
recomend	anbefale
recommend	anbefale
recommendation	henstilling
recommendations	anbefalinger
recommended	anbefalede
reconcile	forene
reconciliation	forsoning
record-setting	rekord-indstilling
recover	gendanne
recovery	genopretning
rectification	berigtigelse
rectify	rette
rectifying	ensrettende
redeem	indløs
redeeming	forløsende
redemption	frelse
refine	raffinere
refined	raffineret
refinement	raffinement
reformed	reformeret
reforming	reformere
reforms	reformer
refresh	opdater
refreshed	forfrisket
refreshing	forfriskende
refund	tilbagebetale
refunded	refunderet
regard	hensyn
rejoicing	jubel
rejuvenate	forynge
rejuvenated	forynget
rejuvenating	foryngende
relaxed	afslappet
relent	formilde
reliable	pålidelig
reliably	pålideligt
relief	lettelse
remarkable	bemærkelsesværdig
remarkably	bemærkelsesværdigt
remedy	afhjælpe
remunerate	aflønne
renaissance	renæssance
renewed	fornyet
renown	berømmelse
renowned	berømt
replaceable	udskiftelige
reputable	velrenommeret
reputation	omdømme
resilient	robust
resolute	resolut
resound	genlyde
resounding	rungende
resourceful	ressourcestærke
resourcefulness	opfindsomhed
respect	respekt
respectable	respektabel
respectful	respektfuld
respectfully	respektfuldt
respite	pusterum
resplendent	strålende
responsibly	ansvarligt
responsive	lydhør
restful	rolig
restored	restaureret
restructure	omstrukturere
restructured	omstruktureret
restructuring	omstrukturering
retractable	optrækkelige
revel	svælge
revelation	åbenbaring
revere	revere
reverence	ærbødighed
reverent	ærbødig
reverently	ærbødigt
revitalize	revitalisere
revival	genoplivning
revive	genoplive
revives	genopliver
revolutionary	revolutionerende
revolutionize	revolutionere
revolutionized	revolutioneret
revolutionizes	revolutionerer
reward	belønning
rewarding	givende
rewardingly	belønner
rich	rig
richer	rigere
richly	rigt
richness	rigdom
right	højre
righteous	retfærdig
righteously	retfærdigt
righteousness	retfærdighed
rightful	retmæssige
rightfully	rettelig
rightly	rette
rightness	rigtighed
risk-free	risikofrit
rock-star	rockstjerne
rock-stars	rock-stjerner
rockstar	rockstjerne
rockstars	rockstars
romantic	romantisk
romantically	romantisk
romanticize	romantisere
roomy	rummelig
rosy	rosenrødt
safe	sikker
safely	sikkert
saint	helgen
saintliness	hellighed
saintly	hellig
salutary	gavnlig
salute	salut
satisfactorily	tilfredsstillende
satisfactory	tilfredsstillende
satisfied	tilfreds
satisfies	tilfredsstiller
satisfy	tilfredsstille
satisfying	tilfredsstillende
satisified	tilfreds
savings	opsparing
savior	frelser
savvy	kyndige
scenic	naturskøn
seamless	sømløs
seasoned	krydret
secure	sikker
securely	forsvarligt
selective	selektiv
self-determination	selvbestemmelse
self-respect	selvrespekt
self-satisfaction	selvtilfredshed
self-sufficiency	selvforsyning
self-sufficient	selvforsynende
sensational	sensationel
sensationally	sensationelt
sensations	fornemmelser
sensible	fornuftig
sensibly	fornuftigt
sensitive	følsom
serene	fredfyldte
serenity	sindsro
sexy	sexet
sharp	skarp
sharper	skarpere
sharpest	skarpeste
shimmering	flimrende
shine	skinne
shiny	skinnende
significant	væsentlig
silent	stille
simpler	enklere
simplest	enkleste
simplified	forenklet
simplifies	forenkler
simplify	forenkle
simplifying	forenkle
sincere	oprigtig
sincerely	oprigtigt
sincerity	oprigtighed
skill	dygtighed
skilled	faglært
skillful	dygtige
skillfully	dygtigt
slammin	slammin
sleek	slank
slick	glat
smarter	smartere
smartest	smarteste
smartly	smart
smile	smil
smiles	smil
smiling	smilende
smitten	slået
smooth	glat
smoother	glattere
smoothes	udglatter
smoothest	glatteste
smoothly	glat
snappy	bidsk
snazzy	smart
sociable	omgængelig
soft	blød
softer	blødere
solace	trøst
solicitous	omsorgsfuld
solicitously	omsorgsfuldt
solidarity	solidaritet
sophisticated	sofistikeret
soulful	sjælfuld
soundly	trygt
soundness	soliditet
spacious	rummelig
sparkle	glimte
sparkling	mousserende
spectacular	spektakulære
spectacularly	spektakulært
speedily	hurtigt
speedy	hurtig
spellbinding	tryllebindende
spellbindingly	bjergtagende
spellbound	tryllebundet
spirited	åndrig
spiritual	åndelig
splendid	glimrende
splendidly	glimrende
splendor	pragt
spontaneous	spontan
spotless	pletfri
sprightly	livlig
stability	stabilitet
stabilize	stabilisere
stable	stabil
stainless	rustfri
stately	statelige
statuesque	statelig
staunch	standhaftig
staunchly	standhaftigt
staunchness	standhaftighed
steadfast	standhaftige
steadfastly	standhaftigt
steadfastness	standhaftighed
steadiness	stabilitet
stellar	stjernernes
stimulate	stimulere
stimulates	stimulerer
stimulating	stimulerende
stimulative	stimulerende
straighten	glatte
straightforward	ligetil
streamlined	strømlinet
striking	slående
strikingly	påfaldende
striving	stræber
strong	stærk
stronger	stærkere
strongest	stærkeste
stunned	bedøvet
stunning	betagende
stunningly	fantastisk
stupendous	drabelig
sturdy	robust
stylish	stilfuld
stylishly	stilfuldt
stylized	stiliseret
suave	åleglat
subsidize	subsidiere
subsidized	subsidieret
subsidizes	subsidierer
subsidizing	subsidiere
substantive	materielle
succeed	lykkes
succeeded	lykkedes
succeeding	efterfølgende
succeeds	lykkes
success	succes
successes	succeser
successful	vellykket
successfully	succesfuldt
suffice	tilstrækkeligt
sufficed	tilstrækkeligt
suffices	tilstrækkeligt
sufficient	tilstrækkelig
sufficiently	tilstrækkeligt
suitable	egnet
sumptuous	overdådig
sumptuously	overdådigt
sumptuousness	overdådighed
superbly	fremragende
superior	overlegen
superiority	overlegenhed
supple	smidig
supported	understøttet
supporting	støtte
supportive	støttende
supremacy	overhøjhed
supremely	suverænt
surmount	overvinde
surpass	overgå
surreal	surrealistisk
survival	overlevelse
survivor	overlevende
sustainability	bæredygtighed
sustainable	bæredygtig
swanky	smarte
sweeping	fejende
sweet	sød
sweeten	forsøde
sweetheart	kæreste
sweetly	sødt
sweetness	sødme
swiftness	hurtighed
talented	talentfuld
talents	talenter
tantalizing	forjættende
tantalizingly	fristende
tempt	friste
tempting	fristende
temptingly	fristende
tenacious	ihærdige
tenaciously	ihærdigt
tenacity	vedholdenhed
tender	bud
tenderly	ømt
terrific	fantastisk
thank	takke
thankful	taknemmelig
thinner	tyndere
thoughtful	tankevækkende
thoughtfully	omtanke
thoughtfulness	eftertænksomhed
thrift	sparsommelighed
thrifty	sparsommelige
thrill	gys
thrilled	begejstret
thrilling	spændende
thrills	spænding
thrive	trives
thriving	blomstrende
tickle	kildre
tidy	ryddelig
time-honored	hævdvundne
timely	rettidig
tingle	snurre
titillate	pirre
titillating	pirrende
togetherness	samvær
tolerable	tålelig
toll-free	momsfri
top-notch	fortræffelig
tops	toppe
tough	sej
tougher	hårdere
toughest	hårdeste
traction	trækkraft
tranquil	rolig
tranquility	ro
transparent	gennemsigtig
treasure	skat
tremendously	uhyre
trendy	smarte
triumph	triumf
triumphal	triumftog
triumphant	triumferende
triumphantly	triumferende
trivially	trivielt
trophy	trofæ
trouble-free	problemfri
trump	trumf
trumpet	trompet
trust	tillid
trusted	betroet
trusting	tillidsfuld
trustworthiness	troværdighed
trustworthy	troværdig
trusty	trofaste
truthful	sandfærdig
truthfully	sandfærdigt
truthfulness	sandfærdighed
ultra-crisp	ultra-sprød
unabashed	skamløs
unabashedly	ufortrødent
unaffected	upåvirket
unassailable	uangribeligt
unbeatable	uovervindelig
unbiased	fordomsfri
unbound	ubundet
uncomplicated	ukompliceret
unconditional	ubetinget
undamaged	ubeskadiget
undaunted	uforfærdet
understandable	forståelig
undisputed	ubestridt
unencumbered	ubehæftet
unequivocal	utvetydige
unequivocally	utvetydigt
unfazed	uanfægtet
unfettered	uhæmmet
unforgettable	uforglemmelig
unity	enhed
unlimited	ubegrænset
unmatched	uovertruffen
unquestionable	ubestridelige
unquestionably	utvivlsomt
unreal	uvirkelig
unrestricted	ubegrænset
unrivaled	uovertruffen
unselfish	uselvisk
unwavering	urokkelige
upbeat	optimistisk
upgradable	opgraderes
upgradeable	opgraderes
upgraded	opgraderet
upheld	stadfæstet
uphold	opretholde
uplift	hævning
uplifting	opløftende
upscale	opskalere
usable	brugbar
useable	brugbar
useful	nyttig
user-friendly	brugervenlig
valiant	tapper
valiantly	tappert
valor	tapperhed
valuable	værdifuld
verifiable	verificerbare
veritable	veritabel
versatile	alsidig
versatility	alsidighed
vibrant	levende
vibrantly	spillevende
victorious	sejrende
victory	sejr
viewable	synlig
vigilance	årvågenhed
vigilant	vagt
virtue	dyd
virtuous	dydige
virtuously	dydigt
visionary	visionær
vivacious	livlig
vivid	levende
vouchsafe	forunde
warm	varm
warmer	varmere
warmhearted	varmhjertet
warmly	varmt
warmth	varme
wealthy	velhavende
welcome	velkommen
well	godt
well-backlit	godt-baggrundsbelysning
well-behaved	velopdragen
well-being	trivsel
well-bred	velopdragen
well-educated	veluddannet
well-established	veletableret
well-informed	velinformeret
well-intentioned	velmente
well-known	kendt
well-managed	veldrevet
well-mannered	velopdragen
well-positioned	veletableret
well-rounded	velafrundet
well-run	veldrevet
well-wishers	bekendte
wellbeing	velvære
wholeheartedly	helhjertet
wholesome	sund
willing	villig
willingly	villigt
willingness	villighed
win	vinde
windfall	stormfald
winner	vinder
winners	vindere
winning	vinder
wins	vinder
wisdom	visdom
wise	klog
wisely	klogt
witty	vittig
won	vandt
wonder	spekulerer
wonderful	vidunderlig
wonderfully	vidunderligt
wonderously	underfuldt
wonders	vidundere
wondrous	vidunderlige
work	arbejde
workable	gennemførlig
worked	arbejdet
works	arbejder
world-famous	verdensberømte
worth	værdi
worth-while	værd-mens
worthiness	værdighed
worthwhile	værd
worthy	værdig
wowed	henrykkede
youthful	ungdommelig
zeal	iver
zenith	zenit
zest	citronskal
2-faces	2-ansigter
abnormal	abnorm
abolish	afskaffe
abominable	vederstyggelige
abominably	vederstyggeligt
abominate	afsky
abomination	vederstyggelighed
aborted	afbrudt
aborts	afbrydes
abrade	slib
abrasive	slibende
abrupt	brat
abruptly	brat
absence	fravær
absent-minded	fraværende
absentee	fraværende
absurdity	absurditet
absurdly	absurd
abuse	misbrug
abused	misbrugt
abuses	misbrug
abusive	grov
abysmal	afgrundsdyb
abyss	afgrunden
accidental	tilfældig
accost	antaste
accursed	forbandede
accusation	anklage
accusations	beskyldninger
accuse	beskylde
accuses	beskylder
accusing	beskylder
accusingly	anklagende
acerbic	bitre
acerbically	syrligt
ache	smerte
ached	smertede
aches	ømhed
aching	smertende
acrid	skarp
acrimonious	bitter
acrimony	bitterhed
adamant	ubøjelig
addict	narkoman
addicted	afhængige
addicting	vanedannende
addicts	misbrugere
admonish	formane
admonishingly	advarende
admonition	formaning
adulterate	forfalske
adulterated	forfalsket
adulteration	forfalskning
adversarial	kontradiktorisk
adversary	modstander
adverse	ugunstig
adversity	modgang
afflict	plage
affliction	lidelse
affront	krænkelse
afraid	bange
aggravate	forværre
aggravating	forværret
aggravation	forværring
aggressive	aggressiv
aggressiveness	aggressivitet
aggrieved	forurettede
aghast	forfærdet
agonies	kvaler
agonize	pines
agonizing	pinefuld
agonizingly	pinefuldt
agony	smerte
aground	grundstødte
ail	ail
ailing	skrantende
ailment	lidelse
aimless	formålsløs
alarmed	alarmeret
alarming	alarmerende
alarmingly	alarmerende
alienate	fremmedgøre
alienated	fremmedgjorte
alienation	fremmedgørelse
allegation	påstand
allegations	beskyldninger
allege	påstår
allergic	allergisk
allergies	allergi
allergy	allergi
aloof	tilknappet
altercation	skænderi
ambiguity	tvetydighed
ambiguous	tvetydig
ambivalence	ambivalens
ambush	baghold
amiss	galt
amputate	amputere
anarchism	anarkisme
anarchist	anarkist
anarchistic	anarkistiske
anarchy	anarki
anemic	anæmisk
anger	vrede
angrily	vredt
angry	vred
anguish	kvaler
animosity	fjendskab
annihilate	tilintetgøre
annihilation	tilintetgørelse
annoy	irritere
annoyance	irritation
annoyances	irritationsmomenter
annoyed	irriteret
annoying	irriterende
annoyingly	irriterende
annoys	irriterer
anomalous	unormal
anomaly	anomali
antagonism	antagonisme
antagonist	modstander
antagonistic	antagonistiske
antagonize	modarbejde
anti-israeli	anti-israelske
anti-occupation	anti-besættelse
anti-semites	antisemitter
anti-social	asocial
anti-us	anti-os
anti-white	anti-hvid
antipathy	antipati
antiquated	antikveret
antithetical	modsætninger
anxieties	bekymringer
anxiety	angst
anxious	ængstelig
anxiously	ængsteligt
anxiousness	angst
apathetic	apatisk
apathetically	apatisk
apathy	apati
apocalypse	dommedag
apocalyptic	apokalyptisk
apologist	apologet
apologists	apologeter
appal	forfærde
appall	forfærder
appalled	rystet
appalling	rystende
appallingly	togforsinkelser
apprehension	ængstelse
apprehensions	ængstelse
apprehensive	betænkelig
apprehensively	ængsteligt
arbitrary	vilkårlig
arcane	mystiske
archaic	gammeldags
arduous	besværlig
argumentative	argumenterende
arrogantly	arrogant
asinine	tåbelige
askance	sideblik
assail	angribe
assassin	snigmorder
assassinate	myrde
assault	angreb
assult	assult
asunder	sønder
atrocious	grusomme
atrocities	grusomheder
atrocity	grusomhed
atrophy	atrofi
attack	angreb
attacks	angreb
audacious	dristig
audaciously	dristighed
audaciousness	dristighed
audacity	dristighed
austere	barsk
authoritarian	autoritær
autocrat	selvhersker
autocratic	autokratisk
avalanche	lavine
avarice	griskhed
avaricious	gerrig
avenge	hævne
averse	utilbøjelig
aweful	zawsze
awful	forfærdelig
awfully	forfærdelig
awfulness	præsent
awkward	akavet
awkwardness	kejtethed
ax	økse
babble	pludre
back-logged	back-logget
back-wood	back-træ
back-woods	sikkerhedskopiere-woods
backache	rygsmerter
backbite	bagtale
backbiting	bagtalelse
backward	baglæns
backwardness	tilbageståenhed
backwood	backwood
bad	dårlig
badly	dårligt
baffle	forbløffe
baffled	forvirret
baffling	forvirrende
bait	lokkemad
balk	balk
banal	banale
banish	forjage
banishment	landsforvisning
bankrupt	bankerot
barbarian	barbar
barbaric	barbarisk
barbarically	barbarisk
barbarity	barbari
barbarous	barbarisk
barbarously	barbarisk
barren	ufrugtbar
baseless	grundløse
bashful	undseelig
bastard	skiderik
bastards	skiderikker
battered	voldsramte
batty	batty
beastly	væmmelig
bedlam	galehus
beg	tigge
beggar	tigger
beggarly	ussel
begging	tigger
beguile	narre
belated	forsinket
beleaguer	belejre
belie	dementere
belittle	forklejne
belittled	nedgjort
belittling	bagatellisering
bellicose	krigeriske
belligerence	krigeriskhed
belligerent	krigsførende
belligerently	antydningerne
bemoan	begræder
bemoaning	begræder
bemused	undrende
bent	bøjet
berate	skælde
bereave	berøve
bereavement	dødsfald
bereft	blottet
berserk	amok
beseech	bønfalder
beset	plaget
besiege	belejre
besmirch	besudle
bestial	dyrisk
betray	forråde
betrayal	forræderi
betrayals	bedrag
betrayer	forræderen
betraying	forråde
betrays	forråder
bewail	begræde
bewilder	forvirre
bewildered	forvirret
bewildering	forvirrende
bewilderingly	forvirrende
bewilderment	forvirring
bewitch	forhekse
bias	partiskhed
biased	forudindtaget
biases	fordomme
bicker	småskændes
bickering	skænderier
bigotries	bigotteri
bigotry	fordomme
bitch	tæve
bitchy	spydig
biting	bidende
bitterly	bittert
bitterness	bitterhed
bizarre	bizar
blackmail	afpresse
blame	bebrejde
blameworthy	dadelværdigt
bland	kedelig
blaspheme	bespotte
blasphemous	blasfemisk
blasphemy	blasfemi
blasted	sprængte
blatant	åbenlys
blatantly	åbenlyst
bleak	dyster
bleed	bløde
bleeding	blødende
bleeds	bløder
blemish	skamplet
blinding	blændende
blindingly	blændende
blister	vabel
blistering	blærer
bloated	oppustet
blockage	blokering
blockhead	dumrian
bloodshed	blodsudgydelse
bloodthirsty	blodtørstige
bloody	blodig
blotchy	plettet
blow	blæse
blunder	bommert
blundering	famle
blunders	brølere
blunt	sløv
blur	sløring
blurred	sløret
blurring	sløring
blurry	sløret
blurs	sløring
blurt	buse
boastful	pralende
bogus	fup
boil	koge
boiling	kogning
boisterous	larmende
bomb	bombe
bombard	bombardere
bombardment	bombardement
bombastic	bombastisk
bondage	trældom
bonkers	skrupskør
boredom	kedsomhed
bores	boringer
boring	kedelig
bother	forstyrre
bothered	generet
bothering	generer
bothers	generer
bothersome	generende
boycott	boykot
braggart	pralhals
bragger	brøgger
brainless	hjernedøde
brainwash	hjernevaske
brash	pågående
brat	møgunge
brazen	fræk
brazenly	frækt
breach	brud
break	pause
breakdown	sammenbrud
breaks	pauser
bribery	bestikkelse
brimstone	svovl
bristle	stritter
brittle	skør
broken-hearted	sønderknust
brood	yngel
bruised	forslået
brusque	brysk
brutalising	brutaliserende
brutalities	brutalitet
brutality	brutalitet
brutalizing	brutaliserende
brutally	brutalt
brutish	dyrisk
buckle	spænde
bug	insekt
bugging	aflytning
bulkier	tykkere
bulkiness	arbitragemuligheder
bulky	pladskrævende
bull****	tyr****
bull----	tyr----
bullies	bøller
bully	bølle
bullying	mobning
bum	vagabond
bumped	stødte
bumping	bumpe
bumps	bump
bumpy	ujævn
bungle	bungle
bungler	klodrian
bungling	brok
bunk	køje
burden	byrde
burdensome	belastende
burn	brænde
burned	brændt
burning	brænding
burns	forbrændinger
bust	buste
busts	buster
busybody	plageånd
butcher	slagter
butchery	slagteri
buzzing	summende
byzantine	byzantinske
cackle	kagle
calamities	ulykker
calamitous	katastrofal
calamity	ulykke
callous	afstumpede
calumniate	bagvaske
calumnies	bagvaskelser
calumnious	bagtalerisk
calumny	bagvaskelse
cancer	kræft
cancerous	kræft
cannibal	kannibal
cannibalize	kannibalisere
capitulate	kapitulere
capricious	lunefuld
capriciously	lunefuldt
capriciousness	lunefuldhed
capsize	kæntre
careless	ligegyldig
carelessness	ligegyldighed
caricature	karikatur
carnage	blodbad
carp	karpe
cartoonish	tegneserieagtige
castrated	kastreret
casualty	tilskadekomne
cataclysm	katastrofe
cataclysmic	katastrofal
catastrophe	katastrofe
catastrophes	katastrofer
catastrophic	katastrofale
catastrophically	katastrofalt
catastrophies	katastrofer
caustic	kaustisk
caustically	spydigt
cautionary	advarende
cave	hule
censure	kritisere
chafe	gnave
chaff	avner
chagrin	ærgrelse
challenging	udfordrende
chaos	kaos
chaotic	kaotisk
chasten	tugter
chastise	revse
chastisement	revselse
chatter	snak
chatterbox	sludrechatol
cheap	billig
cheaply	billigt
cheat	snyde
cheated	snydt
cheats	snyder
checkered	ternet
cheerless	uhyggeligt
cheesy	billig
childish	barnlig
chilly	kølig
choke	kvæle
choleric	koleriske
choppy	urolig
chronic	kronisk
clamor	protester
clamorous	larmende
clash	sammenstød
cliche	kliché
cliched	fjollet
clique	klike
clog	træsko
clogged	tilstoppet
clogs	træsko
cloud	sky
clouding	uklarhed
cloudy	overskyet
clumsy	klodset
clunky	klodset
coarse	grov
cocky	kæphøj
coerce	tvinge
coercion	tvang
coercive	tvangsindgreb
cold	kold
coldly	koldt
combative	kampklar
combust	forbrænde
comical	komisk
commiserate	kondolere
commonplace	hverdagskost
commotion	tumult
commotions	oprør
complacent	selvtilfreds
complained	klagede
complaining	klager
complains	klager
complaint	klage
complaints	klager
complex	kompleks
complicated	kompliceret
complication	komplikation
complicit	medskyldige
compulsion	tvang
compulsive	kompulsiv
concede	indrømme
conceded	indrømmede
conceit	indbildskhed
conceited	indbildsk
concen	koncen
concens	concens
concern	bekymring
concerned	berørte
concerns	bekymringer
concession	koncession
concessions	indrømmelser
condemn	fordømme
condemnable	fordømmes
condemnation	fordømmelse
condemned	fordømte
condemns	fordømmer
condescend	nedlade
condescending	nedladende
condescendingly	nedladende
condescension	nedladenhed
confess	indrømme
confession	tilståelse
confessions	bekendelser
confined	begrænset
conflict	konflikt
conflicted	konflikt
conflicting	modstridende
conflicts	konflikter
confound	forvirre
confounded	beskæmmet
confounding	forvirrende
confront	konfrontere
confrontation	konfrontation
confrontational	konfronterende
confuse	forvirre
confused	forvirret
confuses	forvirrer
confusing	forvirrende
confusion	forvirring
confusions	forvekslinger
congested	overbelastet
congestion	overbelastning
cons	ulemper
conservative	konservativ
conspicuous	iøjnefaldende
conspicuously	iøjnefaldende
conspiracies	sammensværgelser
conspiracy	sammensværgelse
conspirator	medsammensvoren
conspiratorial	konspiratoriske
conspire	konspirerer
consternation	bestyrtelse
contagious	smitsom
contaminate	forurene
contaminated	kontamineret
contaminates	forureninger
contaminating	forurener
contamination	forurening
contempt	foragt
contemptible	foragtelig
contemptuous	foragtende
contemptuously	foragteligt
contend	kæmpe
contention	påstand
contentious	omstridt
contort	vride
contortions	krumspring
contradict	modsige
contradiction	modsigelse
contradictory	modstridende
contrariness	vrangvillighed
contravene	strid
contrive	udtænke
contrived	konstruerede
controversial	kontroversielle
controversy	kontrovers
convoluted	højtravende
corrode	korroderer
corrosion	korrosion
corrosions	tæringer
corrosive	ætsende
corrupt	korrupt
corrupted	beskadiget
corrupting	korrumperende
corruption	korruption
corrupts	korrumperer
costlier	dyrere
costly	kostbar
counter-productive	bagslag
counterproductive	kontraproduktivt
covetous	begærlige
coward	kujon
cowardly	fej
crabby	gnavne
crack	sprække
cracked	revnet
cracks	revner
craftily	underfundigt
crafty	snu
cramp	krampe
cramped	trange
cramping	kramper
cranky	mærkelig
crap	lort
crappy	dårlig
crash	krak
crashing	crash
crass	kras
craven	craven
cravenly	krysteragtig
craze	dille
crazily	sindssygt
craziness	vanvid
creak	knirke
creaking	knirkende
creaks	knirker
credulous	godtroende
creep	krybe
creeping	snigende
creeps	kryber
creepy	uhyggelig
crept	krøb
crime	forbrydelse
criminal	kriminel
cringe	krybe
cripple	krøbling
crippled	forkrøblede
cripples	krøblinge
crippling	lammende
crisis	krise
critic	kritiker
critical	kritisk
criticism	kritik
criticisms	kritik
criticize	kritisere
criticized	kritiseret
criticizing	kritisere
critics	kritikere
cronyism	kammerateri
crook	skurk
crooked	skæv
crooks	skurke
crowded	overfyldt
crude	rå
cruel	grusom
cruelest	ondeste
cruelly	grusomt
cruelties	grusomheder
cruelty	grusomhed
crumble	smuldre
crumbling	smuldre
crummy	mærkværdige
crumple	krølle
crumpled	krøllet
crumples	krøller
crushed	knust
crushing	knusning
cry	skrig
culpable	skyldig
culprit	synderen
cumbersome	besværlig
cunt	kusse
cunts	kusser
curse	forbande
cursed	forbandet
curses	forbandelser
curt	curt
cuss	bande
cussed	drøftet
cutthroat	skarp
cynical	kynisk
cynicism	kynisme
damage	skade
damaged	beskadiget
damages	skader
damaging	skadelige
damnable	forbandet
damnably	forbandet
damnation	forbandelse
damned	forbandet
damning	fældende
damper	dæmper
danger	fare
dangerous	farligt
dangerousness	farlighed
dark	mørk
darken	mørkere
darkened	formørket
darker	mørkere
darkness	mørke
dastard	ugerningsmand
dastardly	nedrige
daunt	daunt
daunting	skræmmende
daze	døs
dazed	fortumlet
dead	død
deadlock	dødvande
deadly	dødelig
deadweight	dødvægt
deaf	døv
dearth	mangel
death	død
debacle	fiaskoen
debase	nedværdige
debasement	fornedrelse
debaser	debaser
debatable	diskutabel
debauch	korrumpere
debauchery	skørlevned
debilitate	svække
debilitating	invaliderende
debility	svækkelse
debt	gæld
debts	gæld
decadence	dekadence
decadent	dekadent
decay	henfald
decayed	henfaldet
deceit	bedrag
deceitful	bedragerisk
deceitfully	bedragerisk
deceive	bedrage
deceiver	bedrager
deceivers	bedragere
deceiving	bedrager
deception	bedrag
deceptive	vildledende
deceptively	bedragerisk
declaim	deklamere
decline	nedgang
declines	fald
declining	faldende
decrement	formindskelsen
decrepit	affældig
decry	nedvurderer
defamation	ærekrænkelse
defamations	æreskrænkelser
defamatory	ærekrænkende
defame	bagvaske
defect	defekt
defective	defekt
defects	defekter
defensive	defensiv
defiance	trodsighed
defiant	trodsig
defiantly	trodsigt
deficiencies	mangler
deficiency	mangel
deficient	mangelfuld
defile	besmitte
deform	deformere
deformed	deform
defrauding	svindel
defunct	hedengangne
defy	trodse
degenerate	degenereret
degenerately	degenerativt
degradation	nedbrydning
degrade	nedbryde
degrading	nedværdigende
dehumanization	umenneskeliggørelse
dehumanize	umenneskeliggøre
deign	nedlade
dejected	modløs
dejectedly	mismodigt
dejection	mismod
delay	forsinke
delayed	forsinket
delaying	forsinke
delays	forsinkelser
delinquency	ungdomskriminalitet
delinquent	kriminel
delirious	ellevild
delude	narre
deluded	vildledt
deluge	syndflod
delusion	vrangforestilling
delusional	vrangforestilling
delusions	vrangforestillinger
demean	nedværdige
demeaning	nedgørende
demise	død
demolish	nedrive
demolisher	demolisher
demon	dæmon
demonic	dæmonisk
demonize	dæmonisere
demonized	dæmoniseret
demonizes	dæmoniserer
demonizing	dæmonisering
demoralize	demoralisere
demoralizing	demoraliserende
denial	afslag
denied	nægtet
denies	benægter
denigrate	nedgøre
denounce	opsige
dense	tæt
dent	bule
dented	bulet
dents	buler
denunciate	udtræde
denunciation	opsigelse
denunciations	opsigelser
deny	nægte
denying	benægte
deplete	nedbryder
deplorable	beklageligt
deplorably	beklagelig
deplore	beklage
deploring	beklager
deprave	fordærve
depraved	fordærvet
deprecate	misbillige
depress	trykke
depressed	deprimeret
depressing	deprimerende
depressingly	deprimerende
depressions	depressioner
deprive	fratage
deprived	berøvet
deride	håne
derision	hån
derisive	spottende
derisively	hånligt
derogatory	nedsættende
desecrate	vanhellige
desert	ørken
desiccate	tørre
desiccated	udtørret
desolate	øde
desolation	trøstesløshed
despair	fortvivlelse
despairing	fortvivlet
despairingly	fortvivlet
desperate	desperat
desperately	desperat
despicable	foragtelig
despicably	foragteligt
despise	foragte
despised	foragtet
despoil	udplyndre
despondency	modløshed
despondent	mismodig
despondently	mismodig
despotic	despotisk
despotism	despoti
destabilisation	destabilisering
destitute	nødlidende
destitution	armod
destroy	ødelægge
destruction	ødelæggelse
destructive	destruktiv
desultory	usammenhængende
deter	afskrække
deteriorate	forringes
deteriorating	forværrede
deterioration	forringelse
deterrent	afskrækkende
detest	afskyr
detestable	afskyelige
detested	forhadte
detests	afskyer
detracted	forringet
detracting	forklejne
detracts	forringer
detriment	skade
detrimental	skadelig
devastate	ødelægge
devastated	knust
devastates	ødelægger
devastating	ødelæggende
devastatingly	sønderlemmende
devastation	ødelæggelser
deviate	afvige
deviation	afvigelse
devil	djævel
devilish	djævelsk
devilishly	djævelsk
devilry	djævelskab
devious	lusket
deviousness	forvridninger
devoid	blottet
diabolic	diabolsk
diabolical	djævelsk
diabolically	djævelsk
diametrically	diametralt
dictator	diktator
dictatorial	diktatorisk
die	dø
died	døde
dies	dør
difficult	svært
difficulties	vanskeligheder
difficulty	vanskelighed
diffidence	generthed
dilapidated	faldefærdige
dilly-dally	drys
dim	svag
dimmer	lysdæmper
din	larmen
dirt	smuds
dirty	snavset
disable	deaktivere
disabled	handicappet
disadvantage	ulempe
disadvantageous	ufordelagtig
disadvantages	ulemper
disaffected	utilfredse
disagreeable	ubehagelig
disagreeably	ubehageligt
disagreed	uenige
disagreeing	uenige
disagreement	uenighed
disagrees	uenig
disallow	forbyd
disappoint	skuffe
disappointed	skuffet
disappointing	skuffende
disappointingly	skuffende
disappointment	skuffelse
disappointments	skuffelser
disappoints	skuffer
disapproval	misbilligelse
disapprove	misbillige
disapproving	misbilligende
disarm	afvæbne
disarray	uorden
disaster	katastrofe
disasterous	katastrofale
disastrous	katastrofal
disastrously	katastrofalt
disavow	dementere
disavowal	desavouering
disbelief	vantro
disbelieve	tvivle
disbeliever	vantro
disclaim	fralægger
discomfort	ubehag
disconcerted	forvirrede
disconcerting	foruroligende
disconsolate	utrøstelig
disconsolately	trøstesløst
discontent	utilfredshed
discontented	utilfredse
discontentedly	misfornøjet
discontinued	afbrydes
discontinuity	diskontinuitet
discontinuous	diskontinuerlig
discord	disharmoni
discordance	uoverensstemmelse
discordant	uharmonisk
discourage	afskrække
discouragement	modløshed
discouraging	nedslående
discouragingly	demotiverende,
discourteous	uhøfligt
discourteously	uhøfligt
discredit	miskreditere
discrepant	afvigende
discriminate	diskriminere
discrimination	forskelsbehandling
discriminatory	diskriminerende
disdain	foragt
disdained	ringeagtede
disdainful	hånlige
disdainfully	foragtelig
disfavor	disfavorisere
disgrace	vanære
disgraced	vanærede
disgraceful	vanærende
disgracefully	skammelig
disgruntled	utilfredse
disgust	afsky
disgusted	væmmes
disgusting	ulækkert
disgustingly	fælt
disheartening	nedslående
dishonest	uærlig
dishonestly	uærligt
dishonesty	uærlighed
dishonor	vanære
dishonorable	uhæderlig
disillusion	desillusion
disillusioned	desillusionerede
disillusionment	desillusionering
disinclination	ulyst
disinclined	utilbøjelige
disingenuous	tilsnigelse
disingenuously	uvederhæftig
disintegrate	smuldre
disintegrated	opløst
disinterested	uinteresseret
disliked	hadede
dislikes	antipatier
dislocated	forvredet
disloyal	illoyale
disloyalty	illoyalitet
dismal	trist
dismay	forfærdelse
dismayed	bestyrtet
dismaying	forfærdende
dismayingly	nedslående
dismissive	afvisende
dismissively	affærdigende
disobedience	ulydighed
disobedient	ulydig
disorder	sygdom
disordered	uorganiseret
disorderly	uordentligt
disorganized	uorganiseret
disorient	forvirre
disoriented	desorienteret
disown	fornægte
disparage	underkende
disparaging	nedsættende
disparagingly	nedsættende
dispensable	undværes
dispirited	nedslået
dispiriting	nedslående
displace	fordrive
displaced	forskudt
displease	mishage
displeased	utilfreds
displeasure	mishag
disproportionate	uforholdsmæssig
disprove	modbevise
disputable	diskutabelt
dispute	bestride
disputed	omstridte
disquiet	uro
disquieting	foruroligende
disquietingly	foruroligende
disquietude	uro
disregard	foragt
disregardful	uopmærksom
disreputable	berygtet
disrepute	miskredit
disrespect	respektløshed
disrespectful	respektløst
disrespectfully	respektløst
disrupt	afbryde
disruption	forstyrrelser
disruptive	forstyrrende
dissapointed	skuffet
dissappointed	skuffet
dissatisfaction	utilfredshed
dissatisfactory	utilfredsstillende
dissatisfied	utilfreds
dissatisfying	utilfredsstillende
dissemble	forstille
dissension	splid
dissent	uenighed
disservice	bjørnetjeneste
dissidence	dissidens
dissidents	dissidenter
dissolute	udsvævende
dissolution	opløsning
dissonance	dissonans
dissonant	dissonante
dissonantly	dissonerende
dissuade	afholde
dissuasive	afskrækkende
distaste	afsmag
distasteful	usmagelig
distort	fordreje
distorted	forvrænget
distortion	forvrængning
distorts	fordrejer
distract	distrahere
distracting	distraherende
distraction	distraktion
distraught	fortvivlet
distress	nød
distressed	nødstedte
distressing	rystende
distressingly	foruroligende
distrust	mistillid
distrustful	mistroiske
distrusting	mistillid
disturb	forstyrre
disturbance	forstyrrelse
disturbed	forstyrret
disturbing	foruroligende
disturbingly	foruroligende
disunity	splittelse
divergent	divergerende
divisive	splittende
divisiveness	splittelse
dizzy	svimmel
doddering	mimrende
dogged	udholdende
doggedly	stædigt
dogmatic	dogmatisk
doldrums	dødvande
domineering	dominerende
doomed	dømt
doomsday	dommedag
doubt	tvivl
doubtful	tvivlsom
doubtfully	tvivlende
doubts	tvivl
douchebag	idiot
downcast	nedslået
downer	nedtur
downfall	fald
downgrade	nedgradering
downhearted	modfaldne
downsides	ulemper
downturn	nedtur
downturns	nedgangstider
drab	kedelig
draconian	drakoniske
draconic	draconic
dragged	slæbte
dragging	trække
dragoon	dragon
drags	slæber
drain	dræne
drained	drænet
draining	dræning
drains	afløb
drastic	drastisk
drastically	drastisk
drawback	ulempe
drawbacks	ulemper
dread	rædsel
dreadful	forfærdelig
dreadfully	frygtelig
dreadfulness	forfærdelige
dreary	kedelig
dripped	dryppede
dripping	dryp
drips	drypper
drones	droner
droop	hænge
drought	tørke
drowning	drukning
drunk	beruset
drunkard	drukkenbolt
drunken	beruset
dubious	tvivlsom
dubiously	tvivlende
dud	blindgænger
dull	kedelig
dumb	dum
dumped	dumpet
dumps	lossepladser
dunce	tumpe
dungeon	fangehul
dust	støv
dusty	støvet
dwindling	svindende
dying	døende
eccentric	excentrisk
eccentricity	excentricitet
effigy	statue
effrontery	uforskammethed
egocentric	egocentrisk
egomania	storhedsvanvid
egotism	egoisme
egotistical	egoistisk
egotistically	egoistisk
egregious	ekstreme
election-rigger	valg-rigger
emaciated	afmagret
emasculate	svække
embarrass	genere
embarrassing	pinlig
embarrassingly	pinligt
embarrassment	forlegenhed
embattled	kampberedt
embroil	indvikle
embroiled	involveret
emergency	nødsituation
emphatic	empatisk
emphatically	eftertrykkeligt
emptiness	tomhed
encroachment	indgreb
endanger	fare
enemies	fjender
enemy	fjende
enfeeble	svække
enflame	opflamme
engulf	opsluge
enjoin	påbyde
enmity	fjendskab
enraged	rasende
enslave	slavebinde
entangle	vikle
entanglement	sammenfiltring
entrap	fange
entrapment	fastklemning
envious	misundelig
enviously	misundeligt
epidemic	epidemi
equivocal	tvetydig
erase	slette
erode	erodere
erodes	eroderer
errant	vildfaren
erratic	uregelmæssig
erratically	uregelmæssigt
erroneous	fejlagtige
erroneously	fejlagtigt
error	fejl
errors	fejl
eruptions	udbrud
escapade	eskapade
estranged	fremmedgjort
evade	unddrage
evasion	omgåelse
evasive	undvigende
evil	ond
evils	onder
exacerbate	forværre
exagerated	overdrevet
exaggerate	overdrive
exaggeration	overdrivelse
exasperated	irriteret
exasperating	irriterende
exasperation	harme
excessive	overdreven
excessively	overdrevent
exclusion	undtagelse
excruciating	ulidelig
excruciatingly	ulideligt
excuse	undskyldning
excuses	undskyldninger
execrate	forbande
exhaust	udstødning
exhausted	udmattet
exhaustion	udmattelse
exhausts	udstødninger
exhort	formane
exile	eksil
exorbitant	ublu
exorbitantly	kvalte
expel	bortvise
expensive	dyrt
expire	udløbe
expired	udløbet
explode	eksplodere
exploit	udnytte
exploitation	udnyttelse
explosive	eksplosiv
expropriate	ekspropriere
expropriation	ekspropriation
expunge	udslette
exterminate	udrydde
extermination	udryddelse
extinguish	slukke
extort	afpresse
extortion	afpresning
extraneous	uvedkommende
extravagance	ekstravagance
extravagant	ekstravagant
extravagantly	overdådigt
extremism	ekstremisme
extremist	ekstremist
extremists	ekstremister
fabricate	fabrikere
fabrication	fabrikation
facetious	spottende
fail	svigte
failed	mislykkedes
failing	svigtende
fails	mislykkes
failure	fiasko
failures	svigt
faint	svag
faithless	troløse
fake	falsk
fall	efterår
fallacies	fejlslutninger
fallacious	fejlagtig
fallacy	fejlslutning
fallen	fallen
falling	faldende
false	falsk
falsehood	falskhed
falsely	falsk
falsify	forfalske
falter	vakle
faltered	vaklet
famine	hungersnød
fanatic	fanatisk
fanatical	fanatisk
fanatically	fanatisk
fanaticism	fanatisme
fanatics	fanatikere
fanciful	fantasifulde
farcical	farceagtige
farcical-yet-provocative	farceagtige-endnu-provokerende
farcically	farceagtigt
fascism	fascisme
fastidious	kræsen
fastidiously	kræsent
fat	fed
fat-cats	fedt-katte
fatalistic	fatalistisk
fatalistically	fatalistisk
fatally	dødeligt
fateful	skæbnesvangre
fatefully	skæbnesvangert
fatigue	træthed
fatigued	trættes
fatique	trætheden
fatty	fed
fatuity	selvforgudelse
fatuous	tåbeligt
fault	fejl
faults	fejl
faulty	defekt
fear	frygt
fearful	frygtsomme
fearfully	frygtsomt
fears	frygt
fearsome	frygtfuld
feeble	svag
feebleminded	åndssvag
feign	foregive
feint	finte
fell	faldt
felon	forbryder
ferociously	voldsomt
ferocity	vildskab
fetid	stinkende
fever	feber
feverish	febrilsk
fevers	feber
fiasco	fiasko
fickle	vægelsindet
fiction	fiktion
fictional	fiktive
fictitious	fiktiv
fidgety	feltstol
fiend	djævel
fiendish	djævelsk
fierce	voldsom
figurehead	galionsfigur
filth	snavs
filthy	beskidte
finicky	kræsen
fissures	sprækker
fist	næve
flabbergasted	paf
flagging	udflagning
flagrant	åbenlys
flagrantly	åbenlyst
flaking	afskalning
flaky	skællet
flares	nødblus
flaunt	flagre
flaw	fejl
flawed	fejlbehæftet
flaws	fejl
flee	flygte
fleeing	flygter
fleer	fleer
flees	flygter
fleeting	flygtig
flicker	flimmer
flickering	blinkende
flickers	flimrer
flighty	flyvsk
flimsy	spinkelt
flirty	flirtende
flounder	rødspætte
floundering	sprællede
foe	fjende
fool	narre
fooled	narre
foolhardy	dumdristig
foolish	tåbelig
foolishly	tåbeligt
foolishness	tåbelighed
forbid	forbyde
forbidden	forbudt
forbidding	forbyder
forceful	insisterende
foreboding	forudanelse
forfeit	miste
forged	smedet
forgetful	glemsom
forgetfulness	glemsomhed
forlorn	forladt
forsake	svigte
forsaken	forladt
foul	modbydeligt
fractious	skrøbelig
fracture	knoglebrud
fragile	skrøbelig
fragmented	fragmenteret
frail	skrøbelig
frantic	hektisk
frantically	febrilsk
fraud	svig
fraudulent	svigagtig
fraught	fyldt
freak	tosse
freakish	lunefulde
freeze	fryse
freezes	fryser
freezing	fryser
frenetic	hektiske
frenzied	forrykte
frenzy	vanvid
fret	klynke
friction	friktion
frictions	gnidninger
fried	stegt
fright	forskrækkelse
frighten	skræmme
frightening	skræmmende
frighteningly	skræmmende
frightful	frygtelige
frightfully	frygtelig
froze	frøs
frozen	frosset
fruitless	frugtesløse
fruitlessly	forgæves
frustrate	frustrere
frustrated	frustreret
frustrates	frustrerer
frustrating	frustrerende
frustratingly	frustrerende
frustrations	frustrationer
fuck	fanden
fucking	skide
fudge	fusk
fugitive	flygtning
fulminate	rase
fumble	fumle
fume	røg
fumes	dampe
fundamentalism	fundamentalisme
funnily	skægt
funny	sjov
furious	rasende
furiously	rasende
furor	furore
fury	raseri
fuss	ballade
fussy	kræsen
fusty	muggen
futile	forgæves
futilely	forgæves
futility	tomhed
gaffe	brøler
gainsay	modsige
gall	galde
galling	rivning
galls	galler
gape	måbe
garbage	affald
garish	skrigende
gasp	gispe
gaudy	prangende
gawky	klodset
genocide	folkedrab
ghastly	skrækkelige
gibber	plaprerier
gibberish	sludder
gibe	gibe
giddy	svimmel
gimmicky	popsmart
glare	blænding
glaringly	grelt
glitch	fejl
gloatingly	skadefro
gloom	dysterhed
gloomy	dyster
glum	mut
glut	overflod
gnawing	gnave
goad	anspore
god-awful	møgelendige
goof	mule
goofy	fedtmule
goon	fortsæt
gossip	sladre
graft	pode
grainy	kornet
grapple	kæmpe
grate	rist
grating	rist
gravely	alvorligt
greasy	fedtet
greed	grådighed
greedy	grådig
grief	sorg
grievance	klage
grievances	klager
grieving	sørgende
grievous	grov
grievously	svarlig
grim	barsk
grimace	grimasse
grind	male
gripe	brokke
gripes	kvababbelser
grisly	uhyggelig
gritty	grynet
gross	brutto
grossly	groft
grotesque	grotesk
grouchy	gnaven
groundless	grundløse
grouse	rype
growl	knurre
grudge	nag
grudges	nag
grudging	modstræbende
grudgingly	modstræbende
gruesome	grusomme
gruesomely	grusomt
gruff	bister
grumble	knurre
grumpy	gnaven
guile	list
guilt	skyld
guiltily	skyldbevidst
guilty	skyldig
gullible	godtroende
gutless	hjerteløst
gutter	tagrende
haggard	udtæret
hairloss	hårtab
halfhearted	halvhjertet
hallucinate	hallucinere
hamper	hæmme
hampered	hæmmet
handicapped	handicappet
hang	hænge
hangs	hænger
haphazard	tilfældig
hapless	ulykkelige
harangue	tale
harass	plage
harassed	chikaneret
harasses	chikanerer
harassment	chikane
harboring	husly
harbors	havne
hard	hårdt
harden	harden
hardened	hærdet
hardhearted	hårdhjertet
hardliners	høge
hardship	trængsler
hardships	strabadser
harm	skade
harmed	skadet
harmful	skadelig
harms	skader
harridan	harridan
harried	jaget
harrow	harve
harsh	barske
harshly	hårdt
hassle	besvær
hassled	chikaneret
hassles	besvær
haste	hastværk
hastily	hastigt
hasty	forhastet
hate	had
hated	hadet
hateful	hadefulde
hatefully	hadefuldt
haters	hadere
hates	hader
hating	hade
hatred	had
haughtily	overlegent
haughty	hovmodige
haunt	hjemsøge
haunting	jagende
havoc	ødelæggelse
hawkish	høgeagtig
haywire	skuddermudder
hazard	fare
hazardous	farlig
haze	dis
hazy	diset
head-aches	hoved-ømhed
headache	hovedpine
headaches	hovedpine
heartbreaker	heartbreaker
heartbreaking	hjerteskærende
heartless	hjerteløs
heathen	hedning
heavy-handed	hårdhændet
heck	dælen
heckle	heckle
heckled	tilråb
hectic	hektisk
hedge	hæk
hedonistic	hedonistiske
hefty	velvoksen
hegemonism	hegemoni
hegemonistic	hegemonisk
hegemony	hegemoni
heinous	afskyelig
hell	helvede
hellion	hellion
hells	helveder
helpless	hjælpeløs
helplessly	hjælpeløst
helplessness	hjælpeløshed
heresy	kætteri
heretic	kætter
heretical	kættersk
hesitant	tøvende
hideous	hæslige
hideously	fælt
hideousness	hæslighed
hinder	hindre
hindrance	hindring
hiss	hvisle
hissed	hvæsede
hissing	hvislende
hoard	hamstre
hoax	fupnummer
hobble	humpe
hogs	svin
hollow	hule
hoodwink	bluffe
hopeless	håbløs
hopelessly	håbløst
hopelessness	håbløshed
horrendous	forfærdelige
horrendously	skrækkeligt
horrible	forfærdelig
horrid	fælt
horrific	rædselsvækkende
horrified	forfærdet
horrifies	forfærder
horrify	forfærde
horrifying	gruopvækkende
hostage	gidsel
hostile	fjendtlig
hostilities	fjendtligheder
hostility	fjendtlighed
hotbeds	arnesteder
hothead	brushoved
hotheaded	opfarende
hothouse	væksthus
hubris	hybris
huckster	spækhøker
hum	brummen
humid	fugtig
humiliate	ydmyge
humiliating	ydmygende
humiliation	ydmygelse
humming	nynnen
hung	hang
hurtful	sårende
hurting	såre
hypocricy	hykleri
hypocrisy	hykleri
hypocrite	hykler
hypocrites	hyklere
hypocritical	dobbeltmoralsk
hypocritically	hyklerisk
hysteria	hysteri
hysterical	hysterisk
hysterically	hysterisk
hysterics	hysteri
idiocy	idioti
idiotic	idiotisk
idiotically	idiotisk
idiots	idioter
idle	ledig
ignoble	uværdig
ignominious	forsmædeligt
ignominiously	forsmædeligt
ignominy	skændsel
ignorance	uvidenhed
ignorant	uvidende
ignore	ignorere
ill-advised	uklog
ill-fated	ulyksalige
ill-mannered	uopdragen
ill-natured	gnavne
ill-tempered	arrig
ill-treated	mishandlet
ill-treatment	mishandling
illegal	ulovlig
illegally	ulovligt
illegitimate	uægte
illicit	ulovlig
illiterate	analfabetisk
illness	sygdom
illogical	ulogisk
illogically	ulogisk
illusions	illusioner
illusory	illusorisk
imaginary	imaginært
imbalance	uligevægt
imbecile	tåbe
immaterial	uvæsentlig
immature	umoden
imminently	overhængende
immobilized	immobiliseret
immoderate	umådeholden
immoderately	umådeligt
immodest	usømmeligt
immoral	umoralsk
immorality	umoral
immorally	umoralsk
immovable	ubevægelig
impair	hæmmet
impaired	svækket
impasse	dødvande
impatience	utålmodighed
impatient	utålmodig
impatiently	utålmodigt
impeach	anklage
impedance	impedans
impede	hindre
impediment	hindring
impending	forestående
impenitent	ubodfærdige
imperfect	ufuldkommen
imperfection	ufuldkommenhed
imperfections	ufuldkommenheder
imperfectly	ufuldkomment
imperialist	imperialistiske
imperil	true
imperious	bydende
imperiously	bydende
impermissible	utilladeligt
impersonal	upersonlig
impertinent	uforskammet
impetuous	fremfusende
impetuously	heftigt
impiety	ugudelighed
impinge	kolliderer
impious	ugudelig
implacable	uforsonlig
implausible	usandsynlig
implicate	implicere
implication	implikation
implode	implodere
impolite	uhøfligt
impolitic	upolitisk
importunate	påtrængende
impose	pålægge
imposing	pålægge
imposition	indførelse
impossible	umulig
impossibly	håbløst
impoverish	forarme
impoverished	forarmede
impractical	upraktisk
imprecise	upræcise
imprecisely	upræcist
imprecision	unøjagtighed
imprison	fængsle
imprisonment	fængsling
improbability	usandsynlighed
improbable	usandsynlig
improbably	usandsynligt
improper	upassende
improperly	forkert
impropriety	uregelmæssigheder
imprudence	uforsigtighed
imprudent	uforsigtig
impudence	frækhed
impudent	uforskammet
impudently	frækt
impugn	bestride
impulsive	impulsiv
impulsively	impulsivt
impunity	straffrihed
impure	uren
impurity	urenhed
inaccuracies	unøjagtigheder
inaccuracy	unøjagtighed
inaccurate	forkert
inaccurately	unøjagtigt
inaction	passivitet
inactive	inaktiv
inadequacy	utilstrækkelighed
inadequate	utilstrækkelig
inadequately	utilstrækkeligt
inadvisable	utilrådeligt
inane	åndsforladt
inappropriate	upassende
inappropriately	uhensigtsmæssigt
inapt	uegnet
inaptitude	uegnethed
inarticulate	uartikulerede
inattentive	uopmærksom
inaudible	uhørlig
incapable	stand
incautious	uforsigtig
incendiary	brandbomber
incense	røgelse
incessant	uophørlige
incessantly	uophørligt
incite	tilskynde
incitement	tilskyndelse
incivility	uhøflighed
inclement	barskt
incoherent	usammenhængende
incoherently	usammenhængende
incommensurate	utilstrækkeligt
incomparable	uforlignelige
incomparably	usammenligneligt
incompatability	uforenelighed
incompatibility	uforenelighed
incompatible	uforenelig
incompetence	inkompetence
incompetent	inkompetent
incomplete	ufuldstændig
incomprehensible	uforståelig
incomprehension	uforstående
inconceivable	utænkeligt
inconceivably	ufatteligt
incongruous	inkongruent
inconsequent	inkonsekvent
inconsequential	ligegyldig
inconsiderate	ubetænksom
inconsistencies	uoverensstemmelser
inconsistency	uoverensstemmelse
inconsistent	inkonsekvent
inconsolable	utrøstelig
inconsolably	utrøsteligt
inconstant	ustadig
inconvenience	ulejlighed
inconveniently	uhensigtsmæssig
incorrect	ukorrekt
incorrectly	forkert
incorrigible	uforbederlig
incorrigibly	uforbederligt
incredulous	skeptisk
inculcate	indpode
indecency	uanstændighed
indecent	uanstændig
indecently	uanstændigt
indecision	ubeslutsomhed
indecisive	ubeslutsom
indecisively	ubeslutsomt
indefensible	uforsvarligt
indelicate	taktløs
indeterminable	ubestemmelig
indeterminate	ubestemt
indifference	ligegyldighed
indifferent	ligegyldig
indigent	trængende
indignant	indignerede
indignantly	indigneret
indignation	harme
indignity	tort
indiscernible	umærkelig
indiscreet	indiskret
indiscretion	indiskretion
indiscriminate	vilkårlige
indiscriminately	flæng
indistinguishable	skelnes
indoctrinate	indoktrinere
indoctrination	indoktrinering
indulge	forkæle
ineffective	ineffektiv
ineffectively	ineffektivt
ineffectiveness	ineffektivitet
ineffectual	virkningsløs
ineffectually	ineffektivt
inefficacious	virkningsløs
inefficacy	ineffektivitet
inefficiency	ineffektivitet
inefficient	ineffektiv
inefficiently	ineffektivt
inelegant	uelegant
ineligible	støtteberettigede
inept	uduelig
ineptitude	uduelighed
ineptly	klodset
inequalities	uligheder
inequality	ulighed
inequitable	uretfærdig
inequitably	urimelig
inequities	uligheder
inescapable	uundgåelig
inescapably	uundgåeligt
inessential	uvæsentlig
inevitable	uundgåelige
inevitably	uundgåeligt
inexcusable	utilgiveligt
inexcusably	utilgiveligt
inexorable	ubønhørlig
inexorably	ubønhørligt
inexperience	uerfarenhed
inexperienced	uerfarne
inexpert	ukyndig
inexpertly	ukyndigt
inextricable	uløselig
inextricably	uløseligt
infamous	berygtede
infamously	infamt
infamy	skændsel
infected	inficeret
infection	infektion
infections	infektioner
inferior	underlegen
inferiority	underlegenhed
infernal	infernalsk
infest	angribe
infested	angrebne
infidel	vantro
infidels	vantro
infiltrator	infiltrator
infiltrators	infiltratorer
infirm	svagelige
inflame	opflamme
inflammation	betændelse
inflammatory	inflammatorisk
inflammed	betændt
inflated	oppustet
inflationary	inflationær
inflexible	ufleksibel
inflict	påføre
infraction	overtrædelse
infringe	krænke
infringement	krænkelse
infringements	overtrædelser
infuriate	hidse
infuriated	rasende
infuriating	oprørende
ingrate	utaknemlig
ingratitude	utaknemmelighed
inhibit	inhibere
inhibition	inhibering
inhospitable	ugæstfri
inhospitality	ugæstfrihed
inhuman	umenneskelig
inhumane	umenneskelig
inhumanity	umenneskelighed
inimical	fjendtlig
iniquitous	uretfærdige
iniquity	uret
injudicious	uklogt
injure	beskadige
injurious	skadelig
injury	skade
injustice	uretfærdighed
injustices	uretfærdigheder
innuendo	insinuationer
inoperable	ubrugeligt
inopportune	ubelejlig
inordinate	overdrevne
inordinately	uforholdsmæssigt
insane	sindssyg
insanely	sindssygt
insanity	sindssyge
insatiable	umættelig
insecure	usikker
insecurity	usikkerhed
insensible	følelsesløse
insensitive	ufølsom
insensitively	ufølsomt
insensitivity	ufølsomhed
insidious	snigende
insidiously	snigende
insignificance	ubetydelighed
insignificant	ubetydelig
insignificantly	ubetydeligt
insincere	uoprigtig
insincerity	uærlighed
insinuate	insinuere
insinuating	indsmigrende
insolence	uforskammethed
insolent	uforskammet
insolently	uforskammet
insolvent	konkurs
insouciance	sorgløshed
instability	ustabilitet
instable	ustabil
instigate	anstifte
instigator	anstifter
instigators	anstiftere
insubordinate	ulydig
insubstantial	uvæsentlige
insubstantially	ubetydeligt
insufferable	ulidelig
insufficiency	insufficiens
insufficient	utilstrækkelig
insufficiently	utilstrækkeligt
insular	ø
insult	fornærme
insulted	fornærmet
insulting	fornærmende
insultingly	fornærmende
insults	fornærmelser
insupportable	uudholdelig
insurmountable	uovervindelige
insurmountably	uløseligt
insurrection	oprør
intense	intens
interfere	blande
interference	interferens
interferes	forstyrrer
intermittent	sporadisk
interrupt	afbryde
interruption	afbrydelse
interruptions	afbrydelser
intimidate	skræmme
intimidating	skræmmende
intimidation	intimidering
intolerable	utålelig
intoxicate	beruse
intractable	umedgørlig
intransigence	uforsonlighed
intransigent	uforsonlige
intrude	trænge
intrusion	indbrud
intrusive	påtrængende
inundate	oversvømme
inundated	oversvømmet
invader	angriber
invalid	ugyldig
invalidate	afkræfte
invalidity	invaliditet
invasive	invasiv
invective	skældsord
inveigle	lokke
invidious	uheldige
invidiously	uretfærdigt
invisible	usynlig
involuntarily	ufrivilligt
involuntary	ufrivillig
irascible	opfarende
irate	harmdirrende
irked	irriterede
irks	irriterer
irksomeness	besværlighed
ironic	ironisk
ironical	ironisk
ironically	ironisk
ironies	ironier
irony	ironi
irrational	irrationel
irrationalities	irrationalitet
irrationality	irrationalitet
irrationally	irrationelt
irreconcilable	uforenelige
irrecoverable	uerholdeligt
irrecoverably	uigenkaldeligt
irredeemable	uopsigeligt
irredeemably	uigenkaldeligt
irregular	uregelmæssig
irregularity	uregelmæssighed
irrelevance	irrelevans
irreparable	uoprettelig
irrepressible	ukuelig
irresolute	ubeslutsom
irresolvable	uløseligt
irresponsible	uansvarlig
irresponsibly	uansvarligt
irretrievable	uigenkaldeligt
irreversible	irreversibel
irritable	irritabel
irritably	irriteret
irritant	lokalirriterende
irritate	irritere
irritated	irriteret
irritating	irriterende
irritations	irritationer
isolate	isolere
isolated	isolerede
issue	problem
issues	problemer
itch	kløe
itching	kløe
itchy	kløende
jaded	slidte
jagged	takkede
jam	marmelade
jarring	disharmonisk
jealous	jaloux
jealously	nidkært
jealousy	misundelse
jeer	spotte
jeering	hujende
jeopardize	true
jeopardy	fare
jerk	fjols
jitters	rystesyge
jittery	nervøs
job-killing	job-drab
jobless	arbejdsløs
jolt	rystelse
judder	vibrationer
juddering	vibrationer
jumpy	hoppende
junky	elendige
junkyard	junkyard
jutter	jutter
kill	dræbe
killed	dræbt
killer	morder
killing	drab
killjoy	lyseslukker
kills	drab
knife	kniv
knock	banke
knotted	knyttede
lack	mangel
lacked	manglede
lackey	lakaj
lackeys	lakajer
lacking	mangler
lackluster	glansløse
lacks	mangler
laconic	lakonisk
lag	forsinkelse
lagged	haltet
lagging	halter
lags	halter
laid-off	afskediget
lambast	skælde
lame	halt
lame-duck	flop
lament	klagesang
lamentable	beklagelig
lamentably	beklageligt
languid	sløv
languor	mathed
languorous	smægtende
lanky	ranglet
lapse	bortfalder
lapsed	bortfaldet
lapses	bortfalder
lascivious	pirrende
latency	latens
laughable	latterlig
laughably	latterligt
laughingstock	grin
lawbreaker	lovovertræder
lawbreaking	lovbrud
lawless	lovløs
lawlessness	lovløshed
layoff	fritstille
layoff-happy	fritstille-glad
lazy	doven
leak	lække
leakage	lækage
leakages	lækager
leaking	utæt
leaks	lækager
leaky	utæt
lech	lech
lecherous	liderlig
lechery	liderlighed
leech	igle
leery	mistænksom
left-leaning	venstreorienterede
lemon	citron
lengthy	langvarig
lethal	dødbringende
lethargic	sløv
lethargy	sløvhed
lewd	uanstændig
lewdness	utugt
liability	ansvar
liable	ansvarlig
liar	løgner
liars	løgnere
licentious	tøjlesløs
licentiousness	tøjlesløshed
lie	ligge
lied	løj
lier	løgner
lies	løgne
life-threatening	livstruende
lifeless	livløs
limit	begrænse
limitation	begrænsning
limitations	begrænsninger
limited	begrænset
limits	grænser
limp	halte
listless	sløv
livid	gusten
loath	tilbageholdne
loathe	væmmes
loathing	afsky
loathsome	modbydelig
loneliness	ensomhed
lonely	ensom
loner	enspænder
lonesome	ensom
long-winded	langtrukken
longingly	længselsfuldt
loophole	smuthul
loopholes	smuthuller
loose	løs
loot	plyndre
lorn	lorn
lose	tabe
loser	taber
losers	tabere
loses	taber
losing	miste
loss	tab
losses	tab
loud	højt
louder	højere
lousy	elendig
lovelorn	elskovssyge
low-rated	lav-rated
lowly	ydmyg
ludicrous	latterlig
ludicrously	latterligt
lukewarm	lunken
lull	dysse
lumpy	klumpet
lunatic	sindssyg
lurch	stikken
lure	lokke
lurid	skumle
lurk	lure
lurking	lurer
macabre	makabre
mad	gal
madden	madden
maddening	besværlig
madder	krap
madly	vildt
madman	galning
madness	vanvid
maladjusted	adfærdsvanskelige
maladjustment	tilpasningsproblemer
malady	sygdom
malaise	utilpashed
malevolence	ondsindede
malevolent	ondsindet
malice	ondskab
malicious	ondsindet
maliciously	skadelig
maliciousness	ondskab
malignant	ondartet
malodorous	ildelugtende
maltreatment	mishandling
mangled	lemlæstede
mangling	rulning
mania	mani
maniac	sindsyg
maniacal	maniske
manic	manisk
manipulate	manipulere
manipulative	manipulerende
manipulators	manipulatorer
mar	mar
marginal	marginal-
marginally	marginalt
martyrdom	martyrium
martyrdom-seeking	martyrium-søger
mashed	moset
massacre	massakre
massacres	massakrer
matte	mat
mawkish	sødladne
mawkishness	kælenskab
meager	mager
meaningless	meningsløs
meanness	smålighed
measly	sølle
meddlesome	geskæftig
mediocre	middelmådig
mediocrity	middelmådighed
melancholy	melankoli
melodramatic	melodramatisk
melodramatically	melodramatisk
meltdown	nedsmeltning
menace	trussel
menacing	truende
menacingly	truende
mendacious	løgnagtig
mendacity	løgnagtighed
menial	underordnede
merciless	nådesløs
mercilessly	nådesløst
mess	rod
messed	rodet
messes	messer
messy	rodet
midget	dværg
miff	miff
militancy	militarisme
mindless	tankeløs
mirage	fatamorgana
mire	sump
misaligned	skævt
misapprehend	misforstå
misbehave	uartig
miscalculate	fejlbedømme
miscalculation	fejlberegning
miscellaneous	diverse
mischief	ballade
mischievous	drilagtig
mischievously	skælmsk
misconception	misforståelse
misconceptions	misforståelser
miscreant	misdæder
miscreants	skurke
misdirection	vildledning
miser	gnier
miserable	elendig
miserableness	elendighed
miserably	ynkeligt
miseries	elendighed
miserly	nærige
misery	elendighed
misfortune	ulykke
misgiving	betænkelighed
misgivings	betænkeligheder
misguidance	vildledning
misguide	vildlede
misguided	vildledt
mishap	uheld
misinform	misinformere
misinformed	misinformeret
misinterpret	fejlfortolke
misjudge	fejlbedømme
misjudgment	fejlvurdering
mislead	vildlede
misleading	misvisende
misleadingly	misvisende
misread	fejllæsning
misreading	fejllæsning
misrepresent	forvanske
misrepresentation	vildledning
missed	savnet
misstatement	fejlinformation
mist	tåge
mistake	fejl
mistaken	fejl
mistakenly	fejlagtigt
mistakes	fejl
mistress	elskerinde
mistrust	mistillid
mistrustful	mistroisk
mistrustfully	mistænksomt
mists	tåger
misunderstand	misforstå
misunderstanding	misforståelse
misunderstandings	misforståelser
misunderstood	misforstået
misuse	misbruge
moan	jamre
mobster	gangsteren
mocked	drillet
mockery	hån
mocking	spottende
mockingly	hånligt
mocks	spotter
molest	forulempe
molestation	forulempelse
monotonous	ensformigt
monotony	monotoni
monster	uhyre
monstrosities	uhyrligheder
monstrosity	skrummel
monstrous	monstrøs
monstrously	monstrøst
moody	humørsyg
moot	omstridt
morbidly	sygeligt
mordant	bejdsemiddel
moribund	døende
moron	fjols
morons	idioter
mortification	selvfornægtelse
mortified	krænket
mortify	dræber
motionless	ubevægelig
motley	broget
mourner	sørgende
mournful	vemodigt
mournfully	sørgmodigt
muddle	roderi
muddy	mudret
mudslinging	mudderkastning
multi-polarization	multi-polarisering
mundane	hverdagsagtige
murder	mord
murderer	morder
murderous	morderiske
murderously	morderisk
murky	skumle
muscle-flexing	muskel-bøjning
mushy	grødet
musty	muggen
mysterious	mystisk
mystery	mysterium
mystify	mystificere
myth	myte
nagging	nagende
naive	naiv
naively	naivt
narrower	smallere
nastily	skalle
nastiness	ondskab
nasty	grim
naughty	uartig
nauseating	kvalmende
nauseatingly	kvalmende
naïve	naiv
nebulous	tågede
needless	unødvendig
needlessly	unødigt
needy	trængende
nefarious	forbryderiske
negate	negere
negative	negativ
negatives	negativer
negativity	negativitet
neglect	forsømme
neglected	forsømt
negligence	uagtsomhed
negligent	uagtsom
nepotism	nepotisme
nervous	nervøs
nervously	nervøst
nervousness	nervøsitet
nettle	brændenælde
neurotic	neurotisk
neurotically	neurotisk
niggles	stum
nightmare	mareridt
nightmarish	mareridtsagtig
nightmarishly	mareridtsagtig
noise	støj
noises	lyde
noisy	støjende
non-confidence	ikke-tillid
nonexistent	ikke-eksisterende
nonsense	nonsens
nosey	nysgerrig
notoriety	berygtet
notorious	berygtet
notoriously	notorisk
noxious	skadelige
nuisance	plage
numb	følelsesløs
obese	overvægtige
object	objekt
objection	indvending
objectionable	anstødeligt
objections	indvendinger
oblique	skrå
obliterate	udslette
obliterated	udslettet
oblivious	uvidende
obnoxious	klamt
obscene	obskøn
obscenely	obskønt
obscenity	obskønitet
obscure	obskur
obscured	sløres
obscures	tilslører
obscurity	ubemærkethed
obsess	besætte
obsessive	obsessiv
obsessively	fantatiske
obsolete	forældet
obstacle	hindring
obstinate	stædig
obstinately	stædigt
obstruct	hindre
obstructed	obstrueres
obstructing	blokerer
obstruction	obstruktion
obstructs	obstruerer
obtrusive	påtrængende
obtuse	stump
occlude	okkludere
occluded	okkluderet
occludes	okkluderer
occluding	tilstoppende
odd	ulige
oddest	mærkeligste
oddities	mærkværdigheder
oddity	særhed
oddly	mærkeligt
odor	lugt
offence	forbrydelse
offend	fornærme
offender	gerningsmand
offending	fejlende
offenses	lovovertrædelser
offensive	offensiv
offensively	offensivt
officious	geskæftig
ominous	ildevarslende
ominously	ildevarslende
omission	udeladelse
omit	udelade
one-sided	ensidigt
onerous	besværlig
onslaught	stormløb
opinionated	påståelig
opponent	modstander
opportunistic	opportunistisk
opposition	modstand
oppositions	indsigelser
oppress	undertrykke
oppression	undertrykkelse
oppressive	undertrykkende
oppressively	trykkende
oppressors	undertrykkere
ordeal	prøvelser
orphan	sjældne
ostracize	boykotte
outbreak	udbrud
outburst	udbrud
outbursts	udbrud
outcast	udstødt
outcry	ramaskrig
outlaw	fredløs
outmoded	forældet
outrage	skandale
outraged	oprørt
outrageous	uhyrlig
outrageously	uhyrligt
outrages	overgreb
over-acted	over-handlet
over-balanced	over-afbalanceret
over-priced	idet
over-valuation	overvurdering
overawe	imponere
overbalanced	overbalanceret
overbearing	anmassende
overblown	overdrevne
overdo	overdrive
overdone	overdrevet
overdue	forsinket
overheat	overophede
overloaded	overbelastet
overlook	overse
overpaid	overbetalte
overplay	overspille
overpower	overmande
overpriced	overpris
overrated	overvurderet
overreach	magtfuldkommenhed
overrun	overrendt
overshadow	overskygge
oversight	tilsyn
oversights	forglemmelser
oversimplification	oversimplificering
oversimplified	forsimplede
oversimplify	forsimpler
overstate	overdrive
overstated	overvurderet
overstatement	overdrivelse
overstates	overvurderer
overtaxed	overbelastede
overthrow	styrte
overturn	vælte
overweight	overvægtig
overwhelm	overvælde
overwhelmed	overvældet
overwhelming	overvældende
overwhelmingly	overvældende
overwhelms	overvælder
overzealous	nidkære
pain	smerte
painful	smertefuld
painfully	smerteligt
pains	smerter
pale	bleg
pales	blegner
paltry	sølle
pan	pande
pandemonium	pandemonium
pander	lefle
pandering	lefle
panic	panik
panicking	panik
panicky	panikagtig
paradoxical	paradoksalt
paralyzed	lammet
parasite	parasit
pariah	paria
parody	parodi
partiality	partiskhed
partisans	partisaner
passive	passiv
passiveness	passivitet
pathetic	patetisk
pathetically	højrøstet
patronize	nedladende
paucity	knapheden
pauper	fattiglem
paupers	fattiglemmer
payback	hævn
peculiar	ejendommelige
peculiarly	ejendommeligt
pedantic	pedantisk
peeled	skrællet
peeved	irriteret
peevish	vrissen
peevishly	gnavent
penalize	straffe
penalty	straf
perfidious	perfide
perfunctory	overfladiske
perilous	farefulde
perilously	faretruende
perish	forsvinde
pernicious	perniciøs
perplex	forvirre
perplexed	forvirret
perplexing	forvirrende
perplexity	rådvildhed
persecute	forfølge
persecution	forfølgelse
pertinacious	ihærdig
pertinaciously	hårdnakket
pertinacity	stædighed
perturb	forurolige
perturbed	forstyrrede
pervasive	gennemtrængende
perverse	pervers
perversely	perverst
perversity	perversitet
pervert	pervers
perverted	perverteret
perverts	perversion
pessimism	pessimisme
pessimistic	pessimistisk
pessimistically	pessimistisk
pest	skadedyr
pestilent	pest
petrified	forstenet
petrify	forstene
petty	smålige
phobia	fobi
phobic	fobisk
phony	falsk
picket	blokadevagt
picketing	blokade
pickets	strejkevagter
picky	kræsne
pig	svin
pigs	svin
pillage	plyndring
pillory	gabestok
pimple	filipens
pitiable	ynkelig
pitiful	ynkelige
pitifully	ynkeligt
pitiless	ubarmhjertig
pitilessly	ubarmhjertigt
pittance	almisse
pity	medlidenhed
plagiarize	plagiere
plague	pest
plaything	legetøj
plea	anbringende
pleas	anbringender
plebeian	plebejer
plight	skæbne
plot	grund
plotters	plottere
ploy	trick
plunder	plyndre
plunderer	plyndrer
pointless	meningsløs
pointlessly	unødigt
poison	gift
poisonous	giftig
poisonously	højtråbende
polarisation	polarisering
pollute	forurene
polluter	forureneren
polluters	forurenere
polution	forurening
pompous	pompøse
poor	fattige
poorer	fattigere
poorest	fattigste
poorly	dårligt
posturing	poseren
pout	surmule
poverty	fattigdom
powerless	magtesløs
prattle	ævl
precarious	usikre
precariously	usikkert
precipitate	udfælde
precipitous	brat
predatory	aggressiv
predicament	knibe
prejudge	foregribe
prejudice	fordomme
prejudices	fordomme
prejudicial	skade
premeditated	overlagt
preoccupy	optager
preposterous	absurd
presumptuous	anmassende
presumptuously	formasteligt
pretence	forstillelse
pretense	forstillelse
pretentious	prætentiøs
pricey	pebret
pricier	dyrere
prick	pik
prickle	pig
prickles	torne
primitive	primitiv
prison	fængsel
prisoner	fange
problematic	problematisk
problems	problemer
procrastination	overspringshandling
profane	blasfemisk
profanity	bandeord
prohibit	forbyde
prohibitive	uoverkommelige
prohibitively	uoverkommeligt
propagandize	propagandereover
proprietary	proprietære
protested	protesterede
protesting	protesterer
protests	protester
protracted	langvarige
provocation	provokation
provocative	udfordrende
provoke	provokere
pry	lirke
pugnacious	stridbar
punch	patrice
punish	straffe
punishable	straffes
punitive	straffende
puny	svagelig
puppet	marionet
puppets	marionetter
puzzled	forundret
puzzling	gådefuldt
quack	kvaksalver
qualms	skrupler
quandary	dilemma
quarrel	skændes
quarrels	skænderier
quarrelsome	stridbar
quash	omstøde
questionable	tvivlsom
quibble	brokker
quibbles	skænderier
rabid	rabiat
racism	racisme
racists	racister
racy	krati
radical	radikal
radicalization	radikalisering
radically	radikalt
radicals	radikaler
rage	raseri
ragged	pjaltet
raging	raser
rail	jernbane
rampage	krigsstien
rampant	grasserende
ramshackle	faldefærdige
rancor	bitterhed
randomly	tilfældigt
rankle	nager
rant	tirade
ranted	rasede
ranting	fantasmer
rape	voldtage
raped	voldtaget
raping	voldtage
rascal	slyngel
rascals	slyngler
rash	udslæt
rattle	rangle
rattled	raslede
rattles	rangler
ravage	hærge
raving	rablende
reactionary	reaktionær
rebellious	oprørsk
rebuff	afvise
rebuke	irettesættelse
recalcitrant	genstridige
recant	afsværge
recessionary	recession
reckless	hensynsløs
recklessly	hensynsløst
recklessness	hensynsløshed
recoil	rekyl
recourses	resurser
redundancy	redundans
redundant	overflødig
refusal	afslag
refuse	nægte
refused	nægtede
refuses	nægter
refusing	nægter
refutation	gendrivelse
refute	tilbagevise
refuted	modbevist
refutes	modbeviser
refuting	gendrive
regress	relatere
regressive	regressiv
regret	fortryde
regretful	beklagende
regretfully	beklagelse
regrets	beklager
regrettable	beklageligt
regrettably	desværre
regretted	fortrudt
reject	afvise
rejected	afvist
rejecting	afvise
rejection	afvisning
rejects	afviser
relapse	tilbagefald
relentless	ubarmhjertig
relentlessly	ubønhørligt
relentlessness	ubønhørlighed
reluctance	tilbageholdenhed
reluctant	modstræbende
reluctantly	modvilligt
remorse	anger
remorseful	angerfuld
remorseless	ubarmhjertige
remorselessly	ubarmhjertigt
renunciation	afkald
repel	frastøde
reprehensible	forkasteligt
repress	undertrykke
repression	undertrykkelse
repressive	undertrykkende
reprimand	irettesættelse
reproach	bebrejdelse
reproachful	bebrejdende
reprove	irettesætte
reprovingly	irettesættende
repudiate	afvise
repudiation	afvisning
repugnance	modvilje
repugnant	frastødende
repulse	repulse
repulsive	frastødende
repulsively	frastødende
resentful	krænket
resentment	vrede
resigned	resigneret
resistance	modstand
restless	rastløs
restlessness	rastløshed
restrict	begrænse
restricted	begrænset
restriction	begrænsning
restrictive	restriktiv
resurgent	genopstået
retaliatory	gengældelsesaktioner
retarded	retarderet
reticent	tilbageholdende
revenge	hævn
revengeful	hævngerrig
revile	håner
reviled	hånet
revoke	tilbagekalde
revolt	opstand
revolting	oprørende
revulsion	afsky
rhetoric	retorik
rhetorical	retorisk
ridicule	latterliggøre
ridiculous	latterlig
ridiculously	latterligt
rife	udbredt
rift	splittelse
rifts	kløfter
rigid	stiv
rigidity	stivhed
rile	ærgre
ripped	rippet
risk	risiko
risks	risici
risky	risikabel
rival	konkurrerende
rivalry	rivalisering
roadblocks	vejspærringer
rocky	stenet
rogue	rogue
rollercoaster	rutsjebane
rot	rådne
rotten	rådne
rough	ru
rubbish	vrøvl
rude	uhøflig
ruffian	bandit
ruffle	flæse
ruined	ødelagt
ruining	ødelægge
ruinous	ruinerende
ruins	ruiner
rumbling	rumlen
rumor	rygte
rumors	rygter
rumours	rygter
rupture	brud
rusts	ruster
rusty	rusten
rut	skure
ruthless	ubarmhjertig
ruthlessly	hensynsløst
ruthlessness	hensynsløshed
ruts	hjulspor
sack	sæk
sacrificed	aflivet
sad	trist
sadden	bedrøve
sadly	desværre
sadness	sorg
sag	synke
sagged	hang
sags	afskalninger
salacious	slibrige
sanctimonious	skinhellige
sap	saft
sarcasm	sarkasme
sarcastic	sarkastisk
sarcastically	sarkastisk
sardonically	sarkastisk
satirical	satirisk
satirize	satirisere
savage	brutal
savagery	vildskab
savages	vilde
scaly	skællende
scam	fup
scams	svindel
scandal	skandale
scandalize	skandalisere
scandalized	forarges
scandalous	skandaløs
scandalously	skandaløst
scandals	skandaler
scant	sparsomme
scapegoat	syndebuk
scar	ar
scarce	knap
scarcely	næppe
scarcity	mangel
scare	skræmme
scared	skræmt
scarred	arret
scars	ar
scary	skræmmende
scathing	sønderlemmende
scathingly	spottende
sceptical	skeptisk
scoff	håner
scolded	skældt
scorching	glohed
scorn	hån
scornful	hånlig
scornfully	hånligt
scourge	svøbe
scrap	skrot
scratch	kradse
scream	skrige
screech	skrig
screwed	skruet
scuffs	skrammer
secretive	hemmelighedsfuld
sedentary	stillesiddende
selfish	selvisk
senile	senil
seriousness	alvor
sever	skille
severe	alvorlig
severity	alvorlighed
shady	lyssky
shallow	overfladisk
sham	falsk
shame	skam
shameful	skammeligt
shameless	skamløs
shark	haj
sharply	skarpt
shimmer	glimmer
shock	chok
shocked	chokeret
shocking	chokerende
shoddy	sjuskede
shortage	mangel
shortcoming	mangel
shortcomings	mangler
shrew	spidsmus
shroud	svøb
shrug	skuldertræk
shun	skye
shunned	undgået
sick	syg
siege	belejring
silly	fjollet
sink	håndvask
skeptical	skeptisk
skinny	mager
skulk	luske
slack	slæk
slander	bagvaskelse
slanderous	bagtalende
slap	smække
slaughter	slagte
sloth	dovendyr
slothful	doven
slow	langsom
slower	langsommere
slowest	langsomste
slowly	langsomt
sluggish	træg
slump	nedturen
slur	nedværdigelse
sly	snu
smack	lussing
smash	smadre
smell	lugt
smoke	røg
smoldering	ulmende
smug	selvglad
snarl	snerren
sneaky	luskede
sneer	vrængen
snub	irettesættelse
soapy	sæbevand
sobering	nedslående
somber	dyster
sore	øm
soreness	ømhed
sorrow	sorg
sorrowful	sorgfuld
sorrowfully	bedrøvet
sorry	undskyld
sour	sur
spilling	spilde
spinster	gammeljomfru
spite	trods
spiteful	ondsindet
split	dele
splitting	opsplitning
spoil	forkæle
spoiled	forkælet
spoils	byttet
sporadic	sporadisk
spotty	plettet
spurious	uægte
sputter	sprutte
squabble	kævl
squander	ødsle
squirm	vride
stagnant	stillestående
stain	plet
starvation	sult
starve	sulte
static	statisk
steal	stjæle
stern	agterstavn
sticky	klæbrig
stiff	stiv
stiffness	stivhed
sting	stik
stole	stjal
stolen	stjålet
stooge	stikirenddreng
stooges	håndlangere
stormy	stormfuld
straggler	efternøler
strained	anstrengt
strange	mærkelig
strangely	mærkeligt
stranger	fremmed
strangle	kvæle
strenuous	anstrengende
stressful	stressende
strict	streng
strictly	strengt
struggle	kamp
stubborn	stædig
stupid	dum
stupidest	dummeste
stupidity	dumhed
stupidly	dumt
sty	stald
stymied	forpurret
subdued	dæmpet
subordinate	underordnet
subservience	underdanighed
subservient	underdanig
suck	suge
sue	sagsøge
sued	sagsøgt
suicidal	selvmordstanker
sulk	surmule
sullen	tvær
superficial	overfladisk
superstition	overtro
superstitious	overtroisk
suppress	undertrykke
surrender	overgivelse
susceptible	modtagelig
suspect	formode
suspicion	mistanke
suspicious	mistænksom
swamped	oversvømmet
swelling	hævelse
swipe	knalde
swollen	opsvulmet
symptoms	symptomer
tainted	plettet
tamper	manipulere
tangle	virvar
tangled	sammenfiltrede
tanked	tanket
tanks	tanke
tantrum	raserianfald
tattered	forhutlet
tease	drille
tedious	kedelig
temper	temperament
temptation	fristelse
tenderness	ømhed
tense	anspændt
tension	spænding
tentative	foreløbige
tentatively	forsøgsvis
terrible	forfærdeligt
terrorize	terrorisere
thirst	tørst
thoughtless	tankeløs
threat	trussel
threatening	truende
threats	trusler
throttle	gashåndtag
thug	bandit
timid	sky
tingling	snurren
tired	træt
tiresome	trættende
tiring	trættende
toil	slid
toll	afgift
topple	vælte
torment	pine
torture	tortur
totalitarian	totalitær
touchy	nærtagende
toughness	sejhed
toxic	toksisk
trap	fælde
trapped	fanget
trash	affald
treacherous	forræderiske
treacherously	forræderisk
treachery	forræderi
treason	forræderi
trivial	trivielt
trouble	problemer
troublesome	generende
tumbled	tumlede
tumultuous	omtumlet
turmoil	oprør
twist	vride
twisted	snoet
ugly	grim
unacceptable	uacceptabel
uncaring	ufølsom
uncertain	usikker
uncivil	ucivil
unclean	urene
unclear	uklar
uncomfortable	ubehageligt
uncomfortably	ubehageligt
uncompetitive	konkurrencedygtige
uncompromising	kompromisløs
undermine	underminere
undignified	uværdige
unequal	ulige
unexpected	uventet
unfamiliar	ukendt
unfinished	ufærdige
unfit	uegnet
unforeseen	uforudset
unforgiving	nådesløs
unfortunate	uheldig
unfortunately	desværre
unfounded	ubegrundet
unfriendly	uvenlig
ungrateful	utaknemmelig
unhappily	ulykkeligt
unprepared	uforberedt
unproductive	uproduktive
unprofitable	urentable
unsavory	usmagelig
unscrupulous	skrupelløs
unseemly	usømmeligt
unsettle	skræmme
unsettled	uafviklede
untenable	uholdbar
untrue	usandt
untrustworthy	utroværdig
untruthful	usandfærdig
unusual	usædvanlig
uprising	opstand
uproar	tumult
uproot	udrydde
upset	ked
urgent	presserende
useless	ubrugelig
usurp	tilrane
usurper	tronraneren
utterly	aldeles
vagrant	vagabond
vague	vag
vagueness	vage
vainly	forgæves
vanity	forfængelighed
vehement	heftige
vehemently	heftigt
vengeance	hævn
vent	aftræk
vexation	ærgrelse
vexing	ærgerlige
vicious	ond
vile	nederdrægtig
vilify	bagvaske
villainous	skurkagtige
villains	skurke
vindictive	hævngerrig
vindictively	hævngerrigt
vindictiveness	hævngerrighed
violate	overtræder
violation	krænkelse
violent	voldsom
violently	voldsomt
viper	hugorm
volatile	flygtig
volatility	volatilitet
wack	excentriker
wallow	svælge
wanton	kåd
warning	advarsel
wary	vagt
waste	spild
wasted	spildt
wayward	egensindige
weak	svag
weaken	svække
weakening	svækkelse
weaker	svagere
weakness	svaghed
weaknesses	svagheder
wearisome	trættende
wedge	kile
weed	ukrudtsplante
weep	græde
weird	mærkelig
weirdly	anderledes
whimper	klynken
whining	klynker
wicked	ond
wickedly	ugudeligt
wickedness	ondskab
wild	vild
woe	ve
woeful	kedelige
woefully	sørgeligt
womanizer	skørtejæger
worried	bekymret
worries	bekymringer
worrisome	bekymrende
worryingly	bekymrende
worse	værre
worsen	forværre
worst	værst
worthless	værdiløs
worthlessness	værdiløshed
wounds	sår
wrangle	skændes
wrath	vrede
wreck	vrag
wrong	forkert
wrongful	uretmæssig
wrongly	fejlagtigt
wrought	smede
yawn	gabe
zealot	fanatiker
zealous	ivrig
