abound	abonder
abounds	abonde
abundance	abondance
abundant	abondant
accessable	accessible
acclaim	acclamer
acclaimed	acclamé
accommodative	accommodatif
accomodative	accommodant
accomplish	accomplir
accomplished	accompli
accomplishment	accomplissement
accomplishments	réalisations
accurate	précis
achievable	réalisable
achievement	réussite
achievements	réalisations
achievible	réalisable
acumen	perspicacité
adaptive	adaptatif
adequate	adéquat
adjustable	Ajustable
admirably	admirablement
admire	admirer
admirer	admirateur
admiring	admiratif
admiringly	admiratif
adore	adorer
adored	adoré
adorer	adorateur
adoring	adorer
adoringly	adorément
adroitly	adroitement
adulate	aduler
adulatory	adulatoire
advanced	Avancée
advantage	avantage
advantageous	avantageux
advantageously	avantageusement
advantages	avantages
adventuresome	aventureux
adventurous	aventureux
advocate	avocat
advocated	préconisé
advocates	avocats
affability	affabilité
affably	affablement
affectionate	affectueux
affinity	affinité
affirm	affirmer
affluence	richesse
afford	offrir
affordable	abordable
affordably	abordable
agilely	agilement
agility	agilité
agreeable	agréable
agreeableness	agréabilité
agreeably	agréablement
alluring	séduisant
alluringly	séduisant
altruistic	altruiste
altruistically	altruiste
amaze	étonner
amazed	étonné
amazement	stupéfaction
amazes	étonne
amazing	incroyable
amazingly	étonnamment
ambitious	ambitieux
ambitiously	ambitieusement
ameliorate	améliorer
amenable	accommodable
amenity	aménité
amiability	amabilité
amiable	aimable
amicability	amabilité
amicable	amical
amity	amitié
amply	amplement
amuse	amuser
amusing	amusant
amusingly	amusant
angel	ange
angelic	angélique
apotheosis	apothéose
appeal	charme
appealing	attirant
applaud	applaudir
appreciable	appréciable
appreciate	apprécier
appreciated	apprécié
appreciates	apprécie
appreciative	reconnaissant
appreciatively	appréciant
appropriate	approprié
approval	approbation
approve	approuver
ardently	ardemment
ardor	ardeur
articulate	articuler
aspire	aspirer
assure	assurer
assuredly	assurément
assuring	assurer
astonish	étonner
astonished	étonné
astonishing	étonnant
astonishingly	étonnamment
astonishment	étonnement
astound	étonner
astounded	étonné
astounding	étonnant
astoundingly	étonnamment
astutely	astucieusement
attentive	attentif
attractive	attrayant
attune	harmoniser
audibly	audible
authentic	authentique
autonomous	autonome
available	disponible
avid	avide
avidly	avidement
award	prix
awarded	attribué
awards	prix
awe	admiration
awed	impressionné
awesome	impressionnant
awesomely	génialement
awestruck	émerveillé
awsome	impressionnant
balanced	équilibré
beauteous	beau
beautiful	beau
beautifullly	magnifiquement
beautifully	magnifiquement
beautify	embellir
beauty	beauté
beckon	Beckeck
beckoned	attiré
beckoning	attirer
beckons	Beckons
believable	croyable
believeable	crédible
beloved	aimé
benefactor	bienfaiteur
beneficent	bienfaisant
beneficial	bénéfique
beneficially	bénéfique
beneficiary	Bénéficiaire
benefit	avantage
benefits	avantages
benevolence	bienveillance
benevolent	bienveillant
best	meilleur
better	meilleur
beutifully	Beutifully
blameless	irréprochable
bless	bénir
blessing	bénédiction
bliss	félicité
blissful	bienheureux
blithe	joyeux
blockbuster	superproduction
bloom	Floraison
blossom	fleur
bolster	traversin
bonny	beau
bonus	prime
bonuses	bonus
boost	renforcer
bountiful	généreux
brainy	intelligent
brave	courageux
bravery	bravoure
bravo	Bravo
breakthrough	percée
breakthroughs	percées
breathlessness	essoufflement
breathtaking	Stupéfiant
breeze	brise
bright	brillant
brighten	éclairer
brilliance	éclat
brilliant	brillant
brilliantly	brillamment
brisk	rapide
brotherly	fraternel
bullish	haussier
buoyant	flottable
cajole	cajoler
calm	calme
calming	calmant
calmness	calme
capability	aptitude
capably	habilement
captivate	captiver
captivating	captivant
carefree	insouciant
catchy	entraînant
celebrate	célébrer
celebrated	célèbre
celebration	fête
celebratory	célébration
champ	champion
charisma	charisme
charismatic	charismatique
charm	charme
charming	charmant
cheer	acclamation
cheery	gai
cherish	chérir
cherished	chéri
cherub	chérubin
chic	élégant
chivalrous	chevaleresque
chivalry	chevalerie
civility	civilité
civilize	civiliser
clarity	clarté
classic	classique
classy	chic
clean	nettoyer
cleaner	nettoyeur
cleanliness	propreté
cleanly	propre
clear	clair
cleared	effacé
clearly	clairement
clears	efface
clever	intelligent
cleverly	habilement
cohere	adhérer
coherent	cohérent
cohesive	cohésif
colorful	coloré
comely	belle
comfort	confort
comfortable	confortable
comfortably	confortablement
comforting	réconfortant
comfy	confortable
commend	saluer
commendable	louable
commendably	louable
commitment	engagement
commodious	spacieux
compassionate	compatissant
competitive	compétitif
complement	complément
complementary	complémentaire
complemented	complémenté
complements	compléments
compliant	conforme
complimentary	gratuit
comprehensive	complet
conciliate	concilier
conciliatory	conciliatoire
concise	concis
confidence	confiance
congenial	agréable
congratulate	féliciter
congratulation	félicitation
conscientious	consciencieux
considerate	prévenant
consistent	cohérent
consistently	régulièrement
constructive	constructif
consummate	consommé
contentment	contentement
continuity	continuité
contrasty	contrasté
convenience	commodité
convenient	pratique
conveniently	commodément
convienient	Convienient
convincing	convaincant
convincingly	convaincant
cooperative	coopérative
correctly	correctement
cost-effective	rentable
counter-attack	contre-attaque
courageous	courageux
courageously	courageusement
courageousness	courageux
courteous	courtois
courtly	courtois
covenant	engagement
cozy	confortable
creative	Créatif
credence	foi
credible	crédible
crisp	croustillant
cure	guérir
cushy	pépère
cute	mignonne
cuteness	gentillesse
daring	audacieux
darling	chéri
dashing	fringant
dauntless	intrépide
dawn	Aube
dazzle	éblouir
dazzled	ébloui
dazzling	éblouissant
dead-on	mort-sur
decency	décence
decent	décent
decisive	décisif
decisiveness	détermination
dedicated	dévoué
defeat	défaite
defeated	vaincu
defeating	défaite
defeats	défaites
defender	défenseur
deference	respect
deft	habile
deginified	déginifié
delectable	délectable
delicacy	délicatesse
delicate	délicat
delicious	délicieux
delight	délice
delighted	Enchanté
delightful	délicieux
delightfully	délicieusement
delightfulness	délice
dependable	sûr
deserving	méritant
desirable	souhaitable
desiring	désirant
desirous	désireux
destiny	destin
detachable	détachable
devout	pieux
dexterous	agile
dexterously	dextérité
dextrous	agile
dignified	digne
dignify	honorer
dignity	dignité
diligently	diligemment
diplomatic	diplomatique
distinctive	distinctif
distinguished	distingué
diversified	diversifié
divine	Divin
divinely	divinement
dominate	dominer
dominated	dominé
dominates	domine
dotingly	pointingly
dumbfounded	abasourdi
dumbfounding	stupéfaction
dynamic	dynamique
eager	désireux
eagerly	vivement
eagerness	ardeur
earnest	sérieux
earnestly	sérieusement
earnestness	sérieux
ease	facilité
eased	assoupli
eases	facilite
easiness	facilité
easing	soulager
easy	facile
ebullience	exubérance
ebullient	exubérant
ebulliently	follement
ecenomical	ecnomique
economical	économique
ecstasies	extases
ecstasy	extase
ecstatically	extatique
edify	édifier
educated	éduqué
effective	efficace
effectively	efficacement
effectiveness	efficacité
effectual	efficace
efficacious	efficace
efficient	efficace
efficiently	efficacement
effusive	expansif
effusively	effusivement
effusiveness	effusion
elate	éloge
elated	exalté
elatedly	exalté
elation	allégresse
electrify	électrifier
elegance	élégance
elegant	élégant
elegantly	élégamment
elevate	élever
elite	élite
eloquence	éloquence
eloquent	éloquent
embolden	enhardir
eminence	éminence
eminent	éminent
empathize	empathiser
empathy	empathie
empower	habiliter
empowerment	autonomisation
enchant	enchanter
enchanted	enchanté
enchanting	enchanteur
enchantingly	enchantement
encourage	encourager
encouraging	encourageant
encouragingly	encourageant
endearing	attachant
endorse	endosser
endorsed	approuvé
endorsement	approbation
endorses	endosse
endorsing	endosser
energetic	énergique
energize	dynamiser
engaging	engageant
engrossing	captivant
enhance	améliorer
enhanced	renforcée
enhancement	renforcement
enhances	améliore
enjoyable	agréable
enjoyably	agréablement
enjoyed	apprécié
enjoying	appréciant
enjoyment	jouissance
enjoys	aime
enlighten	éclairer
enlightenment	éclaircissement
enliven	animer
ennoble	ennoblir
enough	assez
enrapture	ravir
enraptured	ravi
enrich	enrichir
enrichment	enrichissement
enterprising	entreprenant
entertain	divertir
entertaining	divertissant
entertains	divertit
enthral	captiver
enthrall	captiver
enthralled	captivé
enthuse	enthousiasmer
enthusiasm	enthousiasme
enthusiast	passionné
enthusiastic	enthousiaste
entice	attirer
enticed	séduit
enticing	séduisant
enticingly	séduisant
entranced	ravi
entrancing	ravissant
entrust	confier
enviably	enviablement
envious	envieux
enviousness	envie
envy	envie
equitable	équitable
ergonomical	ergonomique
erudite	érudit
ethical	éthique
euphoria	euphorie
euphoric	euphorique
euphorically	euphoriquement
evaluative	évaluatif
evenly	uniformément
eventful	mouvementé
everlasting	éternel
evocative	évocateur
exalt	exalter
exalted	exalté
exaltedly	exalément
exalting	exaltant
exaltingly	exaltant
examplar	exemple
examplary	exemple
exceed	dépasser
exceeded	dépassé
exceeding	dépassement
exceedingly	extrêmement
exceeds	dépasse
excel	exceller
exceled	excelée
excelent	excellent
excellant	excellent
excelled	excellé
excellency	Excellence
excellently	parfaitement
excels	excelle
exceptional	exceptionnel
exceptionally	exceptionnellement
excite	exciter
excited	excité
excitedness	excitation
excitement	excitation
excites	excite
exciting	passionnant
excitingly	passionnément
exemplar	exemple
exemplary	exemplaire
exhilarate	exaltant
exhilarating	exaltant
exhilaratingly	exaltant
exhilaration	euphorie
exonerate	disculper
expansive	expansif
expeditiously	rapidement
expertly	expertement
exquisite	exquis
exquisitely	exquisement
extol	exalter
extoll	exalter
extraordinarily	extraordinairement
extraordinary	extraordinaire
exuberance	exubérance
exuberant	exubérant
exuberantly	exubérante
exult	exulter
eye-catch	accrocheur
eye-catching	accrocheur
eyecatching	attirant
fabulous	fabuleux
fabulously	fabuleusement
facilitate	faciliter
fair	juste
fairly	équitablement
fairness	justice
faith	Foi
faithful	fidèle
faithfully	fidèlement
faithfulness	fidélité
fame	célébrité
famed	célèbre
famous	célèbre
famously	fameusement
fancier	amateur
fancinating	fancy
fancy	fantaisie
fans	Ventilateurs
fantastic	fantastique
fantastically	fantastique
fascinate	fasciner
fascinating	fascinant
fascinatingly	fascinante
fast	vite
fast-paced	rapide
faultless	irréprochable
favor	favoriser
favored	favorisé
favorite	préféré
favorited	favorisé
favour	favoriser
feasible	réalisable
feasibly	faisablement
feat	exploit
fecilitous	fécond
feisty	fougueuse
felicitate	féliciter
felicitous	heureux
felicity	félicité
fervid	fervent
fervidly	fervement
fervor	ferveur
fidelity	fidélité
fiery	ardent
fine	bien
fine-looking	beau
finely	finement
flattering	flatteur
flawlessly	parfaitement
flourish	fleurir
flourishing	florissant
fluent	courant
flutter	battement
fondly	affectueusement
fondness	penchant
foolproof	infaillible
foresight	prévoyance
formidable	redoutable
fortitude	courage
fortuitous	fortuit
fortuitously	fortuitement
fortunate	chanceux
fortunately	Heureusement
fragrant	parfumé
free	gratuit
freed	libéré
freedom	liberté
freedoms	libertés
fresh	Frais
friendly	amical
frolic	gambader
fruitful	fructueux
fulfillment	accomplissement
fun	amusement
futurestic	futuriste
futuristic	futuriste
gaiety	gaieté
gaily	gaiement
gain	Gain
gained	gagné
gainful	rémunéré
gaining	gagner
gallant	galant
gallantly	galamment
geeky	geek
gem	gemme
gems	gemmes
generosity	générosité
generous	généreuse
generously	généreusement
genial	génial
genius	génie
gentle	doux
genuine	authentique
gifted	doué
gladden	réjouir
gladly	volontier
gladness	joie
glamorous	glamour
glee	joie
gleeful	joyeux
gleefully	joyeusement
glimmer	lueur
glimmering	scintillant
glisten	luire
glistening	brillant
glitter	briller
glorify	glorifier
glorious	glorieux
gloriously	glorieusement
glory	gloire
glow	lueur
glowing	embrasé
glowingly	brillamment
godlike	divin
gold	or
golden	d'or
good	bien
goodly	beau
gorgeous	magnifique
gorgeously	magnifiquement
graceful	gracieux
gracious	gracieux
graciously	gracieusement
graciousness	grâce
grand	grandiose
grateful	reconnaissant
gratified	gratifié
gratify	satisfaire
gratifying	gratifiant
gratifyingly	gratifiant
gratitude	Reconnaissance
great	génial
greatness	grandeur
grin	sourire
groundbreaking	révolutionnaire
guarantee	garantie
guidance	orientation
guiltless	innocent
gumption	jugeote
gush	jet
gusto	enthousiasme
hail	saluer
halcyon	alcyon
hale	vigoureux
hallmark	poinçonner
hallmarks	poinçons
hallowed	sanctifié
handily	facilement
handsome	Beau
handsomely	grassement
handy	pratique
happily	Heureusement
happiness	bonheur
happy	content
hard-working	travailleur
hardy	robuste
harmless	inoffensif
harmonious	harmonieux
harmoniously	harmonieusement
harmonize	harmoniser
harmony	harmonie
headway	l'avance
heal	guérir
healthful	salubre
hearten	encourager
heartening	réconfortant
heartfelt	sincère
heartily	chaleureusement
heartwarming	réconfortant
heaven	paradis
heavenly	céleste
helped	aidé
helpful	utile
helping	portion
hero	héros
heroic	héroïque
heroically	héroïquement
heroine	héroïne
heroize	héroiser
heros	héros
hilarious	hilarant
holy	saint
homage	hommage
honest	honnête
honesty	honnêteté
honor	honneur
honored	honoré
honoring	honorer
hooray	hourra
hopeful	optimiste
hospitable	hospitalier
hot	chaud
hug	étreinte
humane	humain
humility	humilité
humor	humour
humorous	humoristique
humourous	humoristique
ideal	idéal
idealize	idéaliser
ideally	idéalement
idol	idole
idolize	idolâtrer
idolized	idolâtré
idyllic	idyllique
illuminate	éclairer
illuminating	éclairant
illumine	éclairer
illustrious	illustre
imaculate	imaculer
imaginative	imaginatif
immaculate	immaculé
immaculately	parfaitement
impartiality	impartialité
impartially	impartialement
impassioned	passionné
impeccably	impeccablement
impress	impressionner
impressed	impressionné
impresses	impressionne
impressive	impressionnant
impressively	impressionnante
impressiveness	impressionner
improve	améliorer
improved	amélioré
improvement	amélioration
improves	améliore
improving	améliorer
incredible	incroyable
incredibly	incroyablement
indebted	endetté
individualized	individualisé
industrious	industrieux
inestimably	inestimable
infallibility	infaillibilité
infallible	infaillible
infallibly	infailliblement
influential	influent
ingenious	ingénieux
ingeniously	ingénieusement
ingenuity	ingéniosité
ingenuous	ingénu
ingenuously	ingénument
innocuous	inoffensif
innovative	innovant
inpressed	inpressé
insightful	perspicace
insightfully	perspicace
inspirational	inspirant
inspire	inspirer
inspiring	inspirant
instantly	immédiatement
instructive	instructif
integral	intégral
integrated	intégré
interesting	intéressant
interests	intérêts
intimacy	intimité
intimate	intime
intricate	complexe
intriguing	intrigant
intriguingly	intrigant
intuitive	intuitif
invaluable	inestimable
invaluablely	inestimable
inventive	inventif
invigorate	revigorer
invigorating	vivifiant
invincibility	invincibilité
inviolate	inviolé
invulnerable	invulnérable
irreplaceable	irremplaçable
irreproachable	irréprochable
irresistible	irrésistible
irresistibly	irrésistiblement
jaw-droping	mâchoire
jollify	jollifier
jolly	gai
joy	joie
joyful	joyeux
joyfully	joyeusement
joyous	joyeux
joyously	joyeusement
jubilant	radieux
jubilantly	jubiler
jubilate	jubiler
judicious	judicieux
justly	justement
keen	enthousiaste
keenly	vivement
keenness	finesse
kindliness	bonté
kindly	gentiment
kudos	gloire
laud	louange
laudable	louable
laudably	louable
lavish	prodiguer
lavishly	somptueusement
lawful	légitime
lawfully	légalement
lead	conduire
leads	pistes
lean	maigre
led	LED
legendary	légendaire
leverage	influence
levity	légèreté
liberate	libérer
liberation	libération
liberty	liberté
lifesaver	sauveteur
likable	sympathique
like	comme
liked	aimé
likes	aime
liking	aimer
lively	animé
logical	logique
lovable	aimable
lovably	aimablement
love	amour
loved	aimé
loveliness	beauté
lovely	charmant
lover	amoureux
loves	amours
loving	aimant
loyal	fidèle
loyalty	fidélité
lucid	lucide
lucidly	lucidement
lucky	chanceux
lucrative	lucratif
luminous	lumineux
lush	luxuriant
luster	lustre
lustrous	lustré
luxurious	luxueux
luxuriously	luxueusement
luxury	luxe
lyrical	lyrique
magical	magique
magnanimous	magnanime
magnanimously	magnanimement
magnificent	magnifique
magnificently	superbement
majestic	majestueux
majesty	majesté
manageable	maniable
maneuverable	maniable
marvel	merveille
marveled	émerveillé
marvelled	émerveillé
marvellous	merveilleux
marvelous	merveilleux
marvelously	merveilleusement
marvelousness	merveilleuse
master	maîtriser
masterful	magistral
masterfully	magistralement
masterpiece	chef-d'oeuvre
masterpieces	chefs-d'œuvre
masters	maîtrise
matchless	incomparable
maturely	mûrement
maturity	maturité
meaningful	significatif
memorable	mémorable
merciful	miséricordieux
mercifully	miséricordieusement
mercy	pitié
merit	mérite
meritorious	méritoire
merrily	joyeusement
merriment	gaieté
merriness	gaieté
merry	joyeux
mesmerize	hypnotiser
mesmerized	hypnotisé
mesmerizes	hypnotise
mesmerizing	hypnotisant
mesmerizingly	hypnotisant
meticulous	méticuleux
meticulously	méticuleusement
mightily	puissamment
mighty	puissant
mind-blowing	époustouflant
miraculous	miraculeux
miraculously	miraculeusement
miraculousness	miraculeuse
modern	moderne
modest	modeste
modesty	modestie
momentous	important
monumentally	monumentalement
morality	moralité
motivated	motivé
multi-purpose	polyvalent
neat	soigné
neatest	propre
neatly	soigneusement
nice	agréable
nicely	bien
nifty	chouette
nimble	agile
nobly	noblement
notably	notamment
noteworthy	remarquable
nourish	nourrir
nourishing	nourrissant
nourishment	nourriture
novelty	nouveauté
nurturing	nourrir
obtainable	disponible
openly	ouvertement
openness	ouverture
optimism	optimisme
optimistic	optimiste
orderly	ordonné
originality	originalité
outdo	surpasser
outdone	surpasser
outperform	surpasser
outperformed	surperformé
outperforming	surperformer
outperforms	surperforme
outshine	éclipser
outsmart	malchance
outstanding	exceptionnel
outstandingly	remarquablement
outstrip	dépasser
overtake	dépasser
overtaken	dépassé
overtakes	dépassements
overtaking	dépassement
overtook	dépassé
overture	ouverture
palatial	grandiose
pamper	dorloter
pampered	choyé
pamperedly	choyé
pamperedness	choyer
panoramic	panoramique
paradise	paradis
paramount	primordial
passionate	passionné
passionately	passionnément
patiently	patiemment
patriot	patriote
patriotic	patriotique
peace	paix
peaceable	paisible
peaceful	paisible
peacefully	pacifiquement
peach	pêche
pep	dynamisme
pepped	piqué
peppy	énergique
perfect	parfait
permissible	permis
perseverance	persévérance
persevere	persévérer
personages	personnages
personalized	personnalisé
phenomenal	phénoménal
phenomenally	phénoménalement
picturesque	pittoresque
piety	piété
pinnacle	sommet
playful	espiègle
playfully	ludique
pleasant	agréable
pleasantly	agréablement
pleased	heureux
pleasing	plaisant
pleasingly	agréablement
pleasurable	agréable
pleasurably	agréablement
pleasure	plaisir
plentiful	copieux
pluses	plus
plush	peluche
poetic	poétique
poeticize	poétiser
poise	équilibre
polished	brillant
polite	poli
politeness	politesse
popular	populaire
posh	chic
positive	positif
positively	positivement
positives	positifs
powerful	puissant
powerfully	puissamment
praise	louange
praiseworthy	louable
praising	louer
pre-eminent	prééminent
precious	précieux
precise	précis
precisely	précisément
preeminent	prééminent
prefer	préférer
preferable	préférable
prefered	préféré
preferes	préfère
preferring	préférant
prefers	préfère
prestigious	prestigieux
prettily	joliment
pretty	joli
priceless	inestimable
pride	fierté
privilege	privilège
privileged	privilégié
prize	prix
proactive	proactif
prodigious	prodigieux
prodigiously	prodigieusement
prodigy	prodige
productive	productif
productively	productivement
proficient	compétent
profound	profond
profoundly	profondément
profuse	abondant
prolific	prolifique
prominence	importance
prominent	important
promise	promettre
promised	promis
promises	promesses
promising	prometteur
promoter	promoteur
prompt	rapide
promptly	rapidement
proper	correct
properly	correctement
propitious	propice
propitiously	propice
pros	avantages
prosper	prospérer
prosperous	prospère
protect	protéger
protective	protecteur
proud	fier
proven	éprouvé
proves	prouve
providence	Providence
proving	prouver
prowess	prouesse
prudently	prudemment
punctual	ponctuel
pure	pur
purify	purifier
purposeful	déterminé
quaint	pittoresque
qualified	qualifié
qualify	qualifier
quiet	silencieux
radiance	éclat
rapid	rapide
rapt	ravi
rapture	ravissement
raptureous	ravi
rapturous	enthousiaste
rational	rationnel
reachable	accessible
readable	lisible
readily	facilement
ready	prêt
reaffirm	réaffirmer
reaffirmation	réaffirmation
realistic	réaliste
realizable	réalisable
reasonable	raisonnable
reasonably	raisonnablement
reasoned	raisonné
reassurance	réconfort
reassure	rassurer
receptive	réceptif
reclaim	récupérer
recommend	recommander
recommendation	recommandation
recommendations	recommandations
recommended	conseillé
reconcile	réconcilier
reconciliation	réconciliation
record-setting	enregistrement
recover	récupérer
recovery	récupération
rectify	rectifier
rectifying	rectifier
redeem	racheter
redeeming	racheter
redemption	rachat
refine	affiner
refined	raffiné
refinement	raffinement
reform	réforme
reformed	réformé
reforming	réformer
reforms	réformes
refresh	rafraîchir
refreshed	rafraîchi
refreshing	rafraîchissant
refund	rembourser
refunded	remboursé
regal	royal
regally	royalement
rejoice	réjouir
rejoicing	réjouissance
rejoicingly	joyeusement
rejuvenate	rajeunir
rejuvenated	rajeuni
rejuvenating	rajeunir
relaxed	détendu
reliable	fiable
reliably	fiable
relish	goût
remarkable	remarquable
remarkably	remarquablement
remedy	remède
remission	remise
remunerate	rémunérer
renaissance	Renaissance
renewed	renouvelé
renown	renommée
renowned	renommé
replaceable	remplaçable
reputable	honorable
reputation	réputation
resilient	résilient
resolute	résolu
resound	retentir
resounding	retentissant
resourceful	ingénieux
resourcefulness	ressource
respectful	respectueux
respite	répit
resplendent	resplendissant
responsibly	responsable
responsive	sensible
restful	reposant
restored	restauré
restructure	restructurer
restructured	restructuré
restructuring	restructuration
retractable	rétractable
revelation	révélation
revere	révérer
reverence	révérence
reverent	respectueux
revitalize	revitaliser
revive	relancer
revives	ravive
revolutionary	révolutionnaire
revolutionize	révolutionner
revolutionized	révolutionné
revolutionizes	révolutionne
reward	récompense
rewarding	récompense
rewardingly	gratifiant
rich	riches
richly	richement
richness	richesse
right	droite
righten	éclairer
righteous	vertueux
righteousness	droiture
rightful	légitime
rightfully	légitimement
rightly	justement
rightness	justesse
robust	robuste
romantic	romantique
romantically	romantique
romanticize	romancer
roomy	spacieux
rosy	rosé
safe	sûr
sagacity	sagacité
sagely	sagement
saint	Saint
saintliness	sainteté
saintly	saint
salutary	salutaire
salute	saluer
sane	sain
satisfactory	satisfaisant
satisfied	satisfait
satisfies	satisfait
satisfy	satisfaire
satisfying	satisfaisant
satisified	satisifié
saver	épargnant
savior	Sauveur
scenic	scénique
seasoned	chevronné
secure	garantir
securely	solidement
selective	sélectif
self-determination	autodétermination
self-satisfaction	auto-satisfaction
self-sufficiency	autosuffisance
self-sufficient	autosuffisant
sensational	sensationnel
sensationally	sensationnellement
sensibly	sensiblement
sensitive	sensible
serene	serein
serenity	sérénité
sharp	tranchant
shimmering	chatoyant
shimmeringly	scintillant
shine	éclat
shiny	brillant
significant	important
silent	silencieux
simplified	simplifié
simplifies	simplifie
simplify	simplifier
simplifying	simplifier
sincere	sincère
sincerely	Cordialement
skill	compétence
skilled	qualifié
skillful	habile
skillfully	habilement
sleek	lisse
slick	nappe
smart	intelligent
smartly	intelligemment
smile	sourire
smiling	souriant
smilingly	souriant
smitten	frappé
smooth	lisse
smoothes	lisse
smoothly	doucement
snappy	accrocheur
soft	doux
solace	réconfort
solicitous	soucieux
solid	solide
solidarity	solidarité
soothe	apaiser
soothingly	apaisant
sophisticated	sophistiqué
soulful	émouvant
soundly	profondément
soundness	solidité
spacious	spacieux
sparkle	scintillait
sparkling	pétillant
spectacular	spectaculaire
spectacularly	spectaculairement
speedily	rapidement
speedy	rapide
spellbind	fasciner
spellbinding	envoûtement
spellbindingly	envoûtant
spellbound	envoûté
spirited	fougueux
spiritual	spirituel
splendid	splendide
splendidly	magnifiquement
splendor	splendeur
spontaneous	spontané
sporty	sportif
spotless	impeccable
sprightly	vif
stabilize	stabiliser
stainless	inoxydable
standout	ressortir
stately	majestueux
statuesque	sculptural
staunch	étancher
staunchly	résolument
staunchness	fermeté
steadfast	ferme
steadfastly	résolument
steadfastness	constance
steadiness	stabilité
steady	stable
stellar	stellaire
stellarly	stellaire
stimulate	stimuler
stimulates	stimule
stimulating	stimulant
stimulative	stimulant
straighten	redresser
straightforward	simple
streamlined	rationalisé
striking	frappant
strikingly	étonnamment
striving	s'efforcer
strong	fort
stunned	étourdi
stunning	étourdissant
stunningly	étonnamment
stupendous	prodigieux
stupendously	prodigieusement
sturdy	solide
stylish	élégant
stylized	stylisé
suavely	suavement
subsidize	subventionner
subsidized	subventionné
subsidizes	subventionne
subsidizing	subventionner
substantive	substantiel
succeed	réussir
succeeded	réussi
succeeding	réussir
succeeds	réussit
success	Succès
successes	succès
successful	réussi
suffice	suffire
sufficed	suffisant
suffices	suffit
sufficient	suffisant
sufficiently	suffisamment
suitable	adapté
sumptuous	somptueux
sumptuously	somptueusement
sumptuousness	somptuosité
superb	superbe
superbly	superbement
superior	supérieur
superiority	supériorité
supple	souple
support	soutien
supporter	Supporter
supporting	justificatif
supportive	favorable
supremacy	suprématie
supreme	suprême
supremely	suprêmement
supurb	dominer
surmount	surmonter
surpass	dépasser
surreal	surréaliste
survival	survie
survivor	survivant
sustainability	durabilité
sustainable	durable
swank	esbroufe
swanky	chic
sweeping	balayage
sweet	doux
sweeten	sucrer
sweetheart	amoureux
sweetly	gentiment
sweetness	douceur
swift	rapide
swiftness	rapidité
talent	Talent
talented	talentueux
tantalize	tenter
tantalizing	alléchant
tantalizingly	alléchant
tempt	tenter
tempting	tentant
temptingly	tentant
tenacious	tenace
tenacity	ténacité
tender	soumissionner
tenderly	tendrement
terrific	terrifiant
terrifically	terriblement
thank	remercier
thankful	reconnaissant
thoughtful	réfléchi
thoughtfully	pensivement
thoughtfulness	prévenance
thrift	épargne
thrifty	économe
thrill	frisson
thrilled	ravi
thrilling	palpitant
thrillingly	passionnément
thrills	frissons
thrive	prospérer
thriving	prospère
tickle	chatouiller
tidy	rangé
time-honored	honoré
timely	opportun
tingle	picotement
titillate	titiller
titillating	titillant
titillatingly	titillant
togetherness	unité
tolerable	tolérable
toll-free	gratuit
top	Haut
top-notch	excellent
topnotch	excellent
tough	dure
tranquil	tranquille
tranquility	tranquillité
treasure	Trésor
tremendously	énormément
trendy	branché
triumph	triomphe
triumphal	triomphal
triumphant	triomphant
triumphantly	triomphalement
trivially	trivialement
trophy	trophée
trump	atout
trumpet	trompette
trust	confiance
trusting	confiant
trustworthiness	fiabilité
trusty	sûr
truthful	véridique
truthfully	sincèrement
truthfulness	véracité
ultra-crisp	ultra-croustillant
unassailable	inattaquable
unbeatable	imbattable
unbiased	impartial
unconditional	inconditionnel
undaunted	intrépide
understandable	compréhensible
undisputable	indiscutable
undisputably	indiscutablement
undisputed	incontesté
unfazed	imperturbable
unforgettable	inoubliable
unity	unité
unlimited	illimité
unmatched	incomparable
unquestionable	incontestable
unquestionably	incontestablement
unreal	irréel
unrestricted	libre
unselfish	généreux
unwavering	inébranlable
upbeat	optimiste
upgradable	évolutif
upgradeable	évolutif
upheld	confirmé
uphold	défendre
uplift	soulèvement
uplifting	édifiant
upliftingly	exaltant
upliftment	élévation
usable	utilisable
useable	utilisable
useful	utile
user-friendly	convivial
valiant	vaillant
valiantly	vaillamment
valor	valeur
variety	variété
venerate	vénérer
verifiable	vérifiable
veritable	véritable
versatile	polyvalent
versatility	versatilité
vibrantly	vibrant
victorious	victorieux
viewable	visible
virtue	vertu
virtuous	vertueux
virtuously	vertueusement
visionary	visionnaire
vivacious	vivace
vivid	vif
vouch	garant
vouchsafe	accorder
warm	chaud
warmhearted	chaleureux
warmly	chaleureusement
warmth	chaleur
wealthy	riches
welcome	Bienvenue
well	bien
well-being	bien-être
well-wishers	bien-vouloir
wellbeing	bien-être
wholesome	sain
wieldy	Wieldy
willing	prêt
willingly	volontiers
willingness	volonté
win	gagner
windfall	aubaine
winner	gagnant
winners	gagnants
winning	gagnant
wins	gagne
wisdom	sagesse
wise	sage
wisely	judicieusement
witty	spirituel
wonder	merveille
wonderful	formidable
wonderfully	merveilleusement
wonderous	merveilleux
wonderously	merveilleusement
wonders	merveilles
wondrous	merveilleux
woo	courtiser
work	travail
workable	réalisable
worked	travaillé
works	travaux
worth	vaut
worthiness	mérite
worthy	digne
wow	sensationnel
wowed	ravi
yay	Yay
youthful	jeune
zeal	zèle
zenith	zénith
zest	zeste
abnormal	anormal
abolish	abolir
abominably	abominablement
abominate	abominer
abort	avorter
aborted	avorté
aborts	abandonne
abrade	éroder
abrasive	abrasif
abrupt	brusque
abruptly	brusquement
absent-minded	distrait
absentee	absent
absurd	absurde
absurdity	absurdité
absurdly	absurdement
absurdness	absurdité
abused	abusé
abusive	injurieux
abysmal	épouvantable
abysmally	abysmalement
abyss	abîme
accidental	accidentel
accost	accoster
accursed	maudit
accuse	accuser
accuses	accuse
accusing	accuser
accusingly	accusativement
acerbate	acerbe
acerbic	acerbe
acerbically	acerbiquement
ache	mal
ached	douloureux
aches	douleurs
aching	douloureux
acrid	âcre
acrimonious	acrimonieux
acrimoniously	acrimonieusement
acrimony	acrimonie
adamant	catégorique
adamantly	catégoriquement
addict	toxicomane
addicted	intoxiqué
addicting	addictif
addicts	toxicomanes
admonish	avertir
admonisher	avertisseur
admonishingly	admonestement
admonishment	admonestation
adulterate	falsifier
adulterated	frelaté
adulteration	falsification
adulterier	adultère
adversarial	contradictoire
adversary	adversaire
adverse	négatif
adversity	adversité
afflict	affliger
afraid	peur
aggravate	aggraver
aggravating	aggravant
aggression	agression
aggressive	agressif
aggressiveness	agressivité
aggressor	agresseur
aggrieve	affliger
aggrieved	lésé
aghast	atterré
agonize	tourmenter
agonizing	angoissant
agonizingly	agonisant
agony	agonie
aground	échoué
ail	tous
ailing	malade
ailment	maladie
alarm	alarme
alarmed	alarmé
alarming	alarmant
alarmingly	alarmant
alienate	aliéner
alienated	aliéné
alienation	aliénation
allegation	allégation
allegations	allégations
allege	alléguer
allergic	allergique
allergy	allergie
aloof	distant
ambiguity	ambiguïté
ambiguous	ambigu
ambush	embuscade
amputate	amputer
anarchism	anarchisme
anarchist	anarchiste
anarchistic	anarchiste
anarchy	anarchie
anemic	anémique
anger	colère
angriness	colère
anguish	angoisse
animosity	animosité
annihilate	annihiler
annoy	ennuyer
annoyance	contrariété
annoyances	ennuis
annoyed	agacé
annoying	ennuyeux
annoyingly	agaçant
annoys	agace
anomalous	anormal
anomaly	anomalie
antagonism	antagonisme
antagonist	antagoniste
antagonistic	antagoniste
antagonize	contrarier
anti-american	anti-américain
anti-israeli	anti-israélien
anti-proliferation	anti-prolifération
anti-semites	antisémites
anti-social	antisocial
anti-us	anti-nous
anti-white	anti-blanc
antipathy	antipathie
antiquated	vieilli
antithetical	antithétique
anxieties	angoisses
anxiety	anxiété
anxious	anxieux
anxiously	anxieusement
anxiousness	anxiété
apathetic	apathique
apathetically	apathique
apathy	apathie
apocalyptic	apocalyptique
apologist	apologiste
apologists	apologistes
appal	épouvanter
appall	épouvanter
appalled	consterné
appalling	épouvantable
appallingly	épouvantablement
apprehension	appréhension
apprehensions	appréhensions
apprehensive	inquiet
apprehensively	appréhensivement
arbitrary	arbitraire
arcane	ésotérique
archaic	archaïque
arduous	difficile
arduously	laborieusement
argumentative	argumentatif
ashamed	honteux
asinine	idiot
asininely	Asinely
asinininity	asinininité
askance	désinvolture
asperse	asperser
assail	assaillir
assassinate	assassiner
assault	agression
assult	assaillir
astray	égaré
atrocious	atroce
atrocities	atrocités
atrocity	atrocité
atrophy	atrophie
attack	attaque
attacks	attaques
audacious	audacieux
audaciously	audacieusement
audaciousness	audace
audacity	audace
audiciously	audicieusement
austere	austère
authoritarian	autoritaire
autocrat	autocrate
autocratic	autocratique
avaricious	avare
avariciously	avaricieusement
avenge	venger
aweful	épouvantable
awful	terrible
awfully	terriblement
awfulness	horreur
awkward	gênant
awkwardness	maladresse
ax	hache
babble	babiller
back-logged	rétro-connecté
backbite	médire
backbiting	médisance
backwardness	arriération
bad	mal
badly	mal
baffled	déconcerté
baffling	déconcertant
bait	appât
balk	rechigner
banalize	banaliser
bane	fléau
banish	bannir
banishment	bannissement
bankrupt	faillite
barbarian	barbare
barbaric	barbare
barbarically	barbare
barbarity	barbarie
barbarous	barbare
barbarously	barbare
barren	stérile
bash	frapper
bashed	défoncé
bashful	timide
bashing	dénigrer
bastard	Connard
bastards	bâtards
battered	battu
battering	coups
bearish	baissier
beastly	bestial
bedlam	chahut
bedlamite	fou
befoul	souiller
beg	mendier
beggar	mendiant
beggarly	misérable
begging	mendicité
beguile	séduire
belabor	invectiver
belated	tardif
beleaguer	assiégeant
belie	démentir
belittle	rabaisser
belittled	rabaissé
belittling	dénigrer
bellicose	belliqueux
belligerence	belligérance
belligerent	belligérant
belligerently	belligérante
bemoan	déplorer
bemoaning	déplorer
bemused	abasourdi
bent	courbé
berate	admonester
bereave	priver
bereavement	deuil
bereft	privé
beseech	supplier
beset	assaillir
besiege	assiéger
besmirch	ternir
betray	trahir
betrayal	trahison
betrayals	trahisons
betrayer	traître
betraying	traître
betrays	trahit
bewilder	déconcerter
bewildered	égaré
bewildering	déroutant
bewilderingly	déroutant
bewilderment	perplexité
bewitch	ensorceler
bias	biais
biased	biaisé
biases	biais
bickering	chamaillerie
bigotries	bigoterie
bigotry	bigoterie
bitch	chienne
bitchy	vache
biting	mordant
bitingly	mordant
bitter	amer
bitterly	amèrement
bitterness	amertume
blab	jaser
blackmail	chantage
blah	blabla
blameworthy	blâmable
bland	fade
blandish	flatter
blaspheme	blasphémer
blasphemous	blasphématoire
blasphemy	blasphème
blasted	foudroyé
blatant	flagrant
blatantly	ouvertement
blather	bêtises
bleak	morne
bleakly	morne
bleakness	tristesse
bleed	saigner
bleeding	saignement
bleeds	saigne
blemish	défaut
blind	aveugle
blinding	aveuglant
blindingly	aveuglant
blindside	aveugle
blister	cloque
blistering	cloques
bloated	gonflé
blockage	obstruction
blockhead	imbécile
bloodthirsty	sanguinaire
bloody	sanglant
blotchy	taché
blow	coup
blunder	gaffe
blundering	maladroit
blunders	gaffes
blunt	émousser
blur	brouiller
blurred	flou
blurring	flou
blurry	flou
blurs	brouille
blurt	lâcher
boastful	vantard
bogus	faux
boil	ébullition
boiling	ébullition
boisterous	bruyant
bomb	bombe
bombard	bombarder
bombardment	bombardement
bombastic	grandiloquent
bondage	esclavage
bore	ennuyer
bored	ennuyé
boredom	ennui
bores	alésages
boring	ennuyeuse
botch	bousiller
bother	déranger
bothered	dérangé
bothering	déranger
bothers	tracassiers
bothersome	ennuyeux
bowdlerize	expurger
boycott	boycotter
braggart	fanfaron
brash	impétueux
brashly	effrontément
brashness	impétuosité
brat	gosse
bravado	bravade
brazen	effronté
brazenly	effrontément
breach	violation
break	Pause
break-up	rompre
break-ups	ruptures
breakdown	panne
breaking	rupture
breaks	pauses
breakup	rompre
breakups	ruptures
bribery	corruption
brimstone	soufre
bristle	poil
brittle	fragile
broke	cassé
broken	cassé
brood	nichée
browbeat	intimider
bruise	bleu
bruised	meurtri
bruises	ecchymoses
bruising	ecchymoses
brutalising	brutaliser
brutalities	brutalités
brutality	brutalité
brutalize	brutaliser
brutalizing	brutaliser
brutally	brutalement
brutish	brutal
buckle	Boucle
bug	punaise
bugging	écoutes
bugs	bogues
bulkiness	encombrement
bulky	volumineux
bulkyness	encombrement
bull****	taureau****
bull----	taureau----
bullies	intimidateurs
bullshit	connerie
bully	brute
bullying	harcèlement
bullyingly	intimidant
bum	clochard
bump	bosse
bumped	heurté
bumpping	bumper
bumps	bosses
bumpy	cahoteux
bungler	bousilleur
bungling	maladresse
bunk	couchette
burden	charge
burdensome	pénible
burdensomely	lourdement
burn	brûler
burned	brûlé
burning	brûlant
burns	brûle
bust	buste
busts	bustes
butcher	Boucher
butchery	boucherie
buzzing	bourdonnant
byzantine	byzantin
cackle	caqueter
calamities	calamités
calamitous	calamiteux
calamitously	calamiteusement
calamity	calamité
callous	insensible
calumniate	calomnier
calumniation	calomnie
calumnies	calomnies
calumnious	calomnieux
calumniously	calomnieusement
calumny	calomnie
cancerous	cancéreux
cannibal	cannibale
cannibalize	cannibaliser
capitulate	capituler
capricious	capricieux
capriciously	capricieusement
capriciousness	caprice
capsize	chavirer
careless	négligent
carelessness	négligence
carp	carpe
cartoonish	cartoon
castigate	fustiger
castrated	castré
casualty	victime
cataclysm	cataclysme
cataclysmal	cataclysmique
cataclysmic	cataclysmique
cataclysmically	cataclysmiquement
catastrophic	catastrophique
catastrophically	catastrophiquement
catastrophies	catastrophes
caustic	caustique
caustically	caustique
censure	censurer
chafe	irriter
chaff	balle
chagrin	dépit
challenging	difficile
chaotic	chaotique
chasten	châtier
chastise	punir
chastisement	châtiment
chatter	bavarder
chatterbox	bavard
cheat	Tricher
cheated	triché
cheater	tricheur
cheerless	triste
cheesy	ringard
chide	gronder
childish	puéril
chill	refroidissement
chilly	froid
choke	étranglement
choleric	colérique
choppy	saccadé
chore	corvée
chronic	chronique
chunky	trapu
clamor	clameur
clamorous	bruyant
clash	choc
cliche	cliché
cliched	cliché
clog	sabot
clogged	bouché
clogs	sabots
cloud	nuage
clouding	obscurcissant
cloudy	nuageux
clumsy	maladroit
coarse	grossier
cocky	arrogant
coerce	contraindre
coercion	coercition
coercive	coercitif
coldly	froidement
collapse	effondrer
collude	comploter
collusion	connivence
combative	combatif
combust	brûler
comical	comique
commiserate	commettre
commonplace	banal
commotion	agitation
complacent	complaisant
complaint	plainte
complaints	plaintes
complex	complexe
complicated	compliqué
complicit	complice
compulsive	compulsif
concede	concéder
conceded	concédé
conceit	vanité
conceited	vaniteux
concens	concen
concern	préoccupation
concerned	concerné
concerns	préoccupations
concession	Concession
condemn	condamner
condemnable	condamnable
condemnation	condamnation
condemned	condamné
condemns	condamne
condescend	condescendre
condescending	condescendant
condescension	condescendance
confess	avouer
confessions	aveux
confined	confiné
conflict	conflit
conflicting	contradictoire
conflicts	conflits
confound	confondre
confounded	confondu
confounding	confondant
confront	affronter
confrontation	affrontement
confrontational	conflictuel
confuse	embrouiller
confused	confus
confuses	confond
confusing	déroutant
congested	congestionné
conservative	conservateur
conspicuous	visible
conspicuously	ostensiblement
conspiracies	conspirations
conspiracy	conspiration
conspirator	conspirateur
conspiratorial	conspirateur
conspire	conspirer
contagious	contagieux
contaminate	contaminer
contaminated	contaminés
contaminates	contamine
contaminating	contaminer
contempt	mépris
contemptible	méprisable
contemptuous	méprisant
contend	combattre
contentious	contentieux
contort	tordre
contortions	contorsions
contradict	contredire
contradictory	contradictoire
contrariness	contradiction
contravene	contrevenir
contrive	contrarier
contrived	artificiel
controversial	controversé
controversy	controverse
convoluted	convoluté
corrode	corroder
corrosive	corrosif
corrupt	corrompu
corrupted	corrompu
corrupting	corrompant
corrupts	corrompt
corruptted	corrompu
costly	cher
counter-productive	contreproductif
counterproductive	contreproductif
covetous	avide
coward	lâche
cowardly	lâche
crack	fissure
cracked	fissuré
cracks	fissures
craftily	astucieusement
craftly	artisanalement
crafty	rusé
cramp	crampe
cramping	crampes
cranky	excentrique
crap	merde
crappy	merdique
crashed	écrasé
crashing	s'écraser
crass	grossier
craven	lâche
cravenly	craignant
craze	engouement
crazily	follement
craziness	folie
crazy	fou
creak	craquer
creaking	grincement
creaks	craquements
credulous	crédule
creeping	rampant
creepy	terrifiant
crept	rampant
criminal	criminel
cringe	reculer
cringed	recroquevillé
cringes	grincements
cripple	paralyser
crippled	estropié
cripples	estropiés
crippling	paralysant
crisis	crise
critic	critique
critical	critique
criticism	critique
criticize	critiquer
criticized	critiqué
criticizing	critiquer
critics	critiques
cronyism	copinage
crook	escroc
crooked	courbé
crooks	escrocs
crowded	bondé
crowdedness	entassement
crude	brut
cruelly	cruellement
cruelness	cruauté
cruelties	cruautés
cruelty	cruauté
crumble	émietter
crumbling	effritement
crumple	froisser
crumpled	froissé
crumples	froisser
crush	écraser
crushed	écrasé
crushing	écrasement
cry	cri
culpable	coupable
culprit	coupable
cumbersome	lourd
cunt	chatte
cunts	chattes
curse	malédiction
cursed	maudit
curses	malédictions
curt	sec
cuss	jurer
cussed	juré
cynical	cynique
cynicism	cynisme
damage	dommage
damaged	endommagé
damages	dégâts
damaging	dommageable
damn	Zut
damnably	rudement
damned	damné
damning	accablant
damper	amortisseur
dangerous	dangereux
dangerousness	dangerosité
dark	foncé
darken	assombrir
darkened	sombre
darkness	obscurité
dastard	lâche
dastardly	lâche
daunt	décourager
daunting	intimidant
dauntingly	intimidant
dawdle	lambiner
daze	hébéter
dazed	étourdi
dead	mort
deadlock	impasse
deadly	mortel
deaf	sourd
dearth	disette
death	décès
debacle	débâcle
debase	avilir
debasement	avilissement
debatable	discutable
debauch	débaucher
debaucher	débaucher
debauchery	débauche
debilitate	débiliter
debilitating	débilitant
debility	débilité
debt	dette
debts	dettes
decadence	décadence
decadent	décadent
decay	pourriture
decayed	pourri
deceit	tromperie
deceitful	trompeur
deceitfully	trompeusement
deceitfulness	fausseté
deceive	tromper
deceiver	trompeur
deceivers	trompeurs
deceiving	tromper
deception	tromperie
deceptive	trompeur
deceptively	trompeusement
declaim	déclamer
decline	déclin
declines	décline
declining	déclinant
decrement	décrémenter
decrepit	délabré
decrepitude	décrépitude
decry	décrier
defamation	diffamation
defamations	diffamations
defamatory	diffamatoire
defame	diffamer
defect	défaut
defective	défectueux
defects	défauts
defensive	défensive
defiance	défi
deficiencies	déficiences
deficiency	carence
deficient	déficient
defile	défilé
defiler	défiler
deform	déformer
deformed	déformé
defrauding	frauder
defunct	défunt
defy	defier
degenerate	dégénérer
degenerately	dégénéré
degeneration	dégénérescence
degradation	dégradation
degrade	dégrader
degrading	dégradant
degradingly	dégradant
dehumanization	déshumanisation
dehumanize	déshumaniser
deign	daigner
dejected	abattu
dejectedly	découragé
dejection	abattement
delay	retard
delayed	différé
delaying	dilatoire
delays	retards
delinquency	délinquance
delinquent	délinquant
delirious	délirant
delirium	délire
delude	tromper
deluded	trompé
deluge	inonder
delusion	illusion
delusional	délirant
delusions	délires
demean	dévier
demeaning	avilissant
demise	disparition
demolish	démolir
demolisher	démolisseur
demon	démon
demonic	démoniaque
demonize	diaboliser
demonized	diabolisé
demonizes	diabolise
demonizing	diabolisant
demoralize	démoraliser
demoralizing	démoralisant
demoralizingly	démoralisant
denied	refusé
denies	nie
denigrate	dénigrer
denounce	dénoncer
dent	bosse
dented	bosselé
denunciate	dénoncer
denunciation	dénonciation
denunciations	dénonciations
deny	Nier
denying	nier
deplete	épuiser
deplorable	déplorable
deplorably	déplorablement
deplore	déplorer
deploring	déplorer
deploringly	déplorant
deprave	corrompre
depraved	dépravé
depravedly	dépravé
deprecate	désapprouver
depress	déprimer
depressed	déprimé
depressing	déprimant
depressingly	déprimant
depression	dépression
depressions	dépressions
deprive	priver
deprived	privé
deride	railler
derision	dérision
derisive	dérisoire
derisively	dérisoire
derisiveness	dérision
derogatory	dérogatoire
desecrate	profaner
desert	désert
desertion	désertion
desiccate	dessécher
desiccated	desséchée
desititute	désitérer
desolate	désolé
desolately	désolé
desolation	désolation
despair	désespoir
despairing	désespéré
despairingly	désespérément
desperate	désespéré
desperately	désespérément
desperation	désespoir
despicable	méprisable
despicably	méprisable
despise	mépriser
despised	méprisé
despoil	spolier
despoiler	spoliateur
despondence	découragement
despondency	abattement
despondent	découragé
despondently	découragé
despot	despote
despotic	despotique
despotism	despotisme
destabilisation	déstabilisation
destitute	dépourvu
destitution	misère
destroy	détruire
destroyer	destructeur
destructive	destructeur
desultory	décousu
deter	dissuader
deteriorate	détériorer
deterioration	détérioration
deterrent	dissuasif
detest	détester
detestable	détestable
detestably	détestablement
detested	détesté
detesting	détestant
detests	déteste
detract	diminuer
detracted	détruit
detracting	nuire
detraction	détraction
detracts	détruit
detriment	détriment
detrimental	préjudiciable
devastate	dévaster
devastated	dévasté
devastates	ravage
devastating	dévastateur
devastatingly	dévastateur
devastation	dévastation
deviate	dévier
deviation	déviation
devil	diable
devilish	diabolique
devilishly	diaboliquement
devilment	diablerie
devilry	diable
devious	sournois
deviously	sournoisement
deviousness	détournement
devoid	dépourvu
diabolic	diabolique
diabolical	diabolique
diabolically	diaboliquement
diametrically	diamétralement
diappointed	diappoint
dick	queue
dictator	dictateur
die	mourir
die-hard	mordant
died	décédés
dies	meurt
difficult	difficile
difficulty	difficulté
diffidence	hésitation
dilapidated	délabré
dilemma	dilemme
dim	faible
dimmer	variateur
din	vacarme
dinky	mignon
dire	terrible
direly	mordant
dirt	saleté
dirty	sale
disable	désactiver
disabled	désactivée
disaccord	désaccord
disadvantage	désavantage
disadvantaged	défavorisé
disadvantageous	désavantageux
disadvantages	désavantages
disaffect	mécontenter
disaffected	mécontent
disaffirm	désaffirmer
disagreeable	désagréable
disagreeably	désagréablement
disagreement	désaccord
disagrees	désapprouve
disallow	refuser
disapointed	déçu
disapointing	décevant
disapointment	déception
disappoint	décevoir
disappointed	désappointé
disappointing	décevant
disappointingly	décevant
disappointment	déception
disappointments	déceptions
disappoints	déçoit
disapprobation	désapprobation
disapproval	désapprobation
disapprove	désapprouver
disapproving	désapprobateur
disarm	désarmer
disarray	désarroi
disaster	catastrophe
disasterous	désastreux
disastrous	catastrophique
disastrously	désastreusement
disavow	désavouer
disavowal	désaveu
disbelief	incrédulité
disbeliever	incrédule
disclaim	désavouer
discombobulate	discombobuler
discomfit	déconcerter
discomfititure	déconfiture
discomfort	malaise
discompose	déranger
disconcert	déconcerter
disconcerted	déconcerté
disconcerting	déroutant
disconcertingly	déconcertant
disconsolate	inconsolable
disconsolation	déconsolation
discontent	mécontentement
discontented	mécontent
discontentedly	mécontentement
discontinued	abandonné
discontinuity	discontinuité
discontinuous	discontinu
discord	discorde
discordance	désaccord
discountenance	opposer
discourage	décourager
discouragement	découragement
discouraging	décourageant
discouragingly	décourageant
discourteous	discourtois
discourteously	discoureusement
discoutinous	discutable
discredit	discrédit
discrepant	discordant
discriminate	discriminer
discriminatory	discriminatoire
disdain	mépris
disdained	dédaigné
disdainful	dédaigneux
disdainfully	dédaigneusement
disfavor	désavouer
disgrace	disgrâce
disgraced	disgracié
disgraceful	honteux
disgracefully	honteusement
disgruntle	contrarier
disgruntled	mécontent
disgust	dégoûter
disgusted	dégoûté
disgustedly	dégoûté
disgustful	dégoûtant
disgustfully	dégoûté
disgusting	répugnant
disgustingly	dégoûtant
dishearten	décourager
disheartening	décourageant
dishearteningly	décourageant
dishonest	malhonnête
dishonestly	malhonnêtement
dishonesty	malhonnêteté
dishonor	déshonorer
dishonorable	déshonorant
dishonorablely	déshonneur
disillusion	désillusion
disillusioned	désabusé
disillusionment	désillusion
disillusions	désillusions
disinclination	désinvolture
disingenuous	fourbe
disingenuously	hypocritement
disintegrate	désintégrer
disintegrated	désintégré
disintegration	désintégration
disinterest	désintéressement
disinterested	désintéressé
dislocated	disloquée
disloyal	déloyal
disloyalty	déloyauté
dismal	lugubre
dismally	lamentablement
dismalness	lamentation
dismay	consternation
dismayed	consterné
dismaying	consternant
dismayingly	effroyablement
dismissive	dédaigneux
dismissively	dédaigneusement
disobedience	désobéissance
disobedient	désobéissant
disobey	désobéir
disoobedient	désoobéissant
disorder	désordre
disordered	désordonné
disorderly	désordonné
disorganized	désorganisé
disorient	désorienter
disoriented	désorienté
disown	renier
disparage	dénigrer
disparaging	désobligeant
disparagingly	méprisante
dispirit	décourager
dispirited	découragé
dispiritedly	découragé
dispiriting	décourageant
displace	déplacer
displaced	déplacé
displease	mécontenter
displeased	mécontent
displeasing	déplaisant
displeasure	mécontentement
disproportionate	disproportionné
disprove	réfuter
disputable	contestable
dispute	contestation
disputed	contesté
disquiet	inquiétude
disquieting	inquiétant
disquietingly	inquiétant
disquietude	inquiétude
disregard	mépris
disregardful	indifférent
disrepute	déconsidération
disrespectable	irrespectable
disrespectful	irrespectueux
disrespectfully	irrespectueusement
disrupt	perturber
disruption	perturbation
disruptive	perturbateur
dissapointed	déçu
dissappointed	déçu
dissappointing	décevant
dissatisfaction	insatisfaction
dissatisfactory	insatisfaisant
dissatisfied	mécontent
dissatisfies	mécontents
dissatisfy	mécontenter
dissatisfying	insatisfaisant
dissemble	dissimuler
dissembler	dissimulateur
dissent	contestation
dissenter	dissident
dissolute	dissolu
dissonantly	dissonant
dissuade	dissuader
dissuasive	dissuasif
distaste	dégoût
distasteful	désagréable
distastefully	désagréablement
distort	fausser
distorted	déformé
distortion	Distorsion
distorts	déforme
distract	distraire
distracting	distraire
distraught	éperdu
distraughtly	désespérément
distraughtness	détresse
distress	détresse
distressed	affligé
distressing	pénible
distressingly	douloureusement
distrust	méfiance
distrustful	méfiant
distrusting	méfiant
disturb	déranger
disturbance	perturbation
disturbed	perturbé
disturbing	inquiétant
disturbingly	dérangeant
disunity	désunion
divisive	diviser
divisively	divisivement
divisiveness	division
dizzing	vertigineux
dizzingly	vertigineusement
dizzy	étourdi
doddering	dodder
dodgey	Dodgey
dogged	obstiné
doggedly	obstinément
dogmatic	dogmatique
domineering	dominateur
donside	Dégide
doom	condamner
doomed	condamné
doubt	doute
doubtful	douteux
doubtfully	douteusement
downcast	abattu
downfall	chute
downfallen	tombé
downgrade	rétrograder
downhearted	découragé
downheartedly	sincèrement
downside	inconvénient
downturn	ralentissement
downturns	ralentissements
drab	terne
draconian	draconien
draconic	draconique
drag	traîne
dragged	traîné
dragging	glisser
dragoon	dragon
drain	drainer
drained	drainé
draining	évacuation
drastic	radical
drastically	drastiquement
drawback	inconvénient
drawbacks	désavantages
dread	crainte
dreadful	horrible
dreadfully	terriblement
dreadfulness	horreur
dreary	morne
dripped	égoutté
dripping	égouttage
drips	gouttes
droop	affaissement
droops	affaissements
drop-out	abandonner
drop-outs	abandons
dropout	abandonner
dropouts	décrocheurs
drought	sécheresse
drowning	noyade
drunk	ivre
drunkard	ivrogne
drunken	ivre
dubious	douteux
dubiously	douteusement
dud	raté
dull	terne
dullard	lourdaud
dumb	stupide
dumbfound	abasourdir
dump	déverser
dumped	déversé
dumps	décharges
dunce	cancre
dungeon	cachot
dungeons	donjons
dust	poussière
dusty	poussiéreux
dwindling	diminuer
earsplitting	époustouflant
eccentric	excentrique
eccentricity	excentricité
effigy	effigie
effrontery	effronterie
egocentric	égocentrique
egomania	manie
egotism	égotisme
egotistical	égoïste
egotistically	égoïstement
egregious	énorme
egregiously	énormément
election-rigger	élection-gréeur
elimination	élimination
emaciated	émacié
emasculate	émasculer
embarrass	embarrasser
embarrassing	gênant
embarrassingly	embarrassant
embarrassment	embarras
embattled	assiégé
embroiled	impliqué
embroilment	implication
emergency	urgence
emphatic	catégorique
emphatically	énergiquement
emptiness	vide
encroach	empiéter
encroachment	empiètement
enemies	ennemis
enemy	ennemi
enervate	amollir
enfeeble	faible
engulf	engloutir
enjoin	enjoindre
enmity	hostilité
enraged	furieux
enraging	enrageant
enslave	asservir
entangle	emmêler
entanglement	enchevêtrement
entrapment	piégeage
envious	envieux
enviousness	envie
epidemic	épidémie
equivocal	équivoque
erase	effacer
erode	éroder
erodes	érode
erosion	érosion
erratic	erratique
erratically	erratique
erroneous	erroné
error	Erreur
eruptions	éruptions
eschew	éviter
estranged	séparé
evade	éluder
evasion	évasion
evasive	évasif
evil	mal
evildoer	scélérat
evils	maux
eviscerate	éviscérer
exacerbate	exacerber
exagerate	exagérer
exagerated	exagéré
exagerates	exagère
exaggerate	exagérer
exaggeration	exagération
exasperate	exaspérer
exasperated	exaspéré
exasperating	exaspérant
exasperatingly	exaspérément
exasperation	exaspération
excessive	excessif
excessively	excessivement
excoriate	excorier
excruciating	atroce
excruciatingly	atrocement
execrate	exécrer
exhaust	échappement
exhausted	épuisé
exhaustion	épuisement
exhausts	échappements
exhort	exhorter
exile	exilé
exorbitantance	exorbitance
exorbitantly	exorbitant
expel	expulser
expensive	coûteux
expire	expirer
expired	expiré
explode	exploser
explosive	explosif
expropriate	exproprier
expunge	effacer
exterminate	exterminer
extinguish	éteindre
extort	extorquer
extortion	extorsion
extraneous	étranger
extravagantly	extravagante
extremism	extrémisme
extremist	extrémiste
extremists	extrémistes
eyesore	horreur
fabricate	fabriquer
facetious	facétieux
facetiously	facétieusement
fail	échouer
failed	échoué
failing	échouer
fails	échoue
failure	échec
fainthearted	pusillanime
faithless	déloyal
fake	faux
fall	tomber
fallacies	sophismes
fallacious	fallacieux
fallaciously	fallacieusement
fallaciousness	fausseté
fallacy	erreur
fallen	déchu
falling	chute
fallout	Tomber
falls	chutes
false	faux
falsehood	mensonge
falsely	faussement
falsify	falsifier
falter	vaciller
faltered	hésité
famished	affamé
fanatic	fanatique
fanatical	fanatique
fanatically	fanatiquement
fanaticism	fanatisme
fanatics	fanatiques
fanciful	fantaisiste
far-fetched	farfelu
farcical	grotesque
farcical-yet-provocative	farcis-et-provocateur
farcically	farcicalement
farfetched	farfelu
fascism	fascisme
fascist	fasciste
fastidious	délicat
fastidiously	méticuleusement
fastuous	rapide
fat	graisse
fatalistic	fataliste
fatalistically	fatalement
fatally	mortellement
fateful	fatidique
fatefully	fatidique
fathomless	insondable
fatigued	fatigué
fatty	gras
fatuity	fatuité
fatuous	stupide
fatuously	sottement
fault	faute
faults	défauts
faulty	défectueux
fawningly	faussement
faze	déconcerter
fear	peur
fearful	craintif
fearfully	craintivement
fears	craintes
fearsome	redoutable
feckless	incapable
feeble	faible
feeblely	faiblement
feign	feindre
feint	feinte
felon	criminel
felonious	criminel
ferociously	férocement
ferocity	férocité
fetid	fétide
fever	fièvre
feverish	fébrile
fevers	fièvres
fib	mensonge
fibber	menteur
fickle	inconstant
fictional	fictif
fictitious	fictif
fidget	remuer
fidgety	agité
fiend	démon
fiendish	diabolique
fierce	féroce
filth	saleté
filthy	crasseux
finicky	pointilleux
fist	poing
flabbergast	époustoufler
flabbergasted	sidéré
flagging	signaler
flagrantly	flagrant
flake	flocon
flaking	s'écailler
flaky	floconneux
flare	éclater
flaw	défaut
flawed	défectueux
flaws	défauts
flee	fuir
fleed	s'enfuit
fleeing	fuite
fleer	méprise
flees	fuit
fleeting	fugace
flicering	Flicering
flicker	vaciller
flickering	vacillant
flickers	scintille
flighty	volage
flimsy	fragile
flirt	flirter
flirty	coquin
floored	étage
flounder	patauger
floundering	patauger
flout	flouté
fluster	troubler
foe	ennemi
fool	imbécile
fooled	trompé
foolhardy	téméraire
foolish	insensé
foolishly	bêtement
forbid	interdire
forbidden	interdit
forbidding	interdiction
forceful	énergique
foreboding	pressentiment
forebodingly	présomptueux
forged	forgé
forgetful	oublieux
forgetfully	oublie
forgetfulness	oubli
forlorn	désespéré
forlornly	désespérément
forsake	abandonner
forsaken	abandonné
forswear	renoncer
foul	faute
foully	méchamment
foulness	méchanceté
fractious	hargneux
fragmented	fragmenté
frail	frêle
frantic	frénétique
frantically	frénétiquement
franticly	frénétiquement
fraud	fraude
fraudulent	frauduleux
fraught	chargé
frazzle	crever
frazzled	fatigué
freak	Freak
freaking	flipper
freakish	bizarre
freakishly	bizarrement
freaks	monstres
freeze	gel
freezing	gel
frenetic	frénétique
frenetically	frénétiquement
frenzied	frénétique
frenzy	frénésie
fret	frette
fretful	agité
frets	frettes
fried	frit
frigging	branler
frighten	effrayer
frightening	effrayant
frighteningly	effrayant
frightful	affreux
frightfully	affreusement
frigid	froid
frost	gel
froze	gelé
frozen	congelé
fruitless	infructueux
frustrate	frustrer
frustrated	frustré
frustrates	frustre
frustrating	frustrant
frustratingly	frustrant
fuck	Merde
fudge	truquer
fugitive	fugitif
full-blown	épanoui
fulminate	fulminer
fumble	tâtonner
fume	fumée
fumes	vapeurs
fundamentalism	fondamentalisme
funky	froussard
funnily	drôlement
funny	drôle
furious	furieux
furiously	furieusement
furor	scandale
fury	fureur
fuss	agitation
fussy	difficile
fustigate	fustiger
futilely	futilement
futility	futilité
fuzzy	flou
gabble	baragouiner
gaff	gaffe
gainsay	contredire
gainsayer	acquéreur
gall	fiel
galling	exaspérant
galls	galles
gangster	bandit
gape	bâiller
garish	criard
gasp	haleter
gaudy	voyant
gawky	gauche
geezer	type
genocide	génocide
ghastly	horrible
ghosting	fantôme
gibberish	charabia
gibe	moquerie
giddy	étourdi
gimmick	truc
gimmicking	gimmick
glare	éblouissement
glib	désinvolte
glibly	facilement
glitch	pépin
glitches	pépins
gloatingly	jubilatoire
gloom	obscurité
gloomy	sombre
glum	maussade
glut	surabondance
gnawing	rongeur
goad	aiguillon
goading	incitation
goon	continue
gossip	potins
graft	greffer
grainy	granuleux
grapple	grappin
grate	grille
grating	grille
gravely	gravement
greasy	graisseux
greed	avidité
greedy	glouton
grief	douleur
grievance	grief
grievances	griefs
grieving	attrister
grievous	grave
grievously	gravement
grim	sinistre
grind	moudre
gripes	coliques
grisly	macabre
gritty	graveleux
gross	brut
grossly	grossièrement
grouch	râleur
grouchy	grognon
growl	grognement
grudge	rancune
grudges	rancunes
gruesome	horrible
gruesomely	horriblement
gruff	bourru
grumble	plaindre
grumpier	grincheux
grumpiest	grincheux
grumpily	grincheux
grumpish	grincheux
grumpy	grincheux
guile	ruse
guilt	culpabilité
guiltily	coupable
guilty	coupable
gullible	crédule
gutter	gouttière
hack	pirater
haggard	hâve
haggle	marchander
halfheartedly	demi-cœur
hallucinate	halluciner
hamper	entraver
hampered	gêné
handicapped	handicapé
hang	pendre
hangs	bloque
hapless	malchanceux
harass	harceler
harassed	harcelé
harassment	harcèlement
harboring	héberger
hard	difficile
hard-liner	intransigeant
harden	durcir
hardened	endurci
hardheaded	têtu
hardliner	intransigeant
hardliners	Hardliners
hardship	épreuves
hardships	difficultés
harm	nuire
harmed	blessé
harmful	nocif
harms	nuit
harpy	harpie
harridan	Harridan
harried	harcelé
harrow	herse
harsh	dur
harshly	durement
hassle	tracas
hassled	harcelé
hassles	tracas
haste	hâte
hastily	hâtivement
hasty	précipité
hate	haine
hated	détesté
hateful	odieux
hatefully	haineusement
hatefulness	haine
hater	haineux
haters	ennemis
hates	déteste
hating	haïr
hatred	haine
haughtily	hautainement
haughty	hautain
haunt	hanter
haunting	hanté
havoc	ravage
hawkish	belliqueux
haywire	détraqué
hazard	danger
hazardous	dangereux
haze	brume
hazy	brumeux
heartbreaking	déchirant
heartbreakingly	déchirant
heathen	païen
heavy-handed	lourdement
heck	Zut
heckle	interrompre
heckled	chahuté
heckles	chahuteurs
hectic	trépidant
hedge	haie
hedonistic	hédonistique
heedless	inattentif
hefty	lourd
hegemonism	hégémonisme
hegemonistic	hégémoniste
hegemony	hégémonie
heinous	odieux
hell	enfer
hells	enfers
helplessly	impuissant
helplessness	impuissance
heresy	hérésie
heretic	hérétique
heretical	hérétique
hesitant	hésitant
hestitant	Hestitant
hideous	hideux
hideously	hideusement
hideousness	hideur
hiliarious	hilarant
hinder	empêcher
hindrance	obstacle
hiss	sifflement
hissed	sifflé
hissing	sifflant
hoard	magot
hoax	canular
hobble	entraver
hogs	porcs
hollow	creux
hoodwink	frauder
hopeless	désespéré
hopelessly	désespérément
hopelessness	désespoir
horrendous	horrible
horrendously	horriblement
horrid	affreux
horrific	horrible
horrified	horrifié
horrifies	horreurs
horrify	horrifier
horrifying	effroyable
hostage	otage
hostilities	hostilités
hostility	hostilité
hothead	exalté
hotheaded	impétueux
hothouse	serre
huckster	colporteur
hum	fredonner
humid	humide
humiliate	humilier
humiliating	humiliant
humming	bourdonnement
hung	pendu
hurt	blesser
hurted	blessé
hurtful	nuisible
hurting	blesser
hustler	Hustler
hypocricy	hypocricie
hypocrisy	hypocrisie
hypocritical	hypocrite
hypocritically	hypocritement
hysteria	hystérie
hysteric	hystérique
hysterical	hystérique
hysterically	hystériquement
hysterics	hystérie
idiocy	idiotie
idiotic	idiot
idiotically	bêtement
ignominious	ignominieux
ignominiously	ignominieusement
ignominy	ignominie
ignore	ignorer
ill-fated	malheureux
ill-favored	mal-favorisé
ill-treated	maltraité
illegal	illégal
illegally	illégalement
illegitimate	illégitime
illicit	illicite
illiterate	analphabète
illness	maladie
illogic	illogique
illogical	illogique
illogically	illogiquement
illusory	illusoire
imaginary	imaginaire
imbalance	déséquilibre
imbecile	imbécile
immaterial	immatériel
imminently	imminemment
immobilized	immobilisé
immoderate	immodéré
immoderately	immodérément
immodest	impudique
immorality	immoralité
immorally	immoralement
immovable	immeuble
impaired	altéré
impatiently	impatiemment
impeach	accuser
impedance	impédance
impede	entraver
impediment	obstacle
impending	imminent
impenitent	impénitent
imperfect	imparfait
imperfectly	imparfaitement
imperialist	impérialiste
imperious	impérieux
imperiously	impérieusement
impermissible	inadmissible
impersonal	impersonnel
impetuous	impétueux
impetuously	impétueusement
impiety	impiété
impinge	empiéter
impious	impie
implausibly	invraisemblablement
implicate	impliquer
implode	imploser
impolite	impoli
impolitely	impoliment
impolitic	impolitique
importunate	importun
importune	importuner
impose	imposer
imposers	imposteurs
imposing	imposant
impossiblity	impossibilité
impossibly	incroyablement
impotent	impuissant
impoverish	appauvrir
impoverished	appauvri
imprecate	imprécier
imprecise	imprécis
imprecisely	imprécis
imprecision	imprécision
imprison	emprisonner
imprisonment	emprisonnement
improbability	improbabilité
improbably	improbablement
improperly	incorrectement
impropriety	inconvenance
impudently	impudemment
impugn	attaquer
impulsive	impulsif
impulsively	impulsivement
impunity	impunité
impure	impur
impurity	impureté
inability	incapacité
inaccuracies	inexactitudes
inaccuracy	inexactitude
inaccurate	inexacte
inaccurately	inexactement
inactive	inactif
inadequacy	insuffisance
inadequate	inadéquat
inadequately	insuffisamment
inadverent	inconséquent
inadvisable	déconseillé
inadvisably	déconseillé
inane	inepte
inanely	niaisement
inappropriate	inapproprié
inapt	inapte
inarticulate	inarticulé
inattentive	inattentif
incapably	incapable
incautious	imprudent
incendiary	incendiaire
incense	encens
incite	inciter
incitement	incitation
incivility	incivilité
inclement	inclément
incognizant	incognito
incoherence	incohérence
incoherent	incohérent
incomparably	incomparablement
incompatability	incompatibilité
incompatibility	incompatibilité
incompetence	incompétence
incompetent	incompétent
incompetently	incompétent
incomplete	incomplet
incomprehensible	incompréhensible
incomprehension	incompréhension
inconceivable	inconcevable
inconceivably	inconcevablement
incongruous	incongru
inconsequent	inconséquent
inconsiderate	inconsidéré
inconsiderately	inconsidérément
inconsistence	inconsistance
inconsistencies	incohérences
inconsistency	incohérence
inconsistent	inconsistant
inconsolably	inconsolable
inconvenience	inconvénient
inconveniently	incommode
incorrect	Incorrect
incorrectly	incorrectement
incorrigibly	incorrigiblement
incredulous	incrédule
incredulously	incrédule
inculcate	inculquer
indecency	indécence
indecent	indécent
indecently	indécemment
indecision	indécision
indecisive	indécis
indecisively	indécisivement
indecorum	indécorum
indefensible	indéfendable
indelicate	indélicat
indeterminable	indéterminable
indeterminably	indéterminé
indeterminate	indéterminé
indifference	indifférence
indifferent	indifférent
indignant	indigné
indignantly	indigné
indignity	indignité
indiscernible	indiscernable
indiscreet	indiscret
indiscreetly	indiscrètement
indiscretion	indiscrétion
indiscriminate	indiscriminer
indiscriminately	indistinctement
indiscriminating	indiscriminant
indistinguishable	indiscernable
indoctrinate	endoctriner
indoctrination	endoctrinement
ineffective	inefficace
ineffectively	inefficace
ineffectiveness	inefficacité
ineffectual	inefficace
ineffectually	inefficace
ineffectualness	inefficacité
inefficacious	inefficace
inefficacy	inefficacité
inefficiency	inefficacité
inefficient	inefficace
inefficiently	inefficacement
inelegance	inélégance
inelegant	inélégant
ineligible	inéligible
ineloquent	inéloquent
ineloquently	inéloquemment
inept	inepte
ineptitude	ineptie
ineptly	inepte
inequalities	inégalités
inequality	inégalité
inequitable	inéquitable
inequitably	inéquitablement
inequities	inégalités
inescapable	inéluctable
inescapably	inéluctablement
inevitable	inévitable
inevitably	inévitablement
inexcusably	inexcusablement
inexorably	inexorablement
inexperience	inexpérience
inexperienced	inexpérimenté
inexpertly	inexpérimenté
inexplainable	inexplicable
inextricably	inextricablement
infamous	infâme
infamy	infamie
infected	infecté
inferior	inférieur
inferiority	infériorité
infest	infester
infested	infesté
infidel	infidèle
infidels	infidèles
infirm	infirme
inflame	enflammer
inflammatory	inflammatoire
inflammed	enflammé
inflated	gonflé
inflationary	inflationniste
inflict	infliger
infringe	enfreindre
infringement	infraction
infringements	infractions
infuriate	exaspérer
infuriated	furieux
infuriating	exaspérant
infuriatingly	exaspérante
ingrate	ingrat
inhibit	inhiber
inhospitable	inhospitalier
inhospitality	inhospitalité
inhuman	inhumain
inhumane	inhumain
inhumanity	inhumanité
inimical	hostile
inimically	inimitablement
iniquitous	inique
iniquity	iniquité
injure	blesser
injurious	préjudiciable
injury	blessure
innuendo	insinuation
inoperable	inopérable
inopportune	inopportun
inordinate	excessif
inordinately	démesurément
insane	insensé
insanely	follement
insanity	folie
insecurity	insécurité
insensitive	insensible
insensitively	insensiblement
insensitivity	insensibilité
insidious	insidieux
insidiously	insidieusement
insignificance	insignifiance
insignificant	insignifiant
insincerely	insincérément
insinuate	insinuer
insinuating	insinuant
insolently	insolemment
insolvent	insolvable
instability	instabilité
instigate	susciter
instigator	instigateur
instigators	instigateurs
insubordinate	insubordonné
insubstantial	négligeable
insufferable	insupportable
insufferably	insupportablement
insufficiency	insuffisance
insufficient	insuffisant
insufficiently	insuffisamment
insular	insulaire
insult	insulter
insulted	insulté
insulting	insultant
insultingly	insultant
insupportably	insupportablement
insurmountable	insurmontable
insurmountably	insurmontable
interfere	interférer
interference	ingérence
interferes	interfère
interrupt	interrompre
intimidate	intimider
intimidating	intimidant
intimidatingly	intimidant
intolerable	intolérable
intolerablely	intolérablement
intolerance	intolérance
intoxicate	enivrer
intractable	intraitable
intransigence	intransigeance
intransigent	intransigeant
intrude	intrusion
intrusive	intrusif
inundate	inonder
inundated	inondé
invader	envahisseur
invalid	invalide
invalidate	invalider
invalidity	invalidité
invasive	envahissant
invidious	injuste
invidiously	invidieusement
invidiousness	injustice
involuntarily	involontairement
involuntary	involontaire
irate	furieux
irately	irrité
ire	colère
irk	contrarier
irked	contrarié
irksome	ennuyeux
irksomeness	ennui
irksomenesses	impatients
ironic	ironique
ironical	ironique
ironically	ironiquement
ironies	Ironies
irony	ironie
irragularity	irrigularité
irrational	irrationnel
irrationalities	irrationalités
irrationality	irrationalité
irrationally	irrationnellement
irrationals	irrationnels
irreconcilable	irréconciliable
irrecoverable	irrécupérable
irrecoverableness	irrécupérable
irrecoverablenesses	irrécupérables
irrecoverably	irrémédiablement
irredeemable	irréparable
irredeemably	irrémédiablement
irreformable	irréformable
irregular	irrégulier
irregularity	irrégularité
irreparable	irréparable
irreplacible	irremplaçable
irrepressible	irrépressible
irresolute	irrésolu
irresolvable	irrésolvable
irresponsible	irresponsable
irresponsibly	irresponsable
irretrievable	irrémédiable
irreversible	irréversible
irritably	irritée
irritate	irriter
irritated	irrité
irritating	irritant
isolate	isoler
isolated	isolé
isolation	isolement
issue	problème
issues	problèmes
itch	démanger
itching	démangeaisons
jabber	jacasser
jaded	blasé
jagged	déchiqueté
jam	confiture
jarring	discordant
jaundiced	jaunisse
jealous	jaloux
jealously	jalousement
jealousness	jalousie
jealousy	jalousie
jeer	railler
jeeringly	moqueur
jeers	railleries
jeopardize	compromettre
jeopardy	péril
jerk	secousse
jerky	saccadé
jitter	gigue
jitters	frousse
jittery	nerveux
job-killing	tuer
joke	blague
jolt	secousse
judder	Judder
juddering	trébucher
jumpy	nerveux
junk	déchet
junkyard	Junkyard
kaput	fichu
kill	tuer
killed	tué
killer	tueur
killing	meurtre
kills	tue
knave	fripon
knife	couteau
knock	frappe
knotted	noué
lackadaisical	apathique
lacked	manqué
lackey	laquais
lackeys	laquais
lacking	manquant
lackluster	terne
lacks	manque
laconic	laconique
lag	décalage
lagged	retardé
lags	retards
lambast	agneau
lambaste	rosser
lame	boiteux
lament	complainte
lamentably	lamentablement
languid	languissant
languish	languir
languor	langueur
languorous	langoureux
languorously	langoureusement
lanky	dégingandé
lapse	laps
lapsed	périmé
lapses	défaillances
lascivious	lascif
latency	latence
laughable	ridicule
laughably	risiblement
laughingstock	risée
lawlessness	anarchie
layoff	Licencier
lazy	paresseux
leak	fuite
leakage	fuite
leakages	fuites
leaking	fuite
lecher	débauché
lecherous	lubrique
lechery	luxure
leech	sangsue
leer	lorgner
leery	méfiant
lemon	citron
lengthy	longue
lethal	mortel
lethargic	léthargique
lethargy	léthargie
lewd	obscène
lewdly	lubrique
lewdness	obscénité
liability	responsabilité
liable	responsable
liar	menteur
liars	menteurs
licentious	licencieux
licentiously	licenciement
licentiousness	licence
lie	mensonge
lied	menti
lies	mentir
limit	limite
limitations	limites
limited	limité
limits	limites
limp	boiter
listless	indifférent
litigious	litigieux
livid	livide
lividly	livide
loath	répugner
loathe	détester
loathing	répugnance
loathly	désespérément
loathsome	détestable
lone	seul
loneliness	solitude
lonely	solitaire
loner	solitaire
lonesome	solitaire
long-time	Longtemps
long-winded	verbeux
longing	désir
loophole	échappatoire
loopholes	failles
loot	butin
lorn	déchiré
lose	perdre
loser	perdant
losers	perdants
loses	perd
losing	perdant
loss	perte
losses	pertes
lost	perdu
loud	bruyant
lousy	pouilleux
lovelorn	amoureuse
lowly	humble
ludicrous	ridicule
ludicrously	ridiculement
lugubrious	lugubre
lukewarm	tiède
lull	accalmie
lumpy	grumeleux
lunatic	fou
lurch	embardée
lure	leurre
lurid	sinistre
lurking	cachette
lying	mensonge
mad	furieux
maddening	exaspérant
maddeningly	affolant
madder	garance
madly	follement
madman	fou
maladjusted	inadapté
maladjustment	inadaptation
malady	maladie
malcontent	mécontent
malcontented	mécontent
maledict	malédict
malevolence	malveillance
malevolent	malveillant
maliciously	malicieusement
maliciousness	malignité
malign	calomnier
malignant	malin
malodorous	malodorant
mangle	mutiler
mangled	mutilé
maniac	maniaque
maniacal	maniaque
manic	maniaque
manipulate	manipuler
manipulative	manipulateur
manipulators	manipulateurs
marginally	marginalement
martyrdom	martyre
matte	mat
mawkish	fade
meager	maigre
meanness	méchanceté
measly	misérable
meddlesome	indiscret
mediocre	médiocre
mediocrity	médiocrité
melancholy	mélancolie
melodramatic	mélodramatique
melodramatically	mélodramatiquement
meltdown	effondrement
menacing	menaçant
menacingly	menaçant
mendacious	mensonger
mendacity	fausseté
menial	servile
mess	désordre
messed	foiré
messes	mess
messing	déconner
messy	désordonné
midget	nain
miff	fâcherie
militancy	militantisme
mindless	stupide
mindlessly	stupidement
mire	boue
misalign	désaligner
misaligns	désalignements
misbecoming	mal-être
misbegotten	illégitime
miscellaneous	divers
mischief	sottises
mischievous	malicieux
mischievously	malicieux
miscreant	scélérat
miscreants	mécréants
miser	avare
miserable	misérable
miserableness	misérable
miserably	misérablement
miseries	misères
miserly	avare
misery	misère
misfit	inadapté
misfortune	malheur
misgiving	crainte
misgivings	appréhensions
misguidance	égarement
misguide	dévoyer
misguided	égaré
mishandle	maltraiter
mishap	mésaventure
mislead	tromper
misleading	trompeur
misleadingly	trompeusement
mispronounce	malpronounce
misrepresent	dénaturer
miss	manquer
missed	manqué
misses	manque
mist	brouillard
mistake	erreur
mistaken	trompé
mistakes	erreurs
mistified	mistifié
mistress	maîtresse
mistrust	méfiance
mistrustful	méfiant
mistrustfully	méfiant
mists	brumes
misunderstanding	malentendu
misunderstandings	malentendus
misuse	abuser
moan	gémissement
mobster	gangster
mock	moquer
mocked	moqué
mockeries	moqueries
mockery	moquerie
mocking	railleur
mockingly	moqueur
molest	molester
monotonous	monotone
monotony	monotonie
monster	monstre
monstrosities	monstruosités
monstrosity	monstruosité
monstrous	monstrueux
monstrously	monstrueusement
moot	discutable
morbid	morbide
morbidly	maladivement
mordantly	mordant
moribund	moribond
moron	idiot
moronic	débile
morons	crétins
mortified	mortifié
mortify	mortifier
mortifying	mortifiant
motionless	immobile
motley	hétéroclite
mourner	pleureuse
mournful	triste
mournfully	mélancoliquement
muddle	confusion
muddy	boueux
mudslinger	bouleverseur
mudslinging	dénigrement
mulish	têtu
multi-polarization	multi-polarisation
mundane	banal
murder	meurtre
murderer	meurtrier
murderous	meurtrier
murderously	meurtrier
murky	sombre
mushy	détrempé
mysterious	mystérieux
mysteriously	mystérieusement
mystery	mystère
mystify	mystifier
myth	mythe
nag	harceler
nagging	harcelant
naive	naïve
naively	naïvement
nastily	méchamment
nastiness	méchanceté
nasty	méchant
naughty	vilain
nauseate	écœurer
nauseates	nauséats
nauseating	nauséeux
nauseatingly	nauséabond
nebulous	nébuleux
nebulously	nébuleusement
needless	inutile
needlessly	inutilement
needy	nécessiteux
nefarious	infâme
nefariously	malfaisant
negate	nier
negation	négation
negative	négatif
negatives	négatifs
negativity	négativité
neglect	négligence
neglected	négligé
negligence	négligence
negligent	négligent
nemesis	Némésis
nepotism	népotisme
nervous	nerveux
nervously	nerveusement
nervousness	nervosité
nettle	ortie
neurotic	névrosé
neurotically	neurotiquement
niggles	dérange
nightmare	cauchemar
nightmarish	cauchemardesque
nightmarishly	cauchemardesque
noise	bruit
noisy	bruyant
nonexistent	inexistant
nonsense	absurdité
nosey	curieux
notoriety	notoriété
notorious	célèbre
notoriously	notoirement
noxious	nuisible
numb	engourdi
obese	obèse
object	objet
objectionable	répréhensible
obliterate	effacer
obliterated	oblitéré
oblivious	inconscient
obnoxious	odieux
obnoxiously	odieusement
obscene	obscène
obscenely	obscénement
obscenity	obscénité
obscure	obscur
obscured	obscurci
obscures	obscurcit
obscurity	obscurité
obsess	obséder
obsessive	obsessionnel
obsessively	obsessionnellement
obsessiveness	obsession
obsolete	obsolète
obstinate	obstiné
obstinately	obstinément
obstruct	obstruer
obstructed	obstrué
obstructing	obstruer
obstructs	obstrue
obtrusive	importun
obtuse	obtus
occlude	occlure
occluded	occlus
occludes	occlus
occluding	occlusion
odd	impair
oddities	bizarreries
oddity	singularité
oddly	bizarrement
odor	odeur
offence	infraction
offend	offenser
offender	délinquant
offending	incriminé
offenses	infractions
offensively	offensivement
offensiveness	offensante
officious	officieux
ominously	menaçant
omit	omettre
one-sided	unilatéral
onerous	lourd
onerously	lourdement
onslaught	assaut
opinionated	dogmatique
opponent	adversaire
opportunistic	opportuniste
oppose	s'opposer
oppress	opprimer
oppressive	oppressif
oppressively	oppressive
oppressiveness	oppression
oppressors	oppresseurs
ordeal	supplice
orphan	orphelin
ostracize	ostraciser
outbreak	déclenchement
outburst	explosion
outbursts	éclats
outcast	banni
outcry	tollé
outmoded	démodé
outraged	indigné
outrageous	scandaleux
outrageously	outrageusement
outrageousness	outrage
over-acted	sur-agi
over-awe	intimider
over-hyped	over-hype
over-valuation	surestimation
overacted	exagéré
overawe	intimider
overbalance	basculer
overbalanced	surbalancé
overbearing	autoritaire
overbearingly	paresseusement
overblown	exagéré
overdo	exagérer
overdone	exagéré
overheat	surchauffer
overkill	surpuissance
overloaded	surchargé
overlook	négliger
overplay	surjouer
overpower	maîtriser
overrated	surfait
overreach	dépassement
overrun	envahi
overshadow	éclipser
oversight	surveillance
oversights	oublis
oversimplify	simplifier
oversize	surdimensionné
overstate	exagérer
overstated	exagéré
overstatement	exagération
overstatements	exagérations
overstates	surestime
overtaxed	surtaxé
overthrow	renverser
overthrows	renverse
overturn	renverser
overwhelm	submerger
overwhelmed	submergé
overwhelming	accablant
overwhelmingly	massivement
overwhelms	submerge
pain	douleur
painful	douloureux
painfull	douloureux
painfully	douloureusement
pale	pâle
pales	pâlit
paltry	dérisoire
pandemonium	chaos
pander	entremetteur
pandering	proxénète
panic	panique
panick	panique
panicked	paniqué
panicking	paniquer
paradoxical	paradoxal
paradoxically	paradoxalement
paralize	paralyser
paralyzed	paralysé
paranoia	paranoïa
paranoid	paranoïaque
pariah	paria
parody	parodie
partiality	partialité
passive	passif
passiveness	passivité
pathetic	pathétique
pathetically	pathétiquement
patronize	fréquenter
paucity	manque
pauper	pauvre
paupers	pauvres
payback	remboursement
peculiar	particulier
peculiarly	particulièrement
pedantic	pédant
peeled	épluché
peeved	pissé
peevish	maussade
peevishly	hargneusement
penalize	pénaliser
penalty	peine
perfidious	perfide
perfunctory	sommaire
peril	péril
perilous	périlleux
perilously	dangereusement
perish	périr
pernicious	pernicieux
perplex	embarrasser
perplexed	perplexe
perplexing	embarrassant
perplexity	perplexité
persecute	persécuter
persecution	persécution
pertinacious	opiniâtre
pertinaciously	pertinemment
pertinacity	opiniâtreté
perturb	perturber
perturbed	perturbé
pervasive	envahissant
perverse	pervers
perversely	perversement
perversity	perversité
pervert	pervertir
perverted	pervers
perverts	pervers
pessimism	pessimisme
pessimistic	pessimiste
pest	ravageur
pestilent	pestilentiel
petrified	pétrifié
petrify	pétrifier
petty	petit
phobia	phobie
phobic	phobique
phony	faux
picket	piquet
picketed	piqueté
pickets	piquets
picky	difficile
pig	porc
pillory	pilori
pimple	bouton
pinch	pincer
pique	piquer
pitiable	pitoyable
pitiful	pitoyable
pitifully	pitoyablement
pity	pitié
plagiarize	plagier
plague	peste
plaything	jouet
plea	plaidoyer
pleas	plaidoyers
plebeian	plébéien
plot	terrain
plotters	traceurs
ploy	stratagème
plunder	pillage
plunderer	pillard
pointless	inutile
poisonous	toxique
poisonously	venimeux
pokey	taule
poky	exigu
polemize	polémiser
pollute	polluer
polluter	pollueur
polluters	pollueurs
pompous	pompeux
poor	pauvre
poorly	pauvrement
posturing	posture
pout	moue
powerless	impuissant
prate	jaser
prattle	babil
precarious	précaire
precariously	précairement
precipitate	précipité
precipitous	abrupt
predatory	prédateur
prejudge	préjuger
prejudice	préjudice
prejudicial	préjudiciable
premeditated	prémédité
preoccupy	préoccuper
preposterous	absurde
presumptuous	présomptueux
presumptuously	présomptueusement
pretence	prétexte
pretense	prétexte
pretentious	prétentieux
pretentiously	prétentieusement
prevaricate	tergiverser
pricey	cher
prick	piquer
prickle	picoter
prickles	piquants
prideful	orgueilleux
primitive	primitif
prisoner	prisonnier
problem	problème
problematic	problématique
problems	problèmes
procrastinate	tergiverser
procrastinates	procrastine
profanity	impiété
prohibit	interdire
prohibitive	prohibitif
prohibitively	prohibitif
proprietary	propriétaire
prosecute	poursuivre
protest	protestation
protested	protesté
protesting	protester
protests	protestations
protracted	prolongé
provocative	provocant
provoke	provoquer
pry	prier
pugnacious	pugnace
pugnacity	pugnacité
punish	punir
punishable	punissable
punitive	punitif
puny	chétif
puppet	fantoche
puppets	marionnettes
puzzled	perplexe
puzzlement	perplexité
puzzling	déroutant
quack	charlatan
qualm	scrupule
qualms	scrupules
quandary	dilemme
quarrel	querelle
quarrellous	querelleuse
quarrellously	querelleusement
quarrels	querelles
quarrelsome	querelleur
quash	annuler
questionable	discutable
quibble	ergoter
quibbles	ergoter
rabid	enragé
racism	racisme
racist	raciste
racists	racistes
racy	racé
radicalization	radicalisation
radically	radicalement
radicals	radicaux
raging	rage
raked	ratissé
rampage	déchaînement
ramshackle	délabré
rancor	rancune
rankle	ennuyer
rant	déclamer
ranted	déclamé
ranting	déclamer
rantingly	rageusement
rants	déchaîne
rape	râpé
raped	violé
raping	violer
rascal	coquin
rascals	coquins
rash	téméraire
rattle	hochet
rattled	ébranlé
rattles	hochets
ravage	ravager
raving	délirant
reactionary	réactionnaire
rebellious	rebelle
rebuff	rebuffade
rebuke	réprimander
recalcitrant	récalcitrant
recant	rétracter
recession	récession
recessionary	récessionnaire
reckless	téméraire
recklessly	imprudemment
recklessness	insouciance
recoil	recul
recourses	recours
redundancy	redondance
redundant	redondant
refusal	refus
refuse	refuser
refused	refusé
refuses	refuse
refusing	refusant
refutation	réfutation
refute	réfuter
refuted	réfuté
refutes	réfute
refuting	réfuter
regress	régresser
regression	régression
regressive	régressif
regreted	regretté
regrettably	malheureusement
regretted	regretté
reject	rejeter
rejected	rejeté
rejecting	rejetant
rejection	rejet
rejects	rejette
relapse	rechute
relentless	implacable
relentlessly	implacablement
relentlessness	implacabilité
reluctance	réluctance
reluctant	réticent
remorse	remords
renounce	renoncer
renunciation	renonciation
repel	repousser
repetitive	répétitif
reprehensible	répréhensible
reprehensibly	répréhensible
reprehensive	répréhensible
repress	réprimer
repression	répression
repressive	répressif
reprimand	réprimande
reproach	reproche
reprove	réprouver
reprovingly	réprimander
repudiate	répudier
repudiation	répudiation
repugn	repousser
repugnance	répugnance
repugnant	répugnant
repugnantly	répugnant
repulse	repousser
repulsed	repoussé
repulsing	repousser
repulsive	repoussant
repulsively	repoussant
repulsiveness	répulsion
resent	renvoyé
resentful	irrité
resentment	rancœur
resignation	démission
resigned	résigné
restless	agité
restlessness	agitation
restrict	restreindre
restricted	limité
restrictive	contraignant
resurgent	renaissant
retarded	retardé
retardedness	retard
retards	retarde
reticent	réticent
retreated	retraité
revenge	vengeance
revengeful	vindicatif
revengefully	vengeance
revert	revenir
revile	vilipender
reviled	insulté
revoke	révoquer
revolt	révolte
revolting	révoltant
revoltingly	révoltant
revulsion	dégoût
revulsive	révulsif
rhetoric	rhétorique
rhetorical	rhétorique
ridiculous	ridicule
ridiculously	ridiculement
rife	répandre
rift	crevasse
rifts	Failles
rigid	rigide
rigidity	rigidité
rigidness	rigidité
rile	agacer
riled	raillé
rip	déchirure
rip-off	vol
ripoff	vol
ripped	déchiré
risk	risque
risky	risqué
rivalry	rivalité
rocky	rocheux
rogue	coquin
rot	pourrir
rotten	pourri
rough	rugueux
rubbish	ordures
rude	grossier
ruffian	brute
ruffle	ébouriffer
ruined	ruiné
ruining	ruiner
ruinous	ruineux
ruins	ruines
rumbling	grondement
rumor	rumeur
rumors	rumeurs
rumours	rumeurs
rumple	froisser
run-down	fatigué
runaway	fuyez
rust	rouille
rusty	rouillé
ruthless	impitoyable
ruthlessly	impitoyablement
ruts	ornières
sack	sac
sacrificed	sacrifié
sad	triste
sadden	attrister
sadly	Malheureusement
sadness	tristesse
sag	affaissement
sagged	affaissé
sagging	affaissement
saggy	flasque
sags	fléchit
salacious	salace
sanctimonious	moralisateur
sap	sève
sarcasm	sarcasme
sarcastic	sarcastique
sarcastically	sarcastique
sardonic	sardonique
sardonically	sardoniquement
sass	toupet
satirical	satirique
satirize	satire
savage	sauvage
savaged	sauvé
savagery	sauvagerie
savages	sauvages
scaly	écailleux
scam	arnaque
scams	escroqueries
scandal	scandale
scandalize	scandaliser
scandalized	scandalisé
scandalous	scandaleux
scandalously	scandaleusement
scandals	scandales
scant	peu
scar	cicatrice
scarce	rare
scarcity	rareté
scare	effrayer
scared	effrayé
scarier	effrayant
scariest	effrayant
scarily	effrayer
scarred	cicatrisé
scary	effrayant
scathing	cinglant
scathingly	cinglant
sceptical	sceptique
scoff	moquerie
scoffingly	moqueur
scold	gronder
scolded	grondé
scolding	réprimande
scoldingly	gronderly
scorching	brûlant
scorchingly	brûlant
scorn	mépris
scornful	méprisant
scoundrel	scélérat
scourge	fléau
scramble	brouiller
scrambled	brouillé
scrambles	brouiller
scrambling	brouiller
scrap	ferraille
scratch	rayure
scratched	rayé
scratches	rayures
scratchy	rêche
scream	crier
screech	hurler
screw-up	bousiller
screwed	vissé
screwed-up	foiré
screwy	tordu
scuff	érafler
scuffs	éraflures
scum	écume
scummy	écumeux
secretive	secret
sedentary	sédentaire
seedy	miteux
seething	bouillir
self-criticism	autocritique
self-defeating	auto-destructeur
self-destructive	autodestructeur
self-humiliation	auto-humiliation
self-interested	intéressé
self-serving	égoïste
selfish	égoïste
selfishly	égoïstement
selfishness	égoïsme
semi-retarded	semi-retardé
senile	sénile
sensationalize	sensationnalise
senseless	insensé
seriousness	gravité
sermonize	sermonner
set-up	installer
setback	revers
setbacks	revers
sever	rompre
severe	sévère
severity	gravité
shabby	minable
shadowy	ombragé
shady	ombragé
shake	secouer
shaky	précaire
sham	faux
shambles	pagaille
shameful	honteux
shamefully	honteusement
shamefulness	honte
shameless	éhonté
shamelessness	impudence
shark	requin
sharply	nettement
shatter	briser
shimmer	miroiter
shipwreck	Naufrage
shit	merde
shiver	frisson
shock	choc
shocked	choqué
shocking	choquant
shockingly	terriblement
shortage	pénurie
shortcoming	défaut
shortcomings	lacunes
shortness	courtesse
shortsighted	myope
shortsightedness	myopie
shrew	musaraigne
shriek	cri
shrill	aigu
shrilly	aigrement
shroud	envelopper
shrouded	enveloppé
shun	éviter
shunned	évité
sick	malade
sickening	écœurant
sickeningly	écœurant
sickly	maladif
sickness	maladie
sidetrack	dérouter
sidetracked	dérouté
siege	siège
silly	idiot
simplistic	simpliste
sin	péché
sinful	coupable
sinfully	pécheresse
sinister	sinistre
sinisterly	sinistrement
sink	évier
sinking	naufrage
skeletons	squelettes
skeptic	sceptique
skeptical	sceptique
skepticism	scepticisme
sketchy	vague
skimpy	maigre
skinny	maigre
skittish	ombrageux
skittishly	maladroitement
slack	mou
slander	calomnie
slanderer	calomniateur
slanderous	diffamatoire
slanderously	calomnieusement
slanders	calomnies
slap	gifler
slashing	couper
slaughter	abattage
slaughtered	abattu
slave	esclave
sleazy	sordide
slime	vase
slog	bosser
slogged	malmené
slogging	fouetter
sloppily	négligemment
sloppy	négligé
slothful	paresseux
slow	lent
slowed	ralenti
slower	Ralentissez
slowly	lentement
sloww	ralentir
slowww	slowwww
slug	limace
sluggish	paresseux
slump	marasme
slumping	effondré
slumpping	trébucher
slur	liaison
slut	salope
sluts	salopes
sly	sournois
smack	claque
smallish	petit
smash	fracasser
smear	frottis
smell	odeur
smelled	sentait
smelling	odeur
smells	odeurs
smelly	malodorant
smelt	éperlan
smoke	fumée
smolder	couver
smoldering	fumant
smother	étouffer
smoulder	couver
smouldering	fumant
smudge	tache
smudged	taché
smudges	taches
smudging	baveux
smug	suffisant
smut	cochonneries
smuttiest	fiévreux
smutty	cochon
snag	accroc
snagged	accroché
snagging	accrochage
snappish	hargneux
snappishly	brusquement
snare	piège
snarl	gronder
sneakily	sournoisement
sneaky	sournois
sneer	ricanement
sneering	ricaner
sneeringly	sournoisement
snobbish	snob
snobish	snob
snub	snober
soapy	savonneux
sob	sanglot
sober	sobre
solemn	solennel
solicitude	sollicitude
somber	sombre
sore	endolori
sorely	grandement
soreness	douleur
sorrow	chagrin
sorrowful	douloureux
sorrowfully	tristement
sorry	Pardon
sour	acide
sourly	aigrement
spade	bêche
spank	fesser
spendy	dépensé
spew	vomir
spewed	craché
spewing	cracher
spews	Spews
spilling	effusion
spite	dépit
spiteful	malveillant
spitefully	méchamment
spitefulness	méchanceté
splatter	éclabousser
split	Divisé
splitting	scission
spoil	gâcher
spoilage	détérioration
spoilages	gâchis
spoiled	gâté
spoils	dépouilles
spook	effrayer
spooky	effrayant
sporadic	sporadique
spurious	faux
sputter	cracher
squabble	querelle
squander	gaspiller
squash	écraser
squeak	grincer
squeaks	couine
squeaky	grinçant
squeal	hurler
squealing	crissement
squeals	cris
stab	poignarder
stagnate	stagner
stain	tache
stains	taches
stale	vicié
stalemate	impasse
stall	stalle
stalls	stalles
stammer	balbutier
stampede	débandade
standstill	arrêt
stark	rigide
starkly	sévèrement
startle	surprendre
startling	surprenant
startlingly	étonnamment
starvation	famine
starve	affamer
static	statique
steal	voler
stealing	vol
steals	vole
steep	raide
steeply	raide
stench	puanteur
stereotype	stéréotype
stereotypical	stéréotypé
stereotypically	stéréotypiquement
stern	arrière
stew	Ragoût
sticky	gluant
stiff	rigide
stiffness	rigidité
stifle	étouffer
stifling	étouffant
stiflingly	étouffant
stigma	stigmate
stigmatize	stigmatiser
sting	piquer
stinging	piqûre
stingingly	cuisant
stingy	avare
stink	puanteur
stinks	pue
stodgy	lourd
stolen	volé
stooge	larbin
stormy	orageux
straggle	lutter
straggler	traînard
strain	souche
strained	tendu
straining	forcer
strange	étrange
strangely	étrangement
stranger	étranger
strangle	étrangler
streaky	strié
strenuous	ardu
stresses	contraintes
stressful	stressant
stressfully	stressant
stricken	sinistré
strictly	strictement
stridently	stridentement
strife	conflit
stringent	strict
stringently	rigoureusement
struck	frappé
struggle	lutte
struggled	lutté
struggles	luttes
struggling	luttant
stubborn	têtu
stubbornly	obstinément
stubbornness	entêtement
stuck	coincé
stuffy	bouché
stumble	trébucher
stumbled	trébuché
stumbles	trébuche
stump	souche
stumped	perplexe
stumps	souches
stun	étourdir
stunt	cascade
stunted	rabougri
stupid	stupide
stupidest	stupide
stupidity	stupidité
stupidly	stupidement
stupified	stupéfié
stupify	stupéfier
stupor	stupeur
stutter	bégayer
stuttered	bégayé
stuttering	bégaiement
stutters	bégaie
sty	porcherie
stymied	contrecarré
sub-par	sous-par
subdued	tamisé
subjected	soumis
subjection	sujétion
subjugate	subjuguer
subjugation	assujettissement
submissive	soumis
subordinate	subalterne
subpoena	assignation
subpoenas	assignations
subservience	asservissement
subservient	servile
subtract	soustraire
subversive	subversif
subversively	subversivement
subvert	subvertir
succumb	succomber
suck	sucer
sucked	aspiré
sucker	ventouse
sucks	suce
sued	poursuivi
sueing	poursuivre
sues	poursuivre
suffer	souffrir
suffered	souffert
sufferer	victime
sufferers	souffrant
suffering	Souffrance
suffers	souffre
suffocate	étouffer
suicidal	suicidaire
sulk	bouder
sullen	renfrogné
sully	souiller
sunder	séparer
sunk	coulé
sunken	creux
superficial	superficiel
superficially	superficiellement
superfluous	superflu
superstitious	superstitieux
suppress	réprimer
surrender	abandon
susceptible	sensible
suspicion	soupçon
suspicions	soupçons
suspicious	méfiant
suspiciously	soupçonneusement
swagger	fanfaronner
swamped	submergé
swelled	gonflé
swelling	gonflement
swindle	escroquerie
swipe	balayer
swollen	gonflé
symptom	symptôme
symptoms	symptômes
taboo	tabou
tacky	collant
taint	entacher
tainted	entaché
tamper	altérer
tangle	enchevêtrement
tangled	emmêlé
tangles	emmêles
tank	réservoir
tanked	tanké
tanks	réservoirs
tantrum	colère
tardy	tardif
tarnish	ternir
tarnished	terni
tarnishes	ternit
tarnishing	ternir
taunt	raillerie
taunting	railler
tauntingly	railleur
taunts	provocations
taut	tendu
tawdry	clinquant
taxing	taxation
tease	taquiner
teasingly	taquiner
tedious	fastidieux
tediously	fastidieusement
temerity	témérité
temper	tempérer
tempest	tempête
temptation	tentation
tenderness	tendresse
tense	tendu
tentative	provisoire
tentatively	provisoirement
tenuous	ténu
tenuously	ténu
tepid	tiède
terribly	terriblement
terror-genic	terreur-génique
terrorism	terrorisme
terrorize	terroriser
testy	grincheux
tetchy	irritable
thankless	ingrat
thorny	épineux
thoughtless	irréfléchi
thoughtlessly	étourdiment
thoughtlessness	légèreté
thrash	débattre
threat	menace
threaten	menacer
threatening	menaçant
threesome	trio
throb	palpiter
throbbed	palpité
throbbing	battement
throbs	battements
throttle	étrangler
thug	voyou
thwart	contrecarrer
time-consuming	long
timid	timide
timidity	timidité
timidly	timidement
timidness	timidité
tin-y	minuscule
tingled	tinté
tingling	picotement
tired	fatigué
tiresome	fatigant
tiring	fatigant
tiringly	fatiguant
toil	labeur
toll	péage
top-heavy	haut-lourd
topple	renverser
torment	tourmenter
tormented	tourmenté
tortuous	tortueux
tortured	torturé
torturing	torturer
torturous	tortueux
torturously	tortueusement
totalitarian	totalitaire
touchy	suceptible
toughness	dureté
touted	vanté
touts	rabatteurs
toxic	toxique
traduce	calomnier
tragic	tragique
tragically	tragiquement
traitor	traitre
traitorous	traître
traitorously	traître
trample	bafouer
transgress	transgresser
trap	piège
traped	piégé
trapped	piégé
trash	poubelle
trashed	saccagé
trashy	trash
trauma	traumatisme
traumatic	traumatique
traumatically	traumatisant
traumatize	traumatiser
traumatized	traumatisé
travesty	travestir
treacherous	perfide
treacherously	traîtreusement
treachery	traîtrise
treason	trahison
treasonous	traître
trick	tour
tricked	trompé
trickery	tromperie
tricky	rusé
trivial	banal
trivialize	banaliser
trouble	difficulté
troubled	troublé
troublesome	gênant
troublesomely	ennuyeusement
troubling	troublant
troublingly	troublant
truant	absent
tumble	chute
tumbled	dégringolé
tumbles	dégringole
tumultuous	tumultueux
twist	torsion
twisted	tordu
twists	rebondissements
tyrannical	tyrannique
tyrannically	tyranniquement
tyranny	tyrannie
tyrant	tyran
ugh	Pouah
ugly	laid
ulterior	ultérieur
un-viewable	non-visible
unable	incapable
unacceptable	inacceptable
unacceptablely	inacceptable
unacceptably	inacceptable
unaccessible	inaccessible
unaccustomed	inhabituel
unachievable	irréalisable
unaffordable	inabordable
unappealing	désagréable
unavailable	indisponible
unavoidably	inévitablement
unbearable	insupportable
unbearablely	insupportablement
unbelievable	incroyable
unbelievably	incroyablement
uncaring	indifférent
uncertain	incertain
uncivil	impoli
uncivilized	sauvage
unclean	impur
uncollectible	irrécouvrable
uncomfortable	inconfortable
uncomfortably	inconfortablement
uncomfy	inconfortable
uncompromising	intransigeant
unconstitutional	inconstitutionnel
uncontrolled	incontrôlé
uncouth	grossier
undecided	indécis
undefined	indéfini
undependability	non-dépendante
undependable	indescriptible
undercut	saper
undercuts	contre-dépouilles
undercutting	sous-cotation
underdog	opprimé
underestimate	sous-estimer
underlings	subalterne
undermine	saper
undermined	miné
undermines	sape
undermining	saper
underpaid	sous-payés
underpowered	sous-alimenté
undesirable	indésirable
undetermined	indéterminé
undid	défait
undignified	indigne
undone	défait
undue	indu
uneasiness	malaise
uneasy	inquiet
unequal	inégal
unethical	immoral
uneven	inégal
unexpected	inattendu
unexplained	inexpliqué
unfairly	injustement
unfaithful	infidèle
unfaithfully	infidèlement
unfamiliar	inconnu
unfavorable	défavorable
unfeeling	insensible
unfinished	inachevé
unfit	inapte
unforeseen	imprévu
unforgiving	impitoyable
unfortunate	malheureux
unfortunately	malheureusement
unfriendly	hostile
unfulfilled	insatisfait
ungovernable	ingouvernable
ungrateful	ingrat
unhappily	malheureusement
unhappy	malheureux
unilateralism	unilatéralisme
unimaginable	inimaginable
unimaginably	inimaginable
unintelligible	inintelligible
unintelligile	inintelligile
unipolar	unipolaire
unjust	injuste
unjustifiable	injustifiable
unjustifiably	injustifiable
unjustified	injustifié
unjustly	injustement
unkind	méchant
unkindly	méchamment
unknown	inconnu
unlamentably	indistinctement
unlawful	illicite
unlawfully	illégalement
unlawfulness	illégalité
unleash	déchaîner
unlikely	improbable
unlucky	malchanceux
unmoved	insensible
unnaturally	anormalement
unnecessary	inutile
unneeded	inutile
unnerve	déconcerter
unnerved	énervé
unnerving	énervant
unnervingly	énervant
unnoticed	inaperçu
unpleasant	désagréable
unpleasantries	désinvestissements
unpopular	impopulaire
unpredictable	imprévisible
unproductive	improductif
unproved	non-prouvé
unproves	non-testé
unravel	démêler
unraveled	démêlé
unreachable	inaccessible
unreadable	illisible
unrealistic	irréaliste
unreasonable	déraisonnable
unreasonably	déraisonnablement
unrelenting	implacable
unrest	troubles
unruly	indiscipliné
unsatisfactory	insatisfaisant
unseemly	inconvenant
unsettle	ébranler
unsettled	instable
unsettling	troublant
unsettlingly	troublant
unsophisticated	simple
unspeakable	indicible
unspeakablely	indiciblement
unstable	instable
unsteadiness	déséquilibre
unsteady	instable
unsuccessful	infructueux
unsure	incertain
unsustainable	insoutenable
untenable	intenable
unthinkable	impensable
unthinkably	impensable
untimely	prématuré
untouched	intacte
untrue	faux
untruthful	mensonger
unusable	inutilisable
unusably	inutilement
unuseable	inutilisable
unuseably	inutilement
unusual	inhabituel
unusually	exceptionnellement
unwanted	indésirable
unwarranted	injustifié
unwelcome	importun
unwell	indisposé
unwieldy	lourd
unwillingness	réticence
unwise	imprudent
unwisely	imprudemment
unworkable	impraticable
unworthy	indigne
unyielding	inflexible
upbraid	reprocher
upheaval	bouleversement
uprising	soulèvement
uproar	tumulte
uproarious	désopilant
uproariously	vaguement
uproarous	capricieux
uproarously	grossièrement
uproot	déraciner
upset	dérangé
upsets	bouleverse
upsetting	bouleversant
upsettingly	bouleversant
useless	inutile
usurp	usurper
usurper	usurpateur
utterly	totalement
vagrant	vagabond
vagueness	imprécision
vainly	vainement
vanity	vanité
vehement	véhément
vengeful	vengeur
vengefully	vengeance
vengefulness	vengeance
venom	venin
venomous	venimeux
venomously	venimeux
vent	évent
vex	vexer
vexing	vexer
vibrate	vibrer
vibrated	vibré
vibrates	vibre
vibrating	vibrant
vicious	vicieux
viciously	vicieusement
viciousness	méchanceté
victimize	victimiser
vile	vil
vileness	bassesse
vilify	diffamer
villainous	infâme
villainously	méchamment
villains	vilains
villianously	villianeusement
vindictive	vindicatif
vindictively	vindictivement
violate	violer
violator	violateur
violators	violateurs
violently	violemment
viper	vipère
virulently	virulente
vociferous	bruyant
vociferously	vocifère
volatile	volatil
volatility	volatilité
vomit	vomir
vomited	vomi
vomiting	vomissement
vomits	vomit
vulgar	vulgaire
vulnerable	vulnérable
wail	lamenter
wane	décliner
waning	déclin
wanton	capricieux
war-like	guerrier
wariness	prudence
warlike	guerrier
warned	averti
warning	Attention
warp	chaîne
warped	voilé
wary	prudent
washed-out	délavé
waste	déchets
wasted	perdu
wasteful	gaspilleur
wastefulness	gaspillage
wasting	gaspillage
water-down	l'eau
watered-down	édulcoré
wayward	rebelle
weak	faible
weaken	affaiblir
weakening	affaiblissement
weaknesses	faiblesses
weariness	lassitude
wearisome	ennuyeux
wedge	coin
weed	cannabis
weep	pleurer
weird	bizarre
weirdly	bizarrement
wheedle	cajoler
whimper	gémissement
whine	gémissement
whining	gémissements
whiny	pleurnicher
whips	fouets
whore	putain
whores	putes
wicked	méchant
wickedly	méchamment
wild	sauvage
wildly	follement
wiles	ruses
wily	rusé
wimpy	mauviette
wince	grimacer
wobble	osciller
wobbled	bouleversé
wobbles	oscille
woe	malheur
woebegone	désolé
woeful	triste
woefully	tristement
womanizing	juvénile
worn	usé
worried	inquiet
worriedly	inquiet
worrier	inquiet
worrisome	inquiétant
worry	inquiéter
worrying	inquiétant
worryingly	inquiétant
worse	pire
worsen	empirer
worsening	détérioration
worst	pire
worthlessness	inutilité
wound	blessure
wounds	blessures
wrangle	dispute
wrath	colère
wreak	assouvir
wreaked	attaqué
wreck	épave
wrest	ravir
wrestle	lutter
wretch	misérable
wretched	misérable
wretchedly	misérablement
wretchedness	misère
wrinkle	ride
wrinkled	ridé
wrong	faux
wrongful	injustifié
wrought	forgé
yawn	bâillement
zap	zapper
zapped	zappé
zealot	fanatique
zealous	zélé
zealously	zélé
zombie	zombi
