abound	abundan
abounds	abunda
abundance	abundancia
abundant	abundante
accessable	accesible
accessible	accesible
acclaim	aclamación
acclaimed	aclamado
acclamation	aclamación
accolade	recoñecemento
accolades	recoñecementos
accommodative	acomodativo
accomodative	acomodativo
accomplish	cumprir
accomplished	realizado
accomplishment	realización
accomplishments	logros
accurate	preciso
achievable	alcanzable
achievement	logro
achievements	logros
achievible	alcanzable
acumen	acumen
adaptable	adaptable
adaptive	adaptable
adequate	adecuada
adjustable	axustable
admirable	admirable
admirably	admirablemente
admiration	admiración
admire	admirar
admirer	admirador
admiring	admirando
admiringly	admirablemente
adorable	adorable
adore	adoro
adored	adorado
adorer	adorador
adoring	adorando
adoringly	adorando
adroit	adroit
adroitly	adroitly
adulate	adular
adulation	adulación
adulatory	adulatorio
advanced	avanzado
advantage	vantaxe
advantageous	ventajoso
advantageously	ventajosamente
advantages	vantaxes
adventuresome	aventurero
adventurous	aventurero
advocate	avogado
advocated	defendido
advocates	defensores
affability	afable
affable	afable
affably	afablemente
affectation	afectación
affection	afecto
affectionate	cariñoso
affinity	afinidade
affirm	afirmar
affirmation	afirmación
affirmative	afirmativa
affluence	riqueza
affluent	afluente
afford	pagar
affordable	accesible
affordably	accesible
afordable	afordable
agile	áxil
agilely	agilamente
agility	axilidade
agreeable	agradable
agreeableness	aceptabilidade
agreeably	agradablemente
alluring	fascinante
alluringly	fascinante
altruistic	altruísta
altruistically	altruísticamente
amaze	sorprender
amazed	sorprendido
amazement	asombro
amazes	asombra
amazing	sorprendente
amazingly	sorprendentemente
ambitious	ambicioso
ameliorate	mellorar
amenable	amenable
amenity	comodidade
amiability	amabilidade
amiabily	amiabily
amiable	amable
amicability	amizade
amicable	amigable
amicably	amigablemente
amity	amizade
ample	amplo
amply	amplamente
amuse	divertirse
amusing	divertido
amusingly	divertidamente
angel	anxo
angelic	angélico
apotheosis	apoteose
appeal	apelido
appealing	atractivo
applaud	aplaudir
appreciable	apreciable
appreciate	apreciar
appreciated	apreciado
appreciates	valora
appreciative	apreciado
appreciatively	apreciativa
appropriate	apropiado
approval	aprobación
approve	aprobar
ardent	ardente
ardently	ardientemente
ardor	ardor
articulate	articular
aspiration	aspiración
aspirations	aspiracións
aspire	Aspirar
assurance	garantía
assurances	garantías
assure	asegurar
assuredly	seguro
assuring	asegurando
astonish	asombroso
astonished	asombrado
astonishing	asombroso
astonishingly	sorprendentemente
astonishment	asombro
astound	asombrado
astounded	asombrado
astounding	sorprendente
astoundingly	sorprendentemente
astutely	astutamente
attentive	atento
attraction	atracción
attractive	atractivo
attractively	atractivo
attune	atune
audible	audible
audibly	audiblemente
auspicious	auspicioso
authentic	auténtico
authoritative	autoritario
autonomous	autónomo
available	dispoñible
aver	aver
avid	ávido
avidly	avidamente
award	premio
awarded	galardoado
awards	premios
awe	medo
awed	asustado
awesome	asombroso
awesomely	increíblemente
awesomeness	asombrosa
awestruck	asombrado
awsome	awsome
balanced	equilibrado
bargain	barganha
beauteous	beauteous
beautiful	fermoso
beautifullly	bonito
beautify	embellecer
beauty	beleza
beckon	beckon
beckoned	encargado
beckoning	chamar
beckons	beckons
believable	credível
believeable	creíble
beloved	amado
benefactor	benefactor
beneficent	benéfico
beneficial	beneficioso
beneficially	beneficiosamente
beneficiary	beneficiario
benefit	beneficio
benefits	beneficios
benevolence	benevolencia
benevolent	benevolente
benifits	beneficios
best	mellor
better	mellor
beutifully	beutifully
bless	bendiga
blessing	bendición
bliss	felicidade
blissful	alegre
blissfully	felizmente
blithe	blithe
blockbuster	superproducción
bloom	flor
blossom	florecer
bolster	reforzar
bonny	bonito
bonus	bonus
bonuses	bonos
boom	estrondo
boost	impulsar
bountiful	abundante
brainy	intelixente
brand-new	novo
brave	valente
bravery	valentía
bravo	bravo
breakthrough	avance
breakthroughs	avances
breathtaking	impresionantes
breathtakingly	impresionantes
breeze	brisa
bright	brillante
brighten	alegrar
brilliance	brillo
brilliances	brillantez
brilliant	brillante
brilliantly	brillante
brisk	rápido
brotherly	irmán
bullish	alcista
buoyant	boia
cajole	cajole
calm	calma
calming	calmando
calmness	calma
capability	capacidade
capable	capaz
capably	habilmente
captivate	cautivar
captivating	cativante
carefree	despreocupado
cashback	cashback
cashbacks	cashbacks
catchy	pegadizo
celebrate	celebrar
celebrated	celebrado
celebration	celebración
celebratory	celebratoria
champ	campión
champion	campión
charisma	carisma
charismatic	carismático
charitable	caritativo
charm	encanto
charming	encantador
charmingly	encantadoramente
chaste	castas
cheer	animar
cheerful	alegre
cheery	alegre
cherish	apreciar
cherished	amado
cherub	querube
chic	chic
chivalrous	caballeresco
chivalry	cabalería
civility	civilidade
civilize	civilizar
clarity	claridade
classic	clásico
clean	limpar
cleaner	limpo
cleanliness	limpeza
cleanly	limpo
clear	claro
clear-cut	claro
cleared	borrado
clearly	claramente
clears	limpa
clever	intelixente
cleverly	intelixente
cohere	cohere
coherence	coherencia
coherent	coherente
cohesive	cohesionado
colorful	colorido
comely	comely
comfort	confort
comfortable	cómodo
comfortably	cómodamente
comforting	reconfortante
comfy	cómodo
commend	felicitar
commendable	encomiable
commendably	encomiable
commitment	compromiso
commodious	mercantil
compact	compacto
compactly	compacto
compassion	compaixón
compassionate	compasivo
compatible	compatible
competitive	competitivo
complement	complemento
complementary	complementaria
complemented	complementado
complements	complementos
compliant	compatible
compliment	felicitación
complimentary	gratis
comprehensive	completo
conciliate	conciliar
conciliatory	conciliador
concise	conciso
confidence	confianza
confident	confiado
congenial	congenial
congratulate	felicitar
congratulation	felicitación
congratulations	parabéns
congratulatory	felicitacións
conscientious	consciente
considerate	Grazas
consistent	consistente
constructive	construtivo
consummate	consumado
contentment	contento
continuity	continuidade
contrasty	contraste
contribution	contribución
convenience	conveniencia
convenient	conveniente
conveniently	convenientemente
convience	conveniencia
convienient	convienient
convient	convient
convincing	convincente
convincingly	convincentemente
cool	xenial
cooperative	cooperativa
cooperatively	cooperativamente
correct	correcto
correctly	correctamente
cost-effective	rendible
counter-attack	contraataque
counter-attacks	contraatacs
courage	coraxe
courageous	valente
courageousness	valentía
courteous	cortés
courtly	cortesano
covenant	pacto
cozy	acolledor
creative	creativo
credence	credencia
credible	credível
crisp	crujiente
crisper	criseiro
cure	cura
cushy	cushy
cute	lindo
cuteness	cuteness
danke	danke
danken	danken
daring	atrevido
daringly	audazmente
darling	Cariño
dashing	correndo
dauntless	incómodo
dawn	amanecer
dazzle	deslumbrante
dazzled	deslumbrado
dazzling	deslumbrante
dead-cheap	morto-barato
dead-on	morto-on
decency	decencia
decent	decente
decisive	decisivo
decisiveness	decisividade
dedicated	dedicado
defeat	derrota
defeated	derrotado
defeating	derrotando
defeats	derrotas
defender	defensor
deference	deferencia
deft	deft
deginified	deginificado
delectable	delectable
delicacy	delicadeza
delicate	delicado
delicious	delicioso
delight	pracer
delighted	encantado
delightful	delicioso
delightfully	deliciosamente
delightfulness	delicia
dependable	fiable
deservedly	merecido
deserving	merecedor
desirable	desexable
desiring	desexando
desirous	desexoso
destiny	destino
detachable	desmontable
devout	devoto
dexterous	Dexterous
dexterously	dexterosa
dextrous	dextroso
dignified	digno
dignify	dignificar
dignity	dignidade
diligence	dilixencia
diligent	dilixente
diligently	dilixente
diplomatic	diplomático
distinction	distinción
distinctive	distintivo
distinguished	distinguido
diversified	diversificado
divine	divina
divinely	divinamente
dominate	dominar
dominated	dominado
dominates	domina
dote	dote
dotingly	dotingly
dreamland	dreamland
dumbfounded	estúpido
dumbfounding	estúpido
durable	duradeiro
dynamic	dinámico
eager	ansioso
eagerly	ansiosamente
eagerness	ansia
earnest	serio
earnestly	sinceramente
earnestness	seriedade
ease	facilidade
eased	aliviado
eases	facilita
easiness	facilidade
easing	aliviar
easy	fácil
easygoing	fácil
ebullience	ebulencia
ebullient	exuberante
ebulliently	excesivamente
ecenomical	ecenómico
economical	económico
ecstasies	ecstasis
ecstasy	éxtase
ecstatic	extático
ecstatically	ecstaticamente
edify	edificar
educated	educado
effective	eficaz
effectively	efectivamente
effectiveness	efectividade
effectual	efectivo
efficacious	eficaz
efficient	eficiente
effusion	efusión
effusive	efusivo
effusively	efusivamente
effusiveness	effusiveness
elan	elan
elate	elate
elated	elated
elatedly	elatedly
elation	elación
electrify	electrificar
elegance	elegancia
elegant	elegante
elegantly	elegante
elevate	elevar
elite	elite
eloquence	elocuencia
eloquent	elocuente
embolden	embolden
eminence	eminencia
eminent	eminente
empathize	empatizar
empathy	empatía
empower	habilitar
empowerment	empoderamento
enchant	encantar
enchanted	encantada
enchanting	encantador
enchantingly	encantadoramente
encourage	animar
encouragement	alento
encouraging	alentador
encouragingly	alentadoramente
endear	endear
endearing	entrañable
endorse	apoiar
endorsed	aprobado
endorsement	endosso
endorses	apoia
endorsing	apoiando
energetic	enérxico
energize	energizar
engaging	enganándose
engrossing	engrossing
enhance	mellorar
enhanced	mellorado
enhancement	mellora
enhances	mellora
enjoy	gozar
enjoyable	agradable
enjoyably	agradablemente
enjoyed	gozado
enjoying	gozando
enjoyment	goce
enjoys	goza
enlighten	iluminar
enlightenment	iluminación
enliven	animar
ennoble	ennoble
enough	suficiente
enrapt	enraptar
enrapture	enraptura
enraptured	enraptura
enrich	enriquecer
enrichment	enriquecemento
enterprising	emprendedor
entertain	entreter
entertaining	entretido
entertains	entreter
enthral	fascinante
enthrall	fascinante
enthralled	fascinado
enthuse	entusiasmo
enthusiasm	entusiasmo
enthusiast	entusiasta
enthusiastic	entusiasmado
entice	atraer
enticed	seducido
enticing	tentador
enticingly	enticingly
entranced	entranced
entrancing	entrancing
entrust	encomendar
enviable	envexable
enviably	enviablemente
envious	envexoso
enviousness	envexa
envy	envexa
equitable	equitativo
ergonomical	ergonómico
erudite	erudito
ethical	ético
eulogize	eulogiar
euphoria	euforia
euphoric	eufórico
euphorically	eufóricamente
evaluative	evaluativo
evenly	uniformemente
eventful	asustado
everlasting	eterno
evocative	evocativo
exalt	exaltar
exaltation	exaltación
exalted	exaltado
exaltedly	exaltado
exalting	exaltación
exaltingly	exaltado
examplar	examplar
examplary	exame
excallent	excallente
exceed	exceder
exceeded	superado
exceeding	excedendo
exceedingly	excesivamente
exceeds	excede
excel	excel
exceled	Excelente
excelent	excelente
excellant	excelentes
excelled	sobresaíu
excellence	excelencia
excellency	excelencia
excellent	excelente
excellently	excelentemente
excels	sobresae
exceptional	excepcional
exceptionally	excepcionalmente
excite	excitar
excited	animado
excitedly	excitadamente
excitedness	excitación
excitement	emoción
excites	excita
exciting	apaixonante
excitingly	emocionante
exellent	exellent
exemplar	exemplar
exemplary	exemplar
exhilarate	estimular
exhilarating	emocionante
exhilaratingly	emocionante
exhilaration	exhilaration
exonerate	exonerar
expansive	expansivo
expertly	expertamente
exquisite	exquisito
exquisitely	exquisitamente
extol	exaltar
extoll	extoll
extraordinarily	extraordinariamente
extraordinary	extraordinario
exuberance	exuberancia
exuberant	exuberante
exuberantly	exuberante
exult	exultar
exultant	exultante
exultation	exultación
exultingly	exultante
eye-catching	atractivo
eyecatch	eyecatch
eyecatching	eyecatching
fabulous	fabuloso
fabulously	fabulosamente
facilitate	facilitar
fair	feria
fairly	bastante
fairness	equidade
faith	fe
faithful	fiel
faithfully	fielmente
faithfulness	fidelidade
fame	fama
famed	famoso
famous	famoso
famously	famoso
fancier	fancier
fancinating	fancinating
fancy	fantasía
fanfare	fanfarria
fans	fans
fantastic	fantástico
fantastically	fantásticamente
fascinate	fascinar
fascinating	fascinante
fascinatingly	fascinante
fascination	fascinación
fast	rápido
fast-paced	rápido
faultless	impecable
fav	fav
fave	fave
favor	favor
favorable	favorable
favored	favorecido
favorite	favorito
favorited	favorito
favour	favor
fearless	intrépido
feasible	factible
feasibly	factiblemente
feat	fazaña
fecilitous	fecilito
feisty	feisty
felicitate	felicitar
felicitous	felicitoso
felicity	felicidade
fertile	fértil
fervent	ferviente
fervently	fervorosamente
fervid	fervido
fervidly	fervidamente
fervor	fervor
festive	festivo
fidelity	fidelidade
fiery	ardente
fine	ben
finely	finamente
finest	mellor
flashy	brillo
flattering	lisonjeiro
flatteringly	lisonjemente
flawlessly	impecablemente
flexibility	flexibilidade
flexible	flexible
flourish	florecer
flourishing	floreciente
fluent	fluído
flutter	flutter
fond	afeccionado
fondness	cariño
foolproof	infalible
foresight	previsión
formidable	formidable
fortitude	fortaleza
fortunate	afortunado
fortunately	afortunadamente
fortune	fortuna
fragrant	perfumado
free	libre
freed	liberado
freedom	liberdade
freedoms	liberdades
fresh	fresco
friendliness	simpatía
friendly	amigable
frolic	parvo
frugal	frugal
fruitful	fecundo
ftw	ftw
fulfillment	cumprimento
fun	divertido
futurestic	futurista
futuristic	futurista
gaiety	alegría
gaily	alegremente
gain	ganancia
gained	gañou
gainful	remunerado
gaining	gañando
gains	ganancias
gallant	galante
gallantly	galantemente
galore	galore
geekier	geekier
geeky	geeky
gem	xoia
gems	xemas
generosity	xenerosidade
generous	xeneroso
generously	xenerosamente
genial	xenial
genius	xenio
gentle	amable
genuine	auténtico
gifted	dotados
glad	contento
gladden	alegre
gladness	alegría
glamorous	glamourosa
glee	alegre
gleeful	alegre
gleefully	alegremente
glimmer	brillo
glimmering	brillantes
glisten	glisten
glistening	brillo
glitter	brillo
glitz	glitz
glorify	glorificar
glorious	glorioso
gloriously	gloriosa
glory	gloria
glow	brillo
glowing	brillando
glowingly	brillo
godlike	Deus
godsend	godsend
gold	ouro
golden	dourado
good	bo
goodly	ben
goodness	bondade
goood	goood
gooood	gooood
gorgeous	precioso
gorgeously	fermoso
grace	graza
graceful	gracioso
gracefully	graciosamente
gracious	gracioso
graciously	graciosamente
graciousness	graza
grand	grandioso
grandeur	grandeza
grateful	agradecido
gratefully	agradecido
gratification	gratificação
gratified	satisfeito
gratifies	gratifica
gratify	gratificar
gratifying	gratificante
gratifyingly	gratificadamente
gratitude	gratitude
great	xenial
greatest	maior
greatness	grandeza
grin	sorriso
groundbreaking	innovador
guarantee	garantía
guidance	orientación
gumption	goma
gush	guspa
gusto	gusto
gutsy	gutsy
hail	saraiba
halcyon	halcyon
hale	Hale
hallmark	sello
hallmarks	marcadores
hallowed	santificado
handsome	fermoso
handsomely	xenerosamente
handy	práctico
happily	felizmente
happiness	felicidade
happy	feliz
hardy	resistente
harmless	inocuo
harmonious	harmonioso
harmoniously	harmoniosamente
harmonize	harmonizar
harmony	harmonía
headway	avanza
heal	curar
healthful	saludable
healthy	saudable
hearten	corazón
heartening	animando
heartfelt	sincero
heartwarming	ardente
heaven	ceo
heavenly	celestial
helped	axudou
helpful	útil
helping	axudando
hero	heroe
heroic	heroica
heroically	heroicamente
heroine	heroína
heroize	heroizar
heros	heros
hilarious	hilarante
holy	santo
homage	homenaxe
honest	honesto
honesty	honestidade
honor	honor
honorable	honorable
honored	honrado
honoring	honrar
hooray	hooray
hopeful	esperanzador
hospitable	hospitalario
hot	quente
hotcake	panquequeiro
hotcakes	panqueiques
hug	abrazo
humane	humano
humble	humilde
humility	humildad
humor	humor
humorous	humorístico
humour	humor
humourous	chistoso
ideal	ideal
idealize	idealizar
ideally	idealmente
idol	ídolo
idolize	idolatrar
idolized	idolatrado
idyllic	idílico
illuminate	iluminar
illuminati	iluminados
illuminating	iluminando
illumine	ilumine
illustrious	ilustre
ilu	ilu
imaculate	imacular
imaginative	imaginativo
immaculate	impecable
immaculately	inmaculadamente
immense	inmenso
impartial	imparcial
impartiality	imparcialidade
impartially	imparcialmente
impassioned	apasionado
impeccable	impecable
impeccably	impecablemente
important	importante
impress	impresionar
impressed	impresionado
impresses	impresiona
impressive	impresionante
impressively	impresionantes
impressiveness	Impresionismo
improve	mellorar
improved	mellorado
improvement	mellora
improvements	melloras
improves	mellora
improving	mellorando
incredible	incrible
incredibly	increíblemente
individualized	individualizado
indulgence	indulxencia
indulgent	indulgente
industrious	traballador
inestimable	inestimable
inestimably	inestimable
inexpensive	barato
infallibility	infalibilidade
infallible	infalible
infallibly	infaliblemente
influential	influente
ingenious	enxeñoso
ingeniously	ingeniosamente
ingenuity	enxeño
ingenuous	ingenuo
ingenuously	ingenuamente
innocuous	inocuo
innovation	innovación
innovative	innovador
inpressed	presionado
insightful	perspicaz
insightfully	insightfully
inspiration	inspiración
inspirational	inspirador
inspire	inspirar
inspiring	inspirador
instructive	instructivo
instrumental	instrumental
integral	integral
integrated	integrado
intelligence	intelixencia
intelligent	intelixente
intelligible	inteligible
interesting	interesante
interests	intereses
intimacy	intimidade
intimate	íntimo
intricate	intrincado
intrigue	intriga
intriguing	intrigante
intriguingly	intrigante
intuitive	intuitivo
invaluable	inestimable
invaluablely	invaluablemente
inventive	inventivo
invigorate	dinamizar
invigorating	revigorante
invincibility	invincibilidade
invincible	invencible
inviolable	inviolable
inviolate	inviolada
invulnerable	invulnerable
irreplaceable	irreemplazable
irreproachable	irreprochable
irresistible	irresistible
irresistibly	irresistiblemente
jollify	jollify
jolly	alegre
jovial	jovial
joy	alegría
joyful	alegre
joyfully	alegremente
joyous	alegre
joyously	alegremente
jubilant	jubilante
jubilantly	jubilosa
jubilate	xubilar
jubilation	xubilación
jubiliant	xubilante
judicious	prudente
justly	xustamente
keen	afiado
keenly	afablemente
keenness	agudeza
kindliness	bondade
kindly	xentilmente
kindness	bondade
knowledgeable	coñecedor
kudos	felicidades
laud	laud
laudable	loable
laudably	laudablemente
lavish	pródigo
lavishly	abundante
lawful	legal
lawfully	legalmente
lead	conducir
leading	líder
leads	conduce
lean	magra
led	LED
legendary	lendario
leverage	alavancagem
levity	liquidez
liberate	liberar
liberation	liberación
liberty	liberdade
lifesaver	salvavidas
light-hearted	alegre
likable	gustábel
like	como
liked	gustou
likes	gústalle
liking	gusto
lionhearted	lionhearted
lively	animado
logical	lóxico
long-lasting	duradeiro
lovable	amable
lovably	amable
love	amor
loved	amada
loveliness	beleza
lovely	precioso
lover	amante
loves	ama
loving	cariñoso
loyal	leal
loyalty	lealdade
lucid	lúcido
lucidly	lucidamente
luck	sorte
luckiness	sorte
lucky	sorte
lucrative	lucrativo
luminous	luminoso
lush	exuberante
luster	brillo
lustrous	lustroso
luxuriant	exuberante
luxuriate	luxuriate
luxurious	luxoso
luxury	luxo
lyrical	lírica
magic	maxia
magical	máxico
magnanimous	magnánimo
magnanimously	magnanimamente
magnificence	magnificencia
magnificent	magnífico
magnificently	magníficamente
majestic	majestuoso
majesty	majestad
manageable	manexable
maneuverable	maniobrable
marvel	marabilla
marveled	marabillado
marvelled	marabillado
marvellous	marabilloso
marvelous	marabilloso
marvelously	marabillosas
marvelousness	marabilloso
marvels	marabillas
master	amo
masterful	magistral
masterfully	magistralmente
masters	mestres
mastery	dominio
matchless	inigualable
mature	maduro
maturely	maduro
maturity	madurez
meaningful	significativo
memorable	memorable
merciful	misericordioso
mercifully	mercé
mercy	misericordia
merit	mérito
meritorious	meritorio
merrily	felices
merriment	alegría
merriness	merriness
merry	alegre
mesmerize	hipnotizar
mesmerized	hipnotizado
mesmerizes	hipnotiza
mesmerizing	fascinante
mesmerizingly	fascinante
meticulous	meticuloso
meticulously	meticulosamente
mightily	poderosamente
mighty	poderoso
mind-blowing	Alucinante
miracle	milagre
miracles	milagres
miraculous	milagroso
miraculously	milagrosamente
miraculousness	milagre
modern	moderno
modest	modesto
modesty	modestia
momentous	momentoso
monumental	monumental
monumentally	monumentalmente
morality	moralidade
motivated	motivado
multi-purpose	multiusos
navigable	navegable
neat	puro
neatly	perfectamente
nice	bonito
nicely	ben
nicer	mellor
nicest	mellor
nifty	nifty
nimble	áxil
noble	nobre
nobly	nobre
notably	notablemente
nourish	nutrir
nourishing	nutritivo
nourishment	alimento
novelty	novidade
nurturing	cariño
oasis	oasis
obsession	obsesión
obsessions	obsesións
obtainable	obtido
openly	abertamente
openness	apertura
optimal	óptimo
optimism	optimismo
optimistic	optimista
opulent	opulento
orderly	ordenada
originality	orixinalidade
outdo	outdo
outdone	outdone
outperform	superan
outperformed	superado
outperforming	superando
outperforms	supera
outshine	outshine
outshone	outshone
outsmart	superar
outstanding	destacado
outstandingly	notablemente
outstrip	superar
outwit	enganar
ovation	ovación
overjoyed	alegre
overtake	superar
overtaken	superado
overtakes	avanza
overtaking	avanzar
overtook	adiantou
overture	obertura
painless	indolora
palatial	palaciano
pamper	pamper
pampered	mimado
pamperedly	mimado
pamperedness	pamperedness
pampers	pampers
panoramic	panorámica
paradise	paraíso
paramount	primordial
pardon	perdón
passion	paixón
passionate	apaixonado
passionately	apaixonadamente
patience	paciencia
patient	paciente
patriot	patriota
patriotic	patriótico
peace	paz
peaceable	pacífica
peaceful	pacífico
peacekeepers	pacificadores
peach	melocotón
pep	pep
pepped	pepped
pepping	pepping
peppy	peppy
peps	peps
perfect	perfecto
perfection	perfección
perfectly	perfectamente
permissible	admisible
perseverance	perseveranza
persevere	perseverar
personages	personaxes
personalized	personalizado
phenomenal	fenomenal
phenomenally	fenomenalmente
picturesque	pintoresco
piety	piedade
pinnacle	pináculo
playful	juguetón
playfully	alegremente
pleasant	agradable
pleasantly	agradablemente
pleased	satisfeito
pleases	agrada
pleasing	agradable
pleasurable	placentero
pleasure	pracer
plentiful	abundante
pluses	vantaxes
plush	felpa
plusses	golpe
poetic	poético
poeticize	poetizar
poignant	poignante
poise	poise
poised	preparado
polished	pulido
polite	educado
politeness	cortesía
popular	popular
portable	portátil
posh	posh
positive	positivo
positives	positivos
powerful	poderoso
powerfully	poderosamente
praise	loanza
praiseworthy	louvável
praising	alabando
pre-eminent	preeminente
precious	precioso
precise	preciso
precisely	precisamente
preeminent	preeminente
prefer	prefire
preferable	preferible
preferably	preferiblemente
prefered	preferido
preferes	prefire
preferring	preferindo
prefers	prefire
premier	premier
prestige	prestixio
prestigious	prestixio
prettily	preciosa
pretty	bonita
priceless	inestimable
pride	orgullo
principled	principios
privilege	privilexio
privileged	privilexiado
prize	premio
proactive	proactivo
prodigious	prodixioso
prodigiously	prodixioso
prodigy	prodixio
productive	produtivo
productively	produtivamente
proficient	proficiente
profound	profundo
profoundly	profundamente
profuse	profundo
profusion	profusión
progress	progreso
progressive	progresivo
prolific	prolífico
prominence	prominencia
prominent	prominente
promise	promesa
promised	prometeu
promises	promete
promising	prometedor
promoter	promotor
prompt	prompt
promptly	inmediatamente
proper	bo
properly	correctamente
propitious	propicio
pros	pros
prosper	prosperar
prosperity	prosperidade
prosperous	próspero
prospros	prospros
protect	protexer
protection	protección
protective	protectora
proud	orgulloso
proven	comprobada
proves	proba
providence	providencia
proving	probando
prowess	proeza
prudence	prudencia
prudent	prudente
punctual	puntual
pure	puro
purify	purificar
purposeful	intencionado
quaint	pintoresco
qualified	cualificado
qualify	calificar
quiet	tranquila
radiance	brillo
radiant	radiante
rapid	rápido
rapport	informe
rapt	rapt
rapture	rapto
raptureous	raptos
raptureously	raptureously
rapturous	rapto
rapturously	rapturously
rational	racional
razor-sharp	afiado
reachable	accesible
readable	lexible
readily	facilmente
ready	listo
reaffirm	reafirmar
reaffirmation	reafirmación
realistic	realista
realizable	realizable
reasonable	razoable
reasonably	razonablemente
reasoned	razoado
reassurance	tranquilidade
reassure	tranquilizar
receptive	receptivo
reclaim	recuperar
recomend	recomend
recommend	recomendar
recommendation	recomendación
recommendations	recomendacións
recommended	recomendado
reconcile	reconciliar
reconciliation	reconciliación
recover	recuperar
recovery	recuperación
rectification	rectificación
rectify	rectificar
rectifying	rectificación
redeem	canjear
redeeming	rescatando
redemption	redención
refine	refinar
refined	refinado
refinement	refinamento
reform	reforma
reformed	reformado
reforming	reformar
reforms	reformas
refresh	actualizar
refreshed	actualizado
refreshing	refrescante
refund	reembolso
refunded	reembolsado
regal	regal
regally	regalmente
regard	respecto
rejoice	Alegre
rejoicing	alegrándose
rejoicingly	alegremente
rejuvenate	rexuvenecer
rejuvenated	rexuvenecido
rejuvenating	rexuvenecemento
relaxed	relaxado
relent	relent
reliable	fiable
relief	alivio
relish	saborear
remarkable	notable
remarkably	notablemente
remedy	remedio
remission	remisión
remunerate	remunerar
renaissance	Renacemento
renewed	renovado
renown	renombre
renowned	renombrado
replaceable	reemplazable
reputable	respectable
reputation	reputación
resilient	resistente
resolute	resoluto
resound	resonar
resounding	resonante
resourcefulness	enxeño
respect	respecto
respectable	respectable
respectful	respetuoso
respite	descanso
resplendent	resplandeciente
responsibly	responsablemente
responsive	sensible
restful	tranquilo
restored	restaurado
restructure	reestruturar
restructured	reestructurado
restructuring	reestruturación
retractable	retráctil
revel	revelar
revelation	revelación
revere	revere
reverence	reverencia
reverent	reverente
reverently	reverentemente
revitalize	revitalizar
revival	renacemento
revive	revivir
revives	revive
revolutionary	revolucionaria
revolutionize	revolucionar
revolutionized	revolucionou
revolutionizes	revoluciona
reward	recompensa
rewarding	gratificante
rewardingly	gratificante
rich	rico
richly	ricamente
richness	riqueza
right	ben
righten	dereito
righteous	xusto
righteously	xustamente
righteousness	xustiza
rightful	legítimo
rightness	rectitude
robust	robusto
rockstar	rockstar
rockstars	rockstars
romantic	romántico
romantically	románticamente
romanticize	romanticizar
roomy	espazos
rosy	rosado
safe	seguro
sagacity	sagacidade
sagely	sagamente
saint	santo
saintliness	santidade
saintly	santo
salutary	saludable
salute	saúde
sane	ben
satisfactorily	satisfactoriamente
satisfactory	satisfactorio
satisfied	satisfeito
satisfies	satisfai
satisfy	satisfacer
satisfying	satisfacer
satisified	Satisfeito
saver	aforro
savings	aforro
savior	salvador
savvy	intelixente
scenic	escénico
seamless	inconsútil
seasoned	temperado
secure	seguro
selective	selectivo
self-determination	autodeterminación
self-respect	auto-respecto
self-satisfaction	auto-satisfacción
self-sufficiency	autosuficiencia
self-sufficient	autosuficiente
sensation	sensación
sensational	sensacional
sensationally	sensacionalmente
sensations	sensacións
sensible	sensible
sensibly	sensiblemente
sensitive	sensible
serene	sereno
serenity	serenidade
sexy	sexy
sharp	agudo
shimmering	brillo
shimmeringly	brillo
shine	brillo
shiny	brillante
significant	significativo
silent	silencioso
simplified	simplificado
simplifies	simplifica
simplify	simplificar
simplifying	simplificando
sincere	sincero
sincerely	sinceramente
sincerity	sinceridade
skill	habilidade
skilled	expertos
skillful	hábil
skillfully	habilmente
slammin	slammin
sleek	elegante
slick	lixeira
smart	intelixente
smartly	intelixente
smile	sorriso
smiles	sorrisos
smiling	sorrindo
smilingly	sonriente
smitten	ferido
smooth	suave
smoothes	suaviza
snappy	arrebatado
snazzy	snazzy
sociable	sociable
soft	suave
solace	consuelo
solicitous	solicitante
solicitously	solicitadamente
solid	sólido
solidarity	solidariedade
soothe	calmar
soothingly	tranquilamente
sophisticated	sofisticado
soulful	alma
soundly	profundamente
soundness	solidez
spacious	espazos
sparkle	brillo
sparkling	espumante
spectacular	espectacular
spectacularly	espectacularmente
speedily	rapidamente
speedy	rápido
spellbind	valentão
spellbinding	fascinante
spellbindingly	fascinante
spellbound	hechizado
spirited	espírito
spiritual	espiritual
splendid	espléndido
splendidly	esplendidamente
splendor	esplendor
spontaneous	espontáneo
sporty	deportivo
spotless	impecable
stability	estabilidade
stabilize	estabilizar
stable	estable
stainless	inoxidable
standout	destacar
state-of-the-art	estado-da-arte
stately	señorial
statuesque	estatuasco
staunch	firme
staunchly	agresivamente
staunchness	estabilidade
steadfast	firme
steadfastly	firme
steadfastness	firmeza
steadiness	firmeza
steady	constante
stellar	estelar
stellarly	estelar
stimulate	estimular
stimulates	estimula
stimulating	estimulante
stimulative	estimulante
straighten	endereitarse
straightforward	sinxelo
streamlined	racionalizado
striking	sorprendente
strikingly	sorprendentemente
striving	esforzándose
strong	forte
stunned	sorprendido
stunning	impresionante
stunningly	asombrosamente
stupendous	estupendo
stupendously	estupendo
sturdy	resistente
stylish	elegante
stylishly	elegante
stylized	estilizado
suave	suave
suavely	suavemente
sublime	sublime
subsidize	subvencionar
subsidized	subvencionado
subsidizes	subvenciona
subsidizing	subvencionar
substantive	substantivo
succeeded	conseguiu
succeeding	seguindo
succeeds	éxito
succes	éxito
success	éxito
successes	éxitos
successful	exitoso
suffice	suficiente
sufficed	suficiente
sufficient	suficiente
sufficiently	suficientemente
suitable	apto
sumptuous	suntuoso
sumptuously	sumptuosamente
sumptuousness	sumptuosidade
super	super
superb	excelente
superbly	excelentemente
superior	superior
superiority	superioridade
supple	flexible
support	soporte
supported	apoiado
supporter	partidario
supporting	apoio
supportive	solidario
supports	soportes
supremacy	supremacía
supreme	supremo
supremely	supremamente
supurb	Supurb
supurbly	supurbly
surmount	superar
surpass	superar
surreal	surrealista
survival	supervivencia
survivor	sobrevivente
sustainability	sostenibilidade
sustainable	sostenible
swank	swank
swankier	swankier
swankiest	swankiest
swanky	swanky
sweeping	varrendo
sweet	doce
sweeten	endulzar
sweetheart	cariño
sweetly	doce
sweetness	dozura
swift	rápido
swiftness	rapidez
talent	talento
talented	talentoso
talents	talentos
tantalize	tantalizar
tantalizing	tentador
tantalizingly	tantalizando
tempt	tentar
tempting	tentador
temptingly	tentadoramente
tenacious	tenaz
tenaciously	tenazmente
tenacity	tenacidade
tender	concurso
tenderly	tiernamente
terrific	fantástico
terrifically	terriblemente
thank	grazas
thankful	agradecido
thoughtful	reflexivo
thoughtfully	pensativo
thoughtfulness	reflexividade
thrift	Ahorro
thrifty	afable
thrill	emoción
thrilled	emocionado
thrilling	emocionante
thrillingly	emocionante
thrills	emocións
thrive	prosperar
thriving	prosperando
thumb-up	thumb-up
thumbs-up	pulgar-up
tickle	cóxegas
tidy	ordenado
timely	oportuna
tingle	tingle
titillate	titilar
titillating	titilar
titillatingly	titillatingly
togetherness	unión
tolerable	tolerable
top	arriba
top-notch	top-notch
topnotch	topnotch
tops	tops
tough	duro
traction	tracción
tranquil	tranquilo
tranquility	tranquilidade
transparent	transparente
treasure	tesouro
tremendously	tremendamente
triumph	triunfo
triumphal	triunfal
triumphant	triunfante
triumphantly	triunfante
trivially	trivialmente
trophy	trofeo
trump	triunfo
trumpet	trompeta
trust	confianza
trusted	fiable
trusting	confiando
trustworthiness	confiabilidade
trusty	confiado
truthful	veraz
truthfulness	veracidade
twinkly	centelleante
ultra-crisp	ultra-crujiente
unassailable	inatacable
unbeatable	imbatible
unbiased	imparcial
unconditional	incondicional
understandable	comprensible
undisputable	indiscutible
undisputably	indiscutiblemente
undisputed	indiscutible
unequivocal	inequívoco
unequivocally	inequívocamente
unforgettable	inesquecible
unity	unidade
unlimited	ilimitado
unmatched	inigualable
unparalleled	inigualable
unquestionable	indiscutible
unreal	irreal
unrivaled	inigualable
unselfish	desinteresado
unwavering	inquebrantable
upbeat	optimista
upgradable	actualizable
upgradeable	actualizable
upgraded	actualizado
upheld	confirmado
uphold	manter
uplift	elevación
uplifting	edificante
upliftingly	ergonamente
upliftment	elevación
upscale	exclusivo
usable	usable
useable	usable
useful	útil
user-friendly	amigable
valiant	valeroso
valiantly	valientemente
valor	valor
valuable	valioso
variety	variedade
venerate	venerar
verifiable	verificable
veritable	verdadeiro
versatile	versátil
versatility	versatilidade
vibrant	vibrante
vibrantly	vibrante
victorious	victorioso
victory	vitoria
viewable	visible
vigilance	vixilancia
vigilant	vigilante
virtue	virtude
virtuous	virtuoso
virtuously	virtuosamente
visionary	visionario
vivacious	vivaz
vivid	vívido
vouch	vouch
vouchsafe	vouchsafe
warm	cálido
warmhearted	cálido
warmly	cariñosamente
warmth	calor
wealthy	ricos
welcome	benvidos
well	ben
well-being	benestar
wellbeing	benestar
whoa	whoa
wholesome	saudable
whooa	quenoa
whoooa	whoooa
wieldy	empatado
willing	disposto
willingness	vontade
win	gañar
windfall	inesperado
winnable	winnable
winner	ganador
winners	ganadores
winning	gañar
wins	gaña
wisdom	sabedoría
wise	sabio
wisely	sabiamente
witty	ingenioso
won	gañou
wonder	marabilla
wonderful	marabilloso
wonderfully	marabillosas
wonderous	marabilloso
wonderously	marabillosas
wonders	marabillas
wondrous	marabilloso
woo	woo
work	traballo
workable	viable
worked	funcionou
works	obras
world-famous	famoso
worth-while	valioso
worthiness	dignidade
worthy	digno
wow	wow
wowed	wowed
wowing	wowing
wows	wows
yay	xa
youthful	xuvenil
zeal	celo
zenith	cenit
zest	ronquido
zippy	zippy
abnormal	anormal
abolish	abolir
abominable	abominable
abominably	abominablemente
abominate	abominar
abomination	abominación
abort	abortar
aborted	cancelado
aborts	aborts
abrade	abrade
abrasive	abrasivo
abrupt	brusco
abruptly	bruscamente
abscond	abscond
absence	ausencia
absentee	ausente
absurd	absurdo
absurdity	absurdo
absurdly	absurdamente
absurdness	absurdo
abuse	abuso
abused	maltratado
abuses	abusos
abusive	abusivo
abysmal	abismal
abysmally	abismalmente
abyss	abismo
accidental	accidental
accost	Acordo
accursed	maldito
accusation	acusación
accusations	acusacións
accuse	acusar
accuses	acusa
accusing	acusando
acerbate	acerbate
acerbic	acerbic
acerbically	acerbicamente
ache	dor
ached	afligido
aches	dor
achey	achey
aching	dolorido
acrid	acrid
acridly	acridly
acridness	acridness
acrimonious	acrimonious
acrimoniously	acrimoniously
acrimony	acrimony
adamant	firme
adamantly	firme
addict	adicto
addicted	adicto
addicting	adictivo
addicts	adictos
admonish	adormecer
admonisher	admonitor
admonishingly	admonitora
admonishment	admonición
admonition	admonición
adulterate	adulterado
adulterated	adulterado
adulteration	adulteración
adulterier	adulterio
adversarial	adversariedade
adversary	adversario
adverse	adverso
adversity	adversidade
afflict	afligido
affliction	aflición
afflictive	aflixente
affront	afrontamento
afraid	temer
aggravate	agravar
aggravating	agravante
aggravation	agravamento
aggression	agresión
aggressive	agresivo
aggressiveness	agresividade
aggressor	agresor
aggrieve	agravar
aggrieved	agraviado
aggrivation	agresión
aghast	aghast
agonies	agonías
agonize	agonizar
agonizing	agonizante
agonizingly	agonizante
agony	agonía
aground	encallado
ail	ail
ailing	enfermo
ailment	enfermidade
alarm	alarma
alarmed	alarmado
alarming	alarmante
alarmingly	alarmante
alienate	alienar
alienated	alienado
alienation	alienación
allegation	alegación
allegations	alegacións
allege	alegar
allergic	alérxica
allergies	alerxias
allergy	alerxia
aloof	aloof
altercation	altercado
ambiguity	ambigüidade
ambiguous	Ambiguo
ambivalence	ambivalencia
ambivalent	ambivalente
ambush	emboscada
amiss	mal
amputate	amputar
anarchism	anarquismo
anarchist	anarquista
anarchistic	anarquista
anarchy	anarquía
anemic	anémico
anger	rabia
angrily	enojado
angriness	angustia
angry	enojado
anguish	angustia
animosity	animosidade
annihilate	aniquilar
annihilation	aniquilación
annoy	molestar
annoyance	aborrecemento
annoyances	molestias
annoyed	molesto
annoying	molesto
annoyingly	irritante
annoys	molesta
anomalous	anómalo
anomaly	anomalía
antagonism	antagonismo
antagonist	antagonista
antagonistic	antagónico
antagonize	antagonizar
anti-	anti-
anti-american	antiamericanos
anti-israeli	anti-israelí
anti-occupation	anti-ocupación
anti-proliferation	anti-proliferación
anti-semites	antisemitas
anti-social	antisocial
anti-us	anti-us
anti-white	anti-branco
antipathy	antipatía
antiquated	anticuado
antithetical	antitético
anxieties	ansiedades
anxiety	ansiedade
anxious	ansioso
anxiously	ansiosamente
anxiousness	ansiedade
apathetic	apático
apathetically	apaticamente
apathy	apatía
apocalypse	apocalipse
apocalyptic	apocalíptico
apologist	apologista
apologists	apoloxistas
appal	appal
appall	appall
appalled	asustado
appalling	aterrador
appallingly	terriblemente
apprehension	aprehensión
apprehensions	aprensións
apprehensive	aprensivo
apprehensively	aprensivamente
arbitrary	arbitrario
arcane	arcano
archaic	arcaico
arduous	arduo
arduously	arduamente
argumentative	argumentativo
arrogance	arrogancia
arrogant	arrogante
arrogantly	arrogantemente
ashamed	avergoñado
asinine	asinina
asininely	asininamente
asinininity	asininidade
askance	askance
asperse	aspirar
aspersion	aspersión
aspersions	aspersións
assail	asaltar
assassin	asasino
assassinate	asasinar
assault	asalto
assult	Asulto
astray	desviarse
asunder	asunder
atrocious	atroz
atrocities	atrocidades
atrocity	atrocidade
atrophy	atrofia
attack	ataque
attacks	ataques
audacious	audaz
audaciously	audazmente
audaciousness	audacia
audacity	audacia
audiciously	auditivo
austere	austero
authoritarian	autoritario
autocrat	autócrata
autocratic	autocrático
avalanche	avalancha
avarice	avaricia
avaricious	avaricioso
avariciously	avariamente
avenge	vingar
averse	averse
aversion	aversión
aweful	sorprendente
awful	horrible
awfully	terriblemente
awfulness	horrible
awkward	incómodo
awkwardness	incómoda
ax	hacha
babble	babble
back-woods	bosqueiros
backaches	dorsos
backaching	backaching
backbite	backbite
backbiting	backbiting
backwardness	atraso
backwoods	refuxios
bad	malo
badly	mal
baffle	deflector
baffled	desconcertante
bafflement	desconcertante
baffling	desconcertante
bait	isca
balk	Balk
banal	banal
banalize	banalizar
bane	bane
banish	desterrar
banishment	desterro
barbarian	bárbaro
barbaric	bárbaro
barbarically	barbaramente
barbarity	barbaridade
barbarous	bárbaro
barbarously	barbaramente
barren	árido
bash	bash
bashed	bashed
bashful	asustado
bashing	golpeando
bastard	bastardo
bastards	bastardos
battered	maltratado
battering	bater
batty	batty
bearish	baixista
beastly	beastly
bedlam	bedlam
bedlamite	bedlamite
befoul	befoul
beg	pedir
beggar	mendigo
beggarly	mendigo
begging	pedindo
beguile	ollar
belabor	belabor
belated	tardío
beleaguer	beleaguer
belie	belie
belittled	belittled
belittling	menosprezante
bellicose	belicosa
belligerence	belixerancia
belligerent	belixerante
belligerently	beligerante
bemoan	bemoan
bemoaning	lamentando
bemused	bemused
bent	dobrado
berate	berate
bereave	marido
bereavement	duelo
bereft	ausente
berserk	irritado
beseech	ruego
beset	asediado
besiege	asediar
besmirch	besmirch
bestial	bestial
betray	traizoar
betrayal	traizón
betrayals	traizóns
betrayer	traidor
betraying	traizoando
betrays	traizoa
bewail	bewail
beware	coidado
bewilder	desconcertante
bewildered	desconcertado
bewildering	desconcertante
bewilderingly	desconcertante
bewilderment	desconcertante
bewitch	bewitch
bias	sesgo
biased	tendenciosa
biases	prejuicios
bicker	bicker
bickering	discutindo
bigotries	fanatismos
bigotry	fanatismo
bitch	puta
bitchy	puta
biting	morder
bitingly	mordaz
bitter	amargo
bitterly	amargamente
bitterness	amargura
bizarre	bizarro
blab	blab
blabber	blabber
blackmail	chantaxe
blah	bla
blame	culpa
bland	sosa
blandish	descarado
blaspheme	blasfemar
blasphemous	blasfemo
blasphemy	blasfemia
blasted	golpeado
blatant	flagrante
blatantly	descaradamente
blather	blather
bleak	sombrío
bleakly	sombrío
bleakness	desangrada
bleed	sangrar
bleeding	hemorragia
bleeds	sangra
blemish	mancha
blind	cego
blinding	cego
blindingly	blindingly
blindside	cego
blister	blister
blistering	ampollas
bloated	inchada
blockage	bloqueo
blockhead	bloqueo
bloodthirsty	sanguinario
bloody	sanguento
blotchy	manchada
blow	golpe
blunder	erro
blundering	blundering
blunders	erro
blunt	contundente
blur	borrão
bluring	borrándose
blurred	borrosa
blurring	borrándose
blurry	borroso
blurs	borros
blurt	blurt
boastful	boastful
boggle	boggle
bogus	falso
boil	ferver
boiling	fervendo
boisterous	bullicioso
bomb	bomba
bombard	bombard
bombardment	bombardeo
bombastic	bombastic
bondage	bondage
bonkers	bonkers
bore	aberto
bored	aburrido
boredom	aburrimiento
bores	ánimas
boring	aburrido
botch	botch
bother	molestar
bothered	molestado
bothering	molestando
bothers	molesta
bothersome	molesto
bowdlerize	arredorizar
boycott	boicot
braggart	braggart
bragger	bragger
brash	brash
brashly	brincamente
brashness	brincadeira
brat	Brat
bravado	bravo
brazen	descarado
brazenly	descaradamente
brazenness	descarada
breach	infracción
break	romper
break-up	romper
break-ups	break-ups
breakdown	avaría
breaking	rompendo
breaks	pausas
breakup	romper
breakups	rupturas
bribery	suborno
brimstone	xofre
bristle	cerda
brittle	quebradizo
broke	rompeu
broken	roto
brood	cría
browbeat	browbeat
bruise	contusão
bruised	machucado
bruises	contusións
bruising	magulladuras
brusque	brusco
brutal	brutal
brutalising	brutalizando
brutalities	brutalidades
brutality	brutalidade
brutalize	brutalizar
brutalizing	brutalizando
brutally	brutalmente
brute	bruto
brutish	brutal
bs	bs
buckle	fivela
bug	erro
bugging	molestando
buggy	buggy
bugs	erros
bulkiness	voluminidade
bulky	voluminoso
bulkyness	voluminosa
bullies	matones
bullshit	mordisco
bullshyt	bochornoso
bully	bully
bullying	bullying
bullyingly	bullyingly
bum	bum
bump	golpe
bumped	golpeado
bumping	golpear
bumpping	bumpa
bumps	bumps
bumpy	golpeado
bungle	bungle
bungler	bungler
bungling	agarrado
bunk	litera
burden	carga
burdensome	caro
burdensomely	carente
burn	queimar
burned	queimado
burning	queima
burns	queimaduras
bust	busto
busts	bustos
busybody	ocupado
butcher	carniceiro
butchery	carnicería
buzzing	zumbido
byzantine	bizantino
cackle	cackle
calamities	calamidades
calamitous	calamitoso
calamitously	calamitamente
calamity	calamidade
callous	calloso
calumniate	calumniar
calumniation	calumnia
calumnies	calumnias
calumnious	calumnioso
calumniously	calumniosamente
calumny	calumnia
cancer	cancro
cancerous	canceroso
cannibal	caníbal
cannibalize	canibalizar
capitulate	capitular
capricious	caprichoso
capriciously	caprichosamente
capriciousness	caprichosa
capsize	capsize
careless	descoidado
carelessness	descoido
caricature	caricatura
carnage	carnicería
carp	carpa
cartoonish	cartoonish
castigate	castigar
castrated	castrado
casualty	baixa
cataclysm	cataclismo
cataclysmal	cataclismo
cataclysmic	cataclísmico
cataclysmically	cataclísmicamente
catastrophe	catástrofe
catastrophes	catástrofes
catastrophic	catastrófico
catastrophically	catastróficamente
catastrophies	catástrofes
caustic	cáustica
caustically	causticamente
cautionary	cauteloso
cave	cova
censure	censura
chafe	chafe
chaff	palla
chagrin	chagrin
challenging	desafiante
chaos	caos
chaotic	caótico
chasten	chaste
chastise	castigar
chastisement	castigo
chatter	chatter
chatterbox	chatterbox
cheap	barato
cheapen	barato
cheat	enganar
cheated	enganado
cheater	tramposo
cheating	trampa
cheats	trampas
cheerless	alegre
cheesy	cursi
chide	chide
childish	infantil
chill	chill
chilly	frío
chintzy	chintzy
choke	choke
choleric	colérico
choppy	choppy
chore	chore
chronic	crónica
chunky	chunky
clamor	clamor
clamorous	clamoroso
clash	choque
cliche	cliché
cliched	cliched
clique	clique
clog	bloquear
clogged	obstruído
clogs	esclops
cloud	nube
clouding	nubes
cloudy	nublado
clueless	despistado
clumsy	torpe
clunky	clunky
coarse	groseiro
cocky	enojado
coerce	coerce
coercion	coerción
coercive	coercitivo
cold	frío
coldly	fríamente
collapse	colapso
collude	enojado
collusion	colusión
combative	combativo
combust	combust
comical	cómico
commiserate	cometer
commonplace	común
commotion	conmoción
commotions	conmocións
complacent	complacente
complain	queixarse
complained	queixouse
complaining	queixándose
complains	quéixase
complaint	denuncia
complaints	denuncias
complex	complexo
complicated	complicado
complication	complicación
complicit	cómplice
compulsion	compulsión
compulsive	compulsivo
concede	conceder
conceded	concedido
conceit	presunción
conceited	presumido
concen	concen
concens	concens
concern	preocupación
concerned	preocupado
concerns	preocupacións
concession	concesión
concessions	concesións
condemn	condenar
condemnable	condenable
condemnation	condena
condemned	condenado
condemns	condena
condescend	condescend
condescending	condescendiente
condescension	condescensión
confess	confesar
confession	confesión
confessions	confesións
confined	confinado
conflict	conflito
conflicting	conflito
conflicts	conflitos
confound	confundir
confounded	confundido
confounding	confundindo
confront	confrontar
confrontation	confrontación
confrontational	confrontación
confuse	confundir
confused	confundido
confuses	confunde
confusing	confuso
confusion	confusión
confusions	confusións
congested	congestionado
congestion	atasco
cons	contra
conscons	Conscons
conservative	conservador
conspicuous	conspicuo
conspicuously	conspicuamente
conspiracies	conspiracións
conspiracy	conspiración
conspirator	conspirador
conspiratorial	conspirador
conspire	conspirar
consternation	consternación
contagious	contaxioso
contaminate	contaminar
contaminated	contaminado
contaminates	Contamina
contaminating	contaminando
contamination	contaminación
contempt	desprezo
contemptible	despreciable
contemptuous	despectivo
contemptuously	despectivamente
contend	contender
contention	contención
contentious	controvertido
contort	contort
contortions	contorções
contradict	contradicen
contradiction	contradición
contradictory	contraditoria
contrariness	contraria
contravene	infrinxir
contrive	contrive
contrived	ideado
controversial	controvertido
controversy	controversia
convoluted	complicado
corrode	corroído
corrosion	corrosión
corrosions	corrosións
corrosive	corrosivo
corrupt	corrupto
corrupted	corrompido
corrupting	corromper
corruption	corrupción
corrupts	corrompe
corruptted	corrompido
costly	caro
counter-productive	contraproducente
counterproductive	contraproducente
coupists	copistas
covetous	voraz
coward	cobarde
cowardly	cobarde
crabby	crabby
crack	crack
cracked	cracked
cracks	rachaduras
craftily	craftily
craftly	artesanalmente
crafty	astuto
cramp	calambre
cramped	axustado
cramping	calambres
cranky	irritante
crap	merda
crappy	malvado
craps	craps
crash	falla
crashed	caeu
crashes	falla
crashing	caer
crass	crass
craven	craven
cravenly	cravenly
craze	mania
crazily	cariñosamente
craziness	tolemia
crazy	tolo
creak	cala
creaking	crujido
creaks	creaks
credulous	creduloso
creep	creep
creeping	arrastrándose
creeps	arrastra
creepy	asustado
crept	arrastrou
crime	delito
criminal	criminal
cringe	cringe
cringed	cringed
cringes	cringes
cripple	paralizar
crippled	paralizado
cripples	aleijado
crippling	paralizando
crisis	crise
critic	crítico
critical	crítico
criticism	críticas
criticisms	críticas
criticize	criticar
criticized	criticado
criticizing	criticando
critics	críticos
cronyism	cronismo
crook	ladrón
crooked	tortuoso
crooks	bandidos
crowded	abarrotado
crowdedness	multitude
crude	cru
cruel	cruel
crueler	cruel
cruelly	cruelmente
cruelness	crueldade
cruelties	crueldades
cruelty	crueldade
crumble	romper
crumbling	desmoronándose
crummy	cruel
crumple	romper
crumpled	arrugar
crush	esmagar
crushed	esmagado
crushing	esmagamento
cry	chorar
culpable	culpable
culprit	culpable
cumbersome	engorroso
cunt	coño
cunts	cunts
cuplrit	cuplrit
curse	maldición
cursed	maldito
curses	maldicións
curt	curt
cuss	cuss
cussed	cussed
cutthroat	cortadura
cynical	cínico
cynicism	cinismo
damage	danos
damaged	mal
damages	danos
damaging	dañino
damn	maldición
damnable	damnable
damnably	Damnably
damnation	condenación
damned	condenado
damning	damning
damper	amortecedor
danger	perigo
dangerous	perigoso
dangerousness	perigosidade
dark	escuro
darken	escurecer
darkened	ensombrecido
darkness	escuridade
dastard	dastard
dastardly	dastardly
daunt	demora
daunting	asustado
dauntingly	asustado
dawdle	dawdle
daze	aturdido
dazed	aturdido
dead	morto
deadlock	bloqueo
deadly	mortal
deaf	xordos
dearth	escaseza
death	morte
debacle	debacle
debase	desconsiderar
debasement	degradación
debaser	debaser
debatable	discutible
debauch	debauch
debaucher	debaucher
debauchery	despedida
debilitate	debilitar
debilitating	debilitante
debility	debilidade
debt	débeda
debts	débedas
decadence	decadencia
decadent	decadente
decay	decadencia
decayed	decaído
deceit	engano
deceitful	enganoso
deceitfully	engañosa
deceitfulness	engano
deceive	engañar
deceiver	engañador
deceivers	enganadores
deceiving	enganar
deception	decepción
deceptive	engañoso
deceptively	engañosamente
declaim	decláim
decline	descenso
declines	declina
declining	diminuíndo
decrement	diminución
decrepit	decrépito
decrepitude	decrepitude
decry	decry
defamation	difamación
defamations	defamacións
defamatory	difamatorio
defame	difamar
defect	defecto
defective	defectuoso
defects	defectos
defensive	defensiva
defiance	desafío
defiant	desafiante
defiantly	desafiante
deficiencies	deficiencias
deficiency	deficiencia
deficient	deficiente
defile	contaminar
defiler	defiler
deform	deformar
deformed	deforme
defrauding	defraudar
defunct	desaparecido
defy	desafiar
degenerate	dexenerar
degenerately	degeneradamente
degeneration	dexeneración
degradation	degradación
degrade	degradar
degrading	degradante
degradingly	degradante
dehumanization	deshumanización
dehumanize	deshumanizar
deign	dignar
deject	expulsar
dejected	expulsado
dejectedly	desagradable
dejection	dexección
delay	atraso
delayed	atrasado
delaying	retrasar
delays	demoras
delinquency	delincuencia
delinquent	delincuente
delirious	delirante
delirium	delirio
delude	delude
deluded	engañado
deluge	diluvio
delusion	ilusión
delusional	delirante
delusions	delirios
demean	demean
demeaning	degradación
demise	desaparición
demolish	demoler
demolisher	demoledor
demon	demo
demonic	demoníaco
demonize	demonizar
demonized	demonizado
demonizes	demoniza
demonizing	demonizando
demoralize	desmoralizar
demoralizing	desmoralizante
demoralizingly	desmoralizadoramente
denial	negación
denied	negado
denies	nega
denigrate	denigrar
denounce	denunciar
dense	denso
dent	dent
dented	dentado
dents	dentes
denunciate	denunciar
denunciation	denuncia
denunciations	denuncias
deny	negar
denying	negando
deplete	esgotar
deplorable	deplorable
deplorably	deplorabilidade
deplore	deplorar
deploring	deplorando
deploringly	deplorando
deprave	deprave
depraved	depravado
depravedly	depravado
deprecate	desamparado
depress	deprimir
depressed	deprimido
depressing	depriment
depressingly	deprimentemente
depression	depresión
depressions	depresións
deprive	privar
deprived	privado
deride	deride
derision	burla
derisive	derisivo
derisively	derisivamente
derisiveness	desprezo
derogatory	despectivo
desecrate	desecrate
desert	deserto
desertion	deserción
desiccate	secar
desiccated	desecado
desititute	desesperado
desolate	desolado
desolately	desolado
desolation	desolación
despair	desesperación
despairing	desesperado
despairingly	desesperadamente
desperate	desesperado
desperately	desesperadamente
desperation	desesperación
despicable	despreciable
despicably	despreciable
despise	desprezar
despised	desprezado
despoil	despoilo
despoiler	Despoilador
despondence	desanimación
despondency	desanimación
despondent	despedido
despondently	despoxadamente
despot	déspota
despotic	despótico
despotism	despotismo
destabilisation	desestabilización
destains	descansa
destitute	indigente
destitution	destitución
destroy	destruír
destroyer	destructor
destruction	destrución
destructive	destrutivo
desultory	desultory
deter	deter
deteriorate	deteriorar
deteriorating	deteriorándose
deterioration	deterioración
deterrent	disuasivo
detest	detestar
detestable	detestable
detestably	detestablemente
detested	detestada
detesting	detestando
detests	detesta
detract	detraer
detracted	detrás
detracting	detraer
detraction	detracción
detracts	detrae
detrimental	perjudicial
devastate	arrasar
devastated	devastada
devastates	arrasa
devastating	devastador
devastatingly	devastadoramente
devastation	devastación
deviate	desviarse
deviation	desviación
devil	diaño
devilish	diabólico
devilishly	diabólicamente
devilment	devilment
devilry	diaño
devious	devious
deviously	deviously
deviousness	devoción
devoid	desprovisto
diabolic	diabólico
diabolical	diabólico
diabolically	diabólicamente
diametrically	diametralmente
diappointed	diappointed
diatribe	diatribe
diatribes	diatribas
dick	pau
dictator	ditador
dictatorial	dictatorial
die	morrer
died	morreu
dies	morre
difficult	difícil
difficulties	dificultades
difficulty	dificultade
diffidence	dificultade
dilemma	dilema
dilly-dally	dilly-dally
dim	dim
dimmer	dimmer
din	din
ding	ding
dings	dings
dinky	dinky
dire	dire
direly	direly
direness	esposa
dirt	lixo
dirtbag	dirtbag
dirtbags	dirtbags
dirts	dirts
dirty	sucio
disable	desactivar
disabled	desactivado
disaccord	desacordo
disadvantage	desvantaxe
disadvantaged	desfavorecidos
disadvantageous	desventajoso
disadvantages	desvantaxes
disaffect	descontento
disaffected	descontento
disaffirm	desafirmar
disagree	desacordo
disagreeable	desagradable
disagreeably	desagradable
disagreeing	desacordo
disagreement	desacordo
disapointed	decepcionado
disapointing	decepcionante
disapointment	decepción
disappoint	decepcionar
disappointed	decepcionado
disappointing	decepcionante
disappointingly	decepcionante
disappointment	decepción
disappointments	decepcións
disappoints	decepciona
disapprobation	desaprobación
disapproval	desaprobación
disapprove	desaprobar
disapproving	desaprobando
disarm	desarmar
disarray	desorde
disaster	desastre
disasterous	desastroso
disastrous	desastroso
disastrously	desastrosamente
disavow	desestimar
disavowal	desestimación
disbelief	incredulidade
disbeliever	incríbel
disclaim	negar
discombobulate	descombobular
discomfit	discomfit
discomfititure	descomfititure
discomfort	incomodidade
discompose	descompúxose
disconcert	desconcertar
disconcerted	desconcertado
disconcerting	desconcertante
disconcertingly	desconcertante
disconsolate	desconsolado
disconsolately	desconsolado
disconsolation	desconsolación
discontent	descontento
discontented	descontento
discontentedly	descontento
discontinued	descontinuado
discontinuity	discontinuidade
discontinuous	discontinuo
discord	discordia
discordance	discordancia
discordant	discordante
discountenance	descontento
discourage	desalentar
discouragement	desánimo
discouraging	desanimado
discouragingly	desalentadoramente
discourteous	descortés
discourteously	discourteously
discoutinous	discoíngua
discredit	descrédito
discrepant	discrepante
discriminate	discriminar
discrimination	discriminación
discriminatory	discriminatorio
disdain	desdén
disdained	desdén
disdainful	desdén
disdainfully	despectivamente
disfavor	desvío
disgrace	desgraza
disgraced	desgraciado
disgraceful	desgraciado
disgracefully	desgraciadamente
disgruntle	descontento
disgruntled	descontento
disgust	disgusto
disgusted	disgustada
disgustedly	desagradablemente
disgustful	desagradable
disgustfully	desagradable
disgusting	asqueroso
disgustingly	desagradablemente
dishearten	desmontar
disheartening	desanimado
dishearteningly	desanimado
dishonest	deshonesto
dishonestly	deshonesto
dishonesty	deshonestidade
dishonor	deshonra
dishonorable	deshonroso
dishonorablely	deshonrosamente
disillusion	desilusión
disillusioned	desilusionado
disillusionment	desilusión
disillusions	desilusións
disinclination	desinformación
disinclined	desinfectado
disingenuous	indignante
disintegrate	desintegrarse
disintegrated	desintegrado
disintegration	desintegración
disinterest	desinterese
disinterested	desinteresado
dislocated	dislocado
disloyal	desleal
disloyalty	deslealdade
dismal	triste
dismally	dismally
dismalness	tristeza
dismay	asustado
dismayed	desanimado
dismaying	desanimado
dismayingly	decepcionante
dismissive	despreciativo
dismissively	despreciable
disobedience	desobediencia
disobedient	desobediente
disobey	desobedecer
disoobedient	desobediente
disorder	trastorno
disordered	desordenado
disorderly	desordenada
disorganized	desorganizado
disorient	desorientar
disoriented	desorientado
disown	rexeitar
disparage	disparage
disparaging	despectivo
disparagingly	despectivamente
dispensable	prescindible
dispirit	desprezo
dispirited	despreciado
dispiritedly	dispiritadamente
dispiriting	desprezando
displace	desplazar
displaced	desprazados
displease	disgusta
displeased	descontento
displeasing	desagradable
displeasure	descontento
disproportionate	desproporcionada
disprove	refutar
disputable	disputable
dispute	disputa
disputed	disputada
disquiet	inquietud
disquieting	inquietante
disquietingly	inquietante
disquietude	inquietude
disregard	desprezo
disregardful	despreocupado
disreputable	indescritível
disrepute	descrédito
disrespectable	indescritível
disrespectablity	desnudez
disrespectful	irrespetuoso
disrespectfully	irrespetuamente
disrupt	perturbar
disruption	interrupción
disruptive	perturbador
diss	diss
dissapointed	decepcionado
dissappointed	decepcionado
dissappointing	decepcionante
dissatisfaction	insatisfacción
dissatisfactory	insatisfactorio
dissatisfied	insatisfeito
dissatisfies	insatisfeitos
dissatisfy	insatisfeito
dissatisfying	insatisfeito
dissed	dised
dissemble	disimular
dissembler	disemblador
dissension	disensión
dissent	disidencia
dissenter	disenso
dissention	disolución
disservice	dobrar
disses	dises
dissidence	disidencia
dissident	disidente
dissidents	disidentes
dissing	disipar
dissocial	disocial
dissolute	disoluto
dissolution	disolución
dissonance	disonancia
dissonant	disonante
dissonantly	disonante
dissuade	disuadir
dissuasive	disuasiva
distains	separa
distaste	repugnancia
distasteful	desagradable
distastefully	desagradable
distort	distorsionar
distorted	distorsionada
distortion	Distorsión
distorts	distorsiona
distract	distraer
distracting	distraer
distraction	distracción
distraught	angustiado
distraughtly	distraídamente
distraughtness	distraído
distress	angustia
distressed	angustiado
distressing	angustiante
distressingly	angustiosamente
distrust	desconfianza
distrustful	desconfiado
distrusting	desconfiado
disturb	molestar
disturbance	perturbación
disturbed	perturbado
disturbing	inquietante
disturbingly	inquietante
disunity	desunión
disvalue	desvalorizar
divergent	diverxente
divisive	divisivo
divisively	divididamente
divisiveness	división
dizzing	encharcado
dizzingly	parvo
dizzy	mareado
doddering	esquivar
dodgey	dodge
dogged	perseguido
doggedly	obstinadamente
dogmatic	dogmático
doldrums	doldrums
domineer	dominante
domineering	dominante
donside	desapareceu
doom	desgraza
doomed	condenado
dope	droga
doubt	dúbida
doubtful	dubidoso
doubtfully	dubidoso
doubts	dúbidas
douchbag	douchbag
douchebag	parvo
douchebags	douchebags
downbeat	pendente
downcast	abatido
downer	abaixo
downfall	caída
downfallen	caídas
downgrade	rebaixar
downhearted	desanimado
downheartedly	desconsolado
downside	desvantaxe
downsides	inconvenientes
downturn	desaceleración
downturns	desaceleración
drab	monótono
draconian	draconiana
draconic	draconia
drag	arrastrar
dragged	arrastrado
dragging	arrastrando
dragoon	dragón
drags	arrastra
drain	fuga
drained	drenado
draining	drenando
drains	drenos
drastic	drástico
drastically	drasticamente
drawback	inconveniente
drawbacks	inconvenientes
dread	temor
dreadful	terrible
dreadfully	terriblemente
dreadfulness	terrible
dreary	triste
dripped	goteo
dripping	goteo
drippy	drippy
drips	gotea
drones	drones
droop	caer
droops	gotas
drop-out	despedida
drop-outs	drop-outs
dropout	despedida
dropouts	abandonos
drought	seca
drowning	afogando
drunk	borracho
drunkard	borracho
drunken	borracho
dubious	dubidoso
dubiously	dubidosa
dubitable	dubitativo
dud	dud
dull	aburrido
dullard	dullard
dumb	mudo
dumbfound	estúpido
dump	vertedoiro
dumped	dumped
dumping	dumping
dumps	vertedoiro
dunce	Dunce
dungeon	mazmorra
dungeons	mazmorras
dupe	dupe
dust	po
dusty	polvoriento
dwindling	diminuíndo
dying	morrendo
earsplitting	Earsplitting
eccentric	excéntrico
eccentricity	excentricidade
effigy	efigie
effrontery	infartos
egocentric	egocéntrico
egomania	egomania
egotism	egotismo
egotistical	egoísta
egotistically	egoísticamente
egregious	agresivo
egregiously	ignorante
elimination	eliminación
emaciated	emaciado
emasculate	emasculate
embarrass	avergoñado
embarrassing	vergonzoso
embarrassingly	vergonzosamente
embarrassment	vergonza
embattled	embutled
embroil	embalar
embroiled	enredado
embroilment	embriamento
emergency	emerxencia
emphatic	enfático
emphatically	enfaticamente
emptiness	baleiro
encroach	invadir
encroachment	invasión
enemies	inimigos
enemy	inimigo
enervate	enervar
enfeeble	enfeeble
enflame	inflamar
engulf	engulir
enjoin	enjoin
enmity	inimizade
enrage	Enrage
enraged	enfurecido
enraging	enraging
enslave	Esclavizar
entangle	enredar
entanglement	entanglement
entrap	entrap
entrapment	atrapamento
envious	envexoso
enviousness	envexa
epidemic	epidemia
equivocal	equívoco
erase	borrar
erode	erosionar
erodes	erosiona
erosion	erosión
err	errar
errant	errante
erratic	errático
erratically	erraticamente
erroneous	erróneo
erroneously	erróneamente
error	erro
errors	erros
eruptions	erupcións
escapade	escapada
eschew	escapar
estranged	distanciado
evade	evadir
evasion	evasión
evasive	evasivo
evil	mal
evildoer	malvado
evils	males
eviscerate	eviscerar
exacerbate	exacerbar
exagerate	exagerado
exagerated	exagerado
exagerates	exagerados
exaggerate	esaxerar
exaggeration	esaxeración
exasperate	exasperar
exasperated	exasperado
exasperating	exasperante
exasperatingly	exasperante
exasperation	exasperación
excessive	excesivo
excessively	excesivamente
exclusion	exclusión
excoriate	excoriate
excruciating	excruciante
excruciatingly	inconsciente
excuse	escusa
excuses	desculpas
execrate	executar
exhaust	escape
exhausted	esgotado
exhaustion	esgotamento
exhausts	esgotamentos
exhorbitant	exorbitante
exhort	exhortar
exile	exilio
exorbitant	exorbitante
exorbitantance	exorbitantancia
exorbitantly	exorbitante
expel	expulsar
expensive	caro
expire	caducan
expired	caducou
explode	explotar
exploit	explotar
exploitation	explotación
explosive	explosivo
expropriate	expropiado
expropriation	expropiación
expulse	expulsar
expunge	expulsar
exterminate	exterminar
extermination	exterminio
extinguish	apagar
extort	extorsionar
extortion	extorsión
extraneous	extrano
extravagance	extravagancia
extravagant	extravagante
extravagantly	extravagante
extremism	extremismo
extremist	extremista
extremists	extremistas
eyesore	ollo
fabricate	fabricar
fabrication	fabricación
facetious	facetious
facetiously	facetiously
fail	falla
failed	fallou
failing	fallando
fails	falla
failure	falla
failures	fallos
faint	débil
fainthearted	desmayado
faithless	infiel
fake	falso
fall	caer
fallacies	falacias
fallacious	falaz
fallaciously	falláceamente
fallaciousness	falacia
fallacy	falacia
fallen	caído
falling	caendo
fallout	fallout
falls	cae
false	falso
falsehood	falsedad
falsely	falsamente
falsify	falsificar
falter	falter
faltered	faltered
famine	fame
famished	famed
fanatic	fanático
fanatical	fanático
fanatically	fanáticamente
fanaticism	fanatismo
fanatics	fanáticos
fanciful	fantasioso
far-fetched	despilfarro
farce	farsa
farcical	fofo
farcical-yet-provocative	fabuloso-aínda-provocativo
farcically	foxicamente
farfetched	estridente
fascism	fascismo
fascist	fascista
fastidious	fastidioso
fastidiously	fastidiosamente
fastuous	fastuoso
fat	graxa
fatal	fatal
fatalistic	fatalista
fatalistically	fatalisticamente
fatally	fatalmente
fatcat	fatcat
fatcats	gordos
fateful	fatídico
fatefully	fatalmente
fathomless	indefenso
fatigue	fatiga
fatigued	fatigado
fatique	fatique
fatty	graxo
fatuity	fatuidade
fatuous	fatuoso
fatuously	fatuosamente
fault	culpa
faults	fallas
faulty	defectuoso
fawningly	fervientemente
faze	faze
fear	medo
fearful	temeroso
fearfully	temerosa
fears	temores
fearsome	temible
feeble	débil
feeblely	feblemente
feebleminded	débil
feign	feign
feint	finta
fell	caeu
felon	felon
felonious	felonious
ferociously	ferozmente
ferocity	ferocidade
fetid	fétido
fever	febre
feverish	febril
fevers	febres
fiasco	fiasco
fib	fib
fibber	Fibra
fickle	inconstante
fiction	ficción
fictional	ficcional
fictitious	ficticio
fidget	fidget
fidgety	fidgety
fiend	fiend
fiendish	diabólico
fierce	feroz
filth	inmundicia
filthy	estampada
finagle	branco
finicky	finicky
fissures	fisuras
fist	puño
flabbergast	flabbergast
flabbergasted	flabbergasted
flagging	marcación
flagrant	flagrante
flagrantly	flagrante
flair	instinto
flairs	afeccionados
flak	flak
flake	escama
flakey	escamosa
flakieness	flaquidade
flaking	descamação
flaky	escamas
flare	flare
flares	bengalas
flareup	flareup
flareups	flareups
flat-out	plano
flaunt	presumir
flaw	fallo
flawed	imperfecto
flaws	defectos
flee	fuxir
fleed	fuxiu
fleeing	fuxindo
fleer	folerpa
flees	foxe
fleeting	fugaz
flicering	flicering
flicker	parpadeo
flickering	parpadeo
flickers	parpadeantes
flighty	flighty
flimflam	flimflam
flimsy	feble
flirt	coquetear
flirty	coqueto
floored	floored
flounder	barro
floundering	floundering
flout	caer
fluster	gasta
foe	inimigo
fool	tonto
fooled	enganado
foolhardy	temerario
foolish	tonto
foolishly	tolamente
foolishness	tolemia
forbid	prohibir
forbidden	prohibido
forbidding	prohibición
forceful	contundente
foreboding	foreboding
forfeit	perdida
forged	forxado
forgetful	esquecible
forgetfully	esquecemento
forgetfulness	esquecemento
forlorn	desamparado
forlornly	fordornly
forsake	abandonar
forsaken	abandonado
forswear	forswear
foul	falta
foully	mal
foulness	farsa
fractious	fracturado
fractiously	fraccionadamente
fracture	fractura
fragile	fráxil
fragmented	fragmentado
frail	fráxil
frantic	frenético
frantically	freneticamente
franticly	frenéticamente
fraud	fraude
fraudulent	fraudulento
fraught	cheo
frazzle	frazzle
frazzled	frazzled
freak	freak
freaking	freaking
freakish	freakish
freakishly	freakishly
freaks	freaks
freeze	xear
freezes	conxela
freezing	conxelación
frenetic	frenético
frenetically	frenéticamente
frenzied	frenético
frenzy	frenesí
fret	fret
fretful	fretful
frets	trastes
friction	fricción
frictions	friccións
fried	frito
friggin	friggin
frigging	fráxil
fright	medo
frighten	asustar
frightening	asustado
frighteningly	asustado
frightful	espantoso
frightfully	terriblemente
frigid	frígida
frost	xeadas
frown	frown
froze	conxelouse
frozen	conxelada
fruitless	infeliz
fruitlessly	infructuosamente
frustrate	frustrar
frustrated	frustrado
frustrates	frustra
frustrating	frustrante
frustratingly	frustrante
frustration	frustración
frustrations	frustracións
fuck	foder
fucking	puta
fudge	fudge
fugitive	fugitivo
full-blown	completo
fulminate	fulminar
fumble	fumble
fume	fume
fumes	fume
fundamentalism	fundamentalismo
funky	funky
funnily	divertidamente
funny	divertido
furious	furioso
furiously	furiosamente
furor	furor
fury	furia
fuss	alboroto
fussy	chuvioso
fustigate	fustigate
fusty	fusty
futile	inútil
futilely	inútil
futility	inutilidade
fuzzy	borroso
gabble	gabble
gaff	gaff
gaffe	gaffe
gainsay	gañou
gainsayer	ganador
gall	gall
galling	atormentando
gallingly	cruelmente
galls	galls
gangster	mafioso
gape	gape
garbage	lixo
garish	garish
gasp	gasp
gauche	gauche
gaudy	alegre
gawk	gawk
gawky	gawky
geezer	geezer
genocide	xenocidio
get-rich	enriquecerse
ghastly	espantoso
ghetto	gueto
ghosting	fantasmas
gibber	gibber
gibberish	gibberish
gibe	gibe
giddy	giddy
gimmick	truco
gimmicked	imitando
gimmicking	gimmicking
gimmicks	trucos
gimmicky	enxame
glare	brillo
glib	glib
glibly	glibly
glitch	glitch
glitches	fallas
gloatingly	gloatingly
gloom	tristeza
gloomy	sombrío
glower	glower
glum	glum
glut	glut
gnawing	gnawing
goad	touro
goading	chocando
god-awful	god-awful
goof	goof
goofy	torpe
goon	segue
gossip	rexouba
graceless	graceless
gracelessly	graciosamente
graft	enxerto
grainy	graino
grapple	manexar
grate	reixa
grating	reixa
gravely	gravemente
greasy	graxa
greed	avaricia
greedy	avaro
grief	pena
grievance	queixa
grievances	queixas
grieve	triste
grieving	pícaro
grievous	graves
grievously	graves
grim	sombrío
grimace	mueca
grind	moer
gripe	gripe
gripes	gripes
grisly	grismente
gritty	gritty
gross	bruto
grossly	groseiramente
grotesque	grotesco
grouch	grouch
grouchy	grouchy
grouse	grouse
growl	gruñir
grudge	rencor
grudges	escamas
grudging	rencor
gruesome	horrible
gruesomely	gruesomely
gruff	pesada
grumble	chorar
grumpiest	grumpiest
grumpily	grumpily
grumpish	grumpish
grumpy	grumpy
guile	guile
guilt	culpa
guiltily	culpable
guilty	culpable
gullible	crédula
gutless	gutless
gutter	canaleta
hack	piratear
hacks	hacks
haggard	desposeídos
haggle	regatear
hairloss	pele
halfhearted	desanimado
hallucinate	alucinar
hallucination	alucinación
hamper	dificultar
hampered	dificultada
handicapped	minusválidos
hang	colgar
hangs	colga
haphazard	asalto
hapless	infeliz
harangue	arengue
harass	hostigar
harassed	hostigado
harasses	asusta
harassment	acoso
harboring	abrigando
harbors	portos
hard	duro
hard-liner	hard-liner
hardball	hardball
harden	endurecer
hardened	endurecido
hardheaded	duro
hardliner	hardliner
hardliners	hardliners
hardship	dificultades
hardships	dificultades
harm	danos
harmed	prexudicado
harmful	nocivo
harms	prexudica
harpy	arpía
harridan	harridan
harried	atrapado
harrow	grada
harsh	dura
harshly	duramente
hasseling	asfixia
hassle	problemas
hassled	molestado
hassles	molestias
haste	présa
hastily	apresuradamente
hasty	apresuradamente
hate	odio
hated	odiado
hateful	odioso
hatefully	odio
hatefulness	odio
hater	abatir
haters	odios
hates	odia
hating	odiando
hatred	odio
haughtily	altivamente
haughty	altivo
haunt	asombrar
haunting	asombroso
havoc	estragos
hawkish	crujiente
haywire	falso
hazard	perigo
hazardous	perigosa
haze	néboa
hazy	brumoso
heartbreaking	desgarrador
heartbreakingly	desgarrador
heathen	paganos
heavy-handed	pesados
heavyhearted	pesado
heck	heck
heckle	heckle
heckled	heckled
heckles	heckles
hectic	axitado
hedge	cobertura
hedonistic	hedonista
hefty	pesado
hegemonism	hegemonismo
hegemonistic	hegemonista
hegemony	hexemonía
heinous	heinous
hell-bent	inflexible
hellion	hellion
helpless	indefenso
helplessly	impotente
helplessness	impotencia
heresy	herexía
heretic	herético
heretical	herético
hesitant	vacilante
hestitant	hestitante
hideous	horrible
hideously	terriblemente
hideousness	horror
hiliarious	hiliarios
hinder	dificultar
hindrance	impedimento
hiss	silbido
hissed	silbido
hissing	silbido
ho-hum	ho-hum
hoard	acumular
hoax	broma
hobble	desenfreado
hogs	porcos
hollow	oco
hoodium	hoodium
hoodwink	incómodo
hooligan	hooligan
hopelessly	irremediablemente
hopelessness	desesperanza
horde	horda
horrendous	horrible
horrendously	horriblemente
horrible	horrible
horrid	horrible
horrific	horrible
horrified	horrorizado
horrifies	horroriza
horrify	horroroso
horrifying	horroroso
horrifys	horrorosos
hostage	rehén
hostile	hostil
hostilities	hostilidades
hostility	hostilidade
hotbeds	cachorros
hothead	hothead
hotheaded	cabezudos
hothouse	inverno
hubris	hubris
huckster	huckster
hum	hum
humid	húmido
humiliate	humillar
humiliating	humillante
humiliation	humillación
humming	tarareando
hung	colgado
hurt	ferido
hurted	ferido
hurtful	ferido
hurting	ferindo
hurts	doe
hustler	cazador
hype	bombo
hypocricy	hipocresía
hypocrisy	hipocresía
hypocrite	hipócrita
hypocrites	hipócritas
hypocritical	hipócrita
hypocritically	hipócrita
hysteria	histeria
hysteric	histérica
hysterical	histérica
hysterically	histéricamente
hysterics	histeria
idiocies	idiocies
idiocy	idiotez
idiot	idiota
idiotic	idiota
idiotically	idioticamente
idiots	idiotas
idle	inactivo
ignoble	ignoble
ignominious	ignominiosa
ignominiously	ignominiosamente
ignominy	ignomínio
ignorance	ignorancia
ignorant	ignorante
ignore	ignorar
ill-fated	maligna
illegal	ilegal
illegally	ilegalmente
illegitimate	ilexítimo
illicit	ilícito
illiterate	analfabetos
illness	doenza
illogic	ilóxico
illogical	ilóxico
illogically	ilógicamente
illusion	ilusión
illusions	ilusións
illusory	ilusorio
imaginary	imaxinario
imbalance	desequilibrio
imbecile	imbécil
imbroglio	imbroglio
immaterial	inmaterial
immature	inmaturas
imminence	inminencia
imminently	inminente
immobilized	inmobilizado
immoderate	immoderar
immoderately	inmoderadamente
immodest	immodesto
immoral	inmoral
immorality	inmoralidade
immorally	inmoralmente
immovable	inmóbil
impair	perjudicar
impaired	impedido
impasse	impasse
impatience	impaciencia
impatient	impaciente
impatiently	impaciente
impeach	impeach
impedance	impedancia
impede	impedir
impediment	impedimento
impending	inminente
impenitent	impenitente
imperfect	imperfecto
imperfection	imperfección
imperfections	imperfeccións
imperfectly	imperfecto
imperialist	imperialista
imperil	imperil
imperious	imperioso
imperiously	imperiosamente
impermissible	impermeable
impersonal	impersonal
impertinent	impertinente
impetuous	impetuoso
impetuously	impetuosamente
impiety	impiedade
impinge	impedir
impious	impío
implacable	implacable
implausible	implausible
implausibly	implacablemente
implicate	implicar
implication	implicación
implode	implode
impolite	impolite
impolitely	impolítamente
impolitic	impolítico
importunate	importunate
importune	importune
impose	impoñer
imposers	imponentes
imposing	impoñendo
imposition	imposición
impossible	imposible
impossiblity	imposiblidade
impossibly	imposible
impotent	impotente
impoverish	empobrecemento
impoverished	empobrecido
impractical	impráctico
imprecate	imprecado
imprecise	impreciso
imprecisely	imprecisamente
imprecision	imprecisión
imprison	prisión
imprisonment	prisión
improbability	improbabilidade
improbable	improbable
improbably	improbablemente
improper	incorrecto
improperly	incorrectamente
impropriety	impropiedade
imprudence	imprudencia
imprudent	imprudente
impudence	impudencia
impudent	impudente
impudently	impudentemente
impugn	impugnar
impulsive	impulsivo
impulsively	impulsivamente
impunity	impunidade
impure	impuro
impurity	impureza
inability	incapacidade
inaccuracies	inexactitudes
inaccuracy	inexactitude
inaccurate	inexacto
inaccurately	inexacto
inaction	inacción
inactive	inactivo
inadequacy	inadecuación
inadequate	inadecuado
inadequately	inadecuadamente
inadverent	inadvertido
inadverently	inadvertidamente
inadvisable	desaconsellable
inadvisably	inadecuadamente
inane	inano
inanely	inanemente
inappropriate	inapropiado
inappropriately	inadecuadamente
inapt	inapt
inaptitude	inaptitude
inarticulate	inarticulado
inattentive	inatente
inaudible	inaudible
incapable	incapaz
incapably	incapaz
incautious	incauta
incendiary	incendiario
incense	incienso
incessant	incesante
incessantly	incesantemente
incite	incitar
incitement	incitación
incivility	incividade
inclement	inclemente
incognizant	incognizante
incoherence	incoherencia
incoherent	incoherente
incoherently	incoherentemente
incommensurate	inconmensurable
incomparable	incomparable
incomparably	incomparablemente
incompatability	incompatibilidade
incompatibility	incompatibilidade
incompatible	incompatible
incompetence	incompetencia
incompetent	incompetente
incompetently	incompetente
incomplete	incompleto
incompliant	incompleto
incomprehensible	incomprensible
incomprehension	incomprensión
inconceivable	inconcibible
inconceivably	inconcebiblemente
incongruous	incongruente
incongruously	incongruentemente
inconsequent	inconsecuentes
inconsequential	inconsecuente
inconsequentially	inconsecuentemente
inconsequently	inconsecuentemente
inconsiderate	inconsiderar
inconsiderately	inquisitivamente
inconsistence	inconsistencia
inconsistencies	inconsistencias
inconsistency	inconsistencia
inconsistent	inconsistente
inconsolable	inconsolable
inconsolably	inconsolablemente
inconstant	inconstant
inconvenience	inconveniente
inconveniently	inconveniente
incorrect	incorrecto
incorrectly	incorrectamente
incorrigible	incorregible
incorrigibly	incorrigible
incredulous	incrédulo
incredulously	incrédulo
inculcate	inculcar
indecency	indecencia
indecent	indecente
indecently	indecentemente
indecision	indecisión
indecisive	indeciso
indecisively	indecisos
indecorum	indecorum
indefensible	indefensible
indelicate	indelicado
indeterminable	indeterminável
indeterminably	indeterminabelmente
indeterminate	indeterminado
indifference	indiferenza
indifferent	indiferente
indigent	indigente
indignant	indignado
indignantly	indignado
indignation	indignación
indignity	indignidade
indiscernible	indiscernible
indiscreet	indiscreto
indiscreetly	indiscreto
indiscretion	indiscreción
indiscriminate	indiscriminada
indiscriminately	indiscriminadamente
indiscriminating	indiscriminado
indistinguishable	indistinguível
indoctrinate	adoctrinar
indoctrination	adoctrinación
indolent	indolente
indulge	entrar
ineffective	ineficaz
ineffectively	ineficazmente
ineffectiveness	ineficacia
ineffectual	ineficaz
ineffectually	ineficazmente
ineffectualness	ineficacia
inefficacious	ineficaz
inefficacy	ineficacia
inefficiency	ineficiencia
inefficient	ineficiente
inefficiently	ineficientemente
inelegance	inelegance
inelegant	inelegante
ineligible	inelegíbel
ineloquent	inelucente
ineloquently	inelucente
inept	inepto
ineptitude	ineptitude
ineptly	inepto
inequalities	desigualdades
inequality	desigualdade
inequitable	inequitativo
inequitably	inequívocamente
inequities	desigualdades
inescapable	ineludible
inescapably	ineludiblemente
inessential	inesencial
inevitable	inevitable
inevitably	inevitablemente
inexcusable	inexcusable
inexcusably	inexcusablemente
inexorable	inexorable
inexorably	inexorablemente
inexperience	inexperiencia
inexperienced	inexperto
inexpert	inexperto
inexpertly	inexperto
inexpiable	inexpiable
inexplainable	inexplicable
inextricable	inextricable
inextricably	inextricablemente
infamous	infame
infamously	infamous
infamy	infamia
infected	infectados
infection	infección
infections	infeccións
inferior	inferior
inferiority	inferioridade
infernal	infernal
infest	infestar
infested	infestados
infidel	infiel
infidels	infieles
infiltrator	infiltrado
infiltrators	infiltrados
infirm	enfermos
inflame	inflamar
inflammation	inflamación
inflammatory	inflamatorio
inflammed	inflamado
inflated	inflado
inflationary	inflacionista
inflexible	inflexible
inflict	infligir
infraction	infracción
infringe	infrinxir
infringement	infracción
infringements	infraccións
infuriate	enfurecer
infuriated	enfurecido
infuriating	infuriante
infuriatingly	infuriado
inglorious	inglorious
ingrate	ingrate
ingratitude	ingratitude
inhibit	inhibir
inhibition	inhibición
inhospitable	inhóspito
inhospitality	inhospitalidade
inhuman	inhumanos
inhumane	inhumano
inhumanity	inhumanidade
inimical	inimical
inimically	inimicalmente
iniquitous	inicuo
iniquity	iniquidade
injudicious	incómodo
injure	ferir
injurious	dañosa
injury	lesión
injustice	inxustiza
injustices	inxustizas
innuendo	insinuación
inoperable	inoperable
inopportune	inoportuno
inordinate	desordenado
inordinately	inordinadamente
insane	insano
insanely	insanamente
insanity	tolemia
insatiable	insaciable
insecure	inseguro
insecurity	inseguridade
insensible	insensible
insensitive	insensible
insensitively	insensiblemente
insensitivity	insensibilidade
insidious	insidioso
insidiously	insidiosamente
insignificance	insignificancia
insignificant	insignificante
insignificantly	insignificante
insincere	insincere
insincerely	insincerely
insincerity	insinceridade
insinuate	insinuar
insinuating	insinuando
insinuation	insinuación
insociable	insociable
insolence	insolencia
insolent	insolente
insolently	insolentemente
insolvent	insolvente
insouciance	insouciance
instability	inestabilidade
instable	inestable
instigate	instigar
instigator	instigador
instigators	instigadores
insubordinate	insubordinado
insubstantial	insustancial
insubstantially	inexorablemente
insufferable	insoportable
insufferably	insufriblemente
insufficiency	insuficiencia
insufficient	insuficiente
insufficiently	insuficiente
insular	insular
insult	insulto
insulted	insultado
insulting	insultante
insultingly	insultante
insults	insultos
insupportable	insoportable
insupportably	insoportablemente
insurmountable	insuperable
insurmountably	insuperablemente
insurrection	insurrección
intefere	intefere
inteferes	inteferes
intense	intenso
interfere	interferir
interference	interferencia
interferes	interfire
intermittent	intermitente
interrupt	interromper
interruption	interrupción
interruptions	interrupcións
intimidate	intimidar
intimidating	intimidante
intimidatingly	intimidante
intimidation	intimidación
intolerable	intolerable
intolerablely	intolerable
intolerance	intolerancia
intoxicate	intoxicar
intractable	intratable
intransigence	intransixencia
intransigent	intransixente
intrude	intrude
intrusion	intrusión
intrusive	intrusivo
inundate	inundar
inundated	inundado
invader	invasor
invalidate	invalidar
invalidity	invalidez
invasive	invasivo
invective	invectiva
inveigle	inveigle
invidious	invicto
invidiously	invidioso
invidiousness	invidencia
invisible	invisible
involuntarily	involuntariamente
involuntary	involuntaria
irascible	irascible
irate	irar
irately	iratismo
ire	ire
irk	Irk
irked	irked
irking	irking
irks	irks
irksome	irritante
irksomely	irksomely
irksomeness	irksomeness
irksomenesses	irksomenesses
ironic	irónico
ironical	irónico
ironically	irónicamente
ironies	ironías
irony	ironía
irragularity	irragularidade
irrational	irracional
irrationalities	irracionalidades
irrationality	irracionalidade
irrationally	irracionalmente
irrationals	irracionales
irreconcilable	irreconciliable
irrecoverable	irrecuperável
irrecoverableness	irrecuperabilidade
irrecoverablenesses	irrecuperables
irrecoverably	irrecuperablemente
irredeemable	irredível
irredeemably	irremediablemente
irreformable	irreformable
irregular	irregular
irregularity	irregularidade
irrelevance	irrelevante
irrelevant	irrelevante
irreparable	irreparable
irreplacible	irreplacable
irrepressible	irreprimible
irresolute	irresoluto
irresolvable	irresolvable
irresponsible	irresponsable
irresponsibly	irresponsablemente
irretating	irretando
irretrievable	irrecuperable
irreversible	irreversible
irritable	irritable
irritably	irritablemente
irritant	irritante
irritate	irritar
irritated	irritado
irritating	irritante
irritation	irritación
irritations	irritacións
isolate	illar
isolated	aislado
isolation	illamento
issue	asunto
issues	problemas
itch	picor
itching	comezón
itchy	coceira
jabber	jabber
jaded	jaded
jagged	dentados
jam	mermelada
jarring	discordante
jaundiced	ictericia
jealous	celoso
jealously	celosamente
jealousness	celosidade
jealousy	celos
jeer	burlarse
jeering	incómodo
jeeringly	inconsciente
jeers	cabrón
jeopardize	comprometido
jeopardy	perigo
jerk	parvo
jerky	tiritas
jitter	jitter
jitters	nerviosismo
jittery	nervioso
jobless	desemprego
joke	broma
joker	bromista
jolt	sacudida
judder	judder
juddering	xulgando
judders	xulgados
jumpy	salto
junk	lixo
junky	junky
jutter	jutter
jutters	jutters
kaput	kaput
kill	matar
killed	asasinado
killer	asasina
killing	matando
killjoy	killjoy
kills	mata
knave	knave
knife	coitelo
knock	bater
knotted	anudado
kook	kook
kooky	kooky
lack	falta
lackadaisical	faltaadaisical
lacked	faltaba
lackey	faltaey
lackeys	lacayos
lacking	falta
lacks	falta
laconic	lacónico
lag	lag
lagged	atrasado
lagging	atraso
laggy	laggy
lags	atrasos
laid-off	despedido
lambast	lambast
lambaste	lambaste
lame	coxo
lament	lamentar
lamentable	lamentable
lamentably	lamentablemente
languid	lândida
languish	languidecen
languor	languidez
languorous	languidez
languorously	languidamente
lanky	mentirosa
lapse	lapso
lapsed	caducado
lapses	caduca
lascivious	lescivo
latency	latencia
laughable	risible
laughably	risadamente
lawlessness	ilegalidade
layoff	deixar
layoff-happy	despedida-feliz
lazy	preguiceiro
leak	fuga
leakage	fuga
leakages	fugas
leaking	fugas
leaks	fugas
leaky	vley
lech	lech
lecher	lecher
lecherous	lecherous
lechery	lechery
leech	leech
leer	ler
leery	leery
lemon	limón
lengthy	longa
letch	chorar
lethal	letal
lethargic	letargo
lethargy	letargo
lewd	lewd
lewdly	lewdly
lewdness	lewdness
liability	responsabilidade
liable	Responsable
liar	embusteiro
liars	mentirosos
licentious	licencioso
licentiousness	licenzas
lie	mentira
lied	mentir
lier	lier
lies	mentiras
limit	límite
limitation	limitación
limitations	limitacións
limited	limitado
limits	límites
limp	limpo
litigious	litixioso
livid	livid
lividly	lividamente
loath	odio
loathe	odia
loathing	odio
loathsome	repugnante
loathsomely	desagradablemente
lone	solitario
loneliness	soidade
lonely	solitario
loner	solitario
lonesome	solitario
longing	ansia
longingly	ansiosamente
loophole	fenda
loopholes	lagoas
loose	solto
loot	botín
lorn	lorn
lose	perder
loser	perdedor
losers	perdedores
loses	perde
losing	perdendo
loss	perda
losses	perdas
lost	perdido
loud	alto
lousy	pésimo
lovelorn	lovelorn
lowly	humilde
ludicrous	ridículo
lugubrious	lúgubre
lukewarm	tibio
lull	calma
lumpy	flojo
lunatic	lunático
lunaticism	lunaticismo
lurch	lurch
lure	atraer
lurid	aterid
lurk	esconderse
lying	mentir
macabre	macabro
mad	tolo
madden	enojado
maddening	enojado
maddeningly	enojado
madder	madder
madly	locamente
madman	tolo
madness	tolemia
maladjustment	inadaptación
malady	enfermidade
malaise	malestar
malcontent	malcontent
malcontented	malcontentado
maledict	malicia
malevolence	malevolencia
malevolent	malévolo
malevolently	malévolo
malice	malicia
malicious	malicioso
maliciously	maliciosamente
maliciousness	malicia
malign	maligno
malignant	maligno
malodorous	malodoroso
mangle	mangle
mangled	mangled
mangles	mangles
mangling	mangling
mania	mania
maniac	maníaco
maniacal	maníaco
manic	maníaco
manipulate	manipular
manipulation	manipulación
manipulative	manipulador
manipulators	manipuladores
mar	mar
marginal	marxinal
marginally	marginalmente
martyrdom	martirio
mashed	puré
massacre	masacre
massacres	masacres
matte	mate
mawkish	mawkish
mawkishly	malvado
mawkishness	malvado
meager	pobre
meanness	meanness
measly	miserable
meddle	entrometerse
meddlesome	entrometido
mediocre	mediocre
mediocrity	mediocridade
melancholy	melancolía
melodramatic	melodramático
melodramatically	melodramaticamente
meltdown	fusión
menace	ameaza
menacing	amenazante
menacingly	amenazadoramente
mendacious	mendaz
mendacity	mendacity
menial	menial
mess	desorde
messed	desordenado
messes	desorde
messing	desordenado
messy	desordenado
midget	mediodía
miff	miff
militancy	militancia
mirage	espejismo
mire	mire
misalign	desalinear
misaligned	alineados
misaligns	desalineos
misbecome	misbecome
misbecoming	insolente
misbegotten	misbegotten
miscellaneous	diverso
mischief	travesura
mischievous	travieso
mischievously	maliciosamente
miscreant	incomprensible
miscreants	miscreants
miser	avaro
miserable	miserable
miserableness	miserableness
miserably	miserablemente
miseries	miserias
miserly	desgraciado
misery	miseria
misfit	inadaptado
misfortune	desgraza
misgiving	desprezo
misgivings	repugnancia
misguide	desviar
misguided	equivocada
mishandle	mishandle
mishap	accidente
misinterpret	malinterpretar
misjudge	equivocación
mislead	enganar
misleading	engañosa
misleadingly	engañosa
mislike	mislike
mispronounce	mispronounce
mispronounces	maltrato
misrepresent	erroneamente
miss	faltar
missed	perdido
misses	falta
mist	néboa
mistake	erro
mistaken	equivocado
mistakes	erros
mistified	mistificado
mistress	amante
mistrust	desconfianza
mistrustful	desconfiado
mistrustfully	desconfiado
mists	brumas
misunderstanding	malentendido
misunderstandings	malentendidos
misunderstood	incomprendido
moan	queixume
mobster	mafioso
mock	burla
mocked	burlouse
mockeries	burlas
mockery	burla
mocking	burlarse
mockingly	burlonamente
mocks	burlas
molest	molestar
molestation	molestation
monotonous	monótono
monotony	monotonía
monster	monstro
monstrosities	monstruosidades
monstrosity	monstruosidade
monstrous	monstruoso
monstrously	monstruosamente
moody	moody
moot	erro
mope	mope
morbid	mórbido
morbidly	morbosamente
mordant	mordiente
mordantly	mordantemente
moribund	moribundo
moron	parvo
moronic	moronic
morons	morons
mortification	mortificación
mortified	mortificado
mortify	mortificar
mortifying	mortificante
motionless	inmóbil
motley	motley
mourn	chorar
mourner	mourner
mournful	triste
mournfully	tristemente
muddle	muddle
muddy	lodo
mudslinger	mudslinger
mudslinging	mudslinging
mulish	mulish
multi-polarization	multipolarización
mundane	mundano
murder	asasinato
murderer	asasino
murderous	asasinos
murderously	asasinosamente
murky	turbio
mushy	mushy
musty	mofo
mysterious	misterioso
mysteriously	misteriosamente
mystery	misterio
mystify	mistificar
myth	mito
nag	nag
nagging	irritante
naive	inxenuo
naively	inxenuamente
nastily	nastily
nastiness	maldade
nasty	desagradable
naughty	travieso
nauseate	náuseas
nauseates	náuseas
nauseating	náuseas
nauseatingly	nauseabundo
naïve	inxenuo
nebulous	nebuloso
nebulously	nebuloso
needless	innecesario
needlessly	innecesariamente
needy	necesitado
nefarious	nefasta
nefariously	nefastamente
negate	negar
negation	negación
negative	negativa
negatives	negativos
negativity	negatividade
neglect	neglixencia
neglected	negligenciado
negligence	neglixencia
negligent	negligente
nemesis	nemesis
nepotism	nepotismo
nervous	nervioso
nervously	nerviosamente
nervousness	nerviosismo
nettle	urtiga
nettlesome	indeciso
neurotic	neurótico
neurotically	neuroticamente
niggle	niggle
niggles	niggles
nightmare	pesadelo
nightmarish	pesadelo
nightmarishly	sorprendentemente
nitpick	nitpick
nitpicking	nitpicking
noise	ruído
noises	ruídos
noisy	ruidoso
nonexistent	inexistente
nosey	narciso
notoriety	notoriedade
notorious	notorio
notoriously	notoriamente
noxious	nocivo
nuisance	molestias
numb	entumecido
obese	Obeso
object	obxecto
objection	obxección
objectionable	desagradable
objections	obxeccións
oblique	oblicuo
obliterate	borrar
obliterated	borrado
oblivious	ignorante
obnoxious	desagradable
obnoxiously	desagradable
obscene	obsceno
obscenely	obscenamente
obscenity	obscenidade
obscure	escuro
obscured	escuro
obscures	escuro
obscurity	escuridade
obsess	obsesionado
obsessive	obsesivo
obsessively	obsesivamente
obsessiveness	obsesión
obsolete	obsoleto
obstacle	obstáculo
obstinate	obstinado
obstinately	obstinadamente
obstruct	obstruír
obstructed	obstruído
obstructing	obstruyendo
obstruction	obstrución
obstructs	obstruye
obtrusive	molesto
obtuse	obtuso
occlude	occlude
occluded	oculto
occludes	occludes
occluding	occluding
odd	estraño
oddities	curiosidades
oddity	oddidade
oddly	curiosamente
odor	olor
offence	delito
offend	ofender
offender	infractor
offending	ofender
offenses	delitos
offensive	ofensiva
offensively	Ofensivamente
offensiveness	ofensiva
officious	oficiosas
ominous	ominoso
ominously	ominoso
omission	omisión
omit	omitir
one-sided	unilateral
onerous	oneroso
onerously	onerosa
onslaught	ataque
opinionated	opinionado
opponent	adversario
opportunistic	oportunista
opposition	oposición
oppositions	oposicións
oppress	oprimir
oppression	opresión
oppressive	opresivo
oppressively	opressivamente
oppressiveness	opressividade
oppressors	opresores
ordeal	calvario
orphan	orfo
ostracize	ostracize
outbreak	brote
outburst	explosión
outbursts	explosións
outcast	despedida
outcry	protesta
outlaw	proscrito
outmoded	anticuado
outrage	indignación
outraged	indignado
outrageous	indignante
outrageously	escandalosamente
outrageousness	indignación
outrages	indignacións
outsider	outsider
over-acted	sobre-actuado
over-hyped	over-hyped
over-valuation	sobrevaloración
overact	overact
overacted	overacted
overawe	overawe
overbalance	sobrebalanza
overbalanced	equilibrado
overbearing	aburrido
overblown	excesivamente
overdo	exceso
overdone	exagerado
overdue	atrasado
overemphasize	sobreemphasize
overheat	sobrecalentarse
overkill	exceso
overloaded	sobrecargado
overpriced	caro
overrated	sobrevalorado
overreach	overreach
overrun	exceso
overshadow	eclipsar
oversight	supervisión
oversights	descuidos
oversize	oversize
overstate	exagerar
overstated	esaxerado
overstatement	exageración
overstatements	excesos
overstates	esquece
overtaxed	sobretaxado
overthrow	derrocar
overthrows	derrubas
overturn	voltar
overweight	sobrepeso
overwhelm	abrumar
overwhelmed	abrumado
overwhelming	abafadora
overwhelmingly	abrumadoramente
overwhelms	abruma
overzealous	excesivo
overzealously	excesivamente
overzelous	Overzelous
pain	dor
painful	Dolores
painfull	doloroso
painfully	dolorosamente
pains	dores
pale	pálido
pales	palés
paltry	malvada
pan	pan
pandemonium	pandemonium
pander	pander
pandering	pandering
panders	panders
panic	pánico
panick	pánico
panicking	pánico
panicky	pánico
paradoxical	paradoxal
paradoxically	paradójicamente
paralize	paralizar
paralyzed	paralizado
paranoia	paranoia
paranoid	paranoico
parasite	parasito
pariah	pariah
parody	parodia
partiality	parcialidade
partisan	partidista
partisans	partisanos
passe	pase
passive	pasivo
passiveness	pasividade
pathetic	patético
pathetically	patéticamente
patronize	patrocinar
paucity	escaseza
pauper	pauper
paupers	paupers
payback	retorno
peculiar	peculiar
peculiarly	curiosamente
pedantic	pedante
peeled	pelado
peeve	peeve
peeved	peeved
peevish	peevish
peevishly	peevishly
penalize	castigar
penalty	pena
perfidious	perfidioso
perfidity	perfidencia
perfunctory	perfunctory
peril	perigo
perilous	perigoso
perilously	perigosamente
perish	perecer
pernicious	pernicioso
perplex	perplexo
perplexed	perplexos
perplexing	desconcertante
perplexity	perplexidade
persecute	perseguir
persecution	persecución
pertinacious	pertinaz
pertinaciously	pertinazmente
pertinacity	pertinacidade
perturb	perturb
perturbed	perturbado
pervasive	penetrante
perverse	perverso
perversely	perversamente
perversion	perversión
perversity	perversidade
pervert	pervertido
perverted	pervertido
perverts	Perverts
pessimism	pesimismo
pessimistic	pesimista
pessimistically	pesimistamente
pest	praga
pestilent	pestilente
petrified	petrificado
petrify	Petrificar
pettifog	pettifog
petty	pequeno
phobia	fobia
phobic	fóbico
phony	falso
picket	piquete
picketed	piquetes
picketing	piquetes
pickets	piquetes
picky	esixente
pig	porco
pigs	porcos
pillage	pillaje
pillory	píldora
pimple	espiñas
pinch	pinch
pique	pique
pitiable	pitiable
pitiful	lamentable
pitifully	lamentablemente
pitiless	desapontado
pitilessly	pitilessly
pittance	pittance
pity	mágoa
plagiarize	plagiar
plague	peste
plasticky	plasticky
plaything	xogar
plea	motivo
pleas	motivos
plebeian	plebeo
plight	situación
plot	trama
plotters	plotters
ploy	golpeteo
plunder	saqueo
plunderer	saqueador
pointless	inútil
poison	veneno
poisonous	venenoso
poisonously	envelenado
pokey	pokey
poky	poky
polarisation	polarización
polemize	polemizar
pollute	contaminar
polluters	contaminadores
polution	polución
pompous	pomposo
poor	pobre
poorly	mal
posturing	postura
pout	pout
poverty	pobreza
powerless	impotente
prate	prate
pratfall	pratfall
prattle	practle
precarious	precario
precariously	precariamente
precipitate	precipitar
precipitous	precipitado
predatory	depredador
predicament	predicamento
prejudge	prexudicar
prejudice	prejuicio
prejudices	prejuicios
prejudicial	prejudicial
premeditated	premeditado
preoccupy	preocupación
preposterous	absurdo
preposterously	absurdamente
presumptuous	presuntuoso
presumptuously	presuntamente
pretence	pretensio
pretend	finxir
pretense	pretensio
pretentious	pretencioso
pretentiously	pretenciosamente
prevaricate	prevaricar
pricey	caro
prick	picar
prickle	picar
prickles	espiños
prideful	orgulloso
prik	prik
primitive	primitivo
prison	prisión
prisoner	preso
problem	problema
problematic	problemático
problems	problemas
procrastinate	procrastinar
procrastinates	procrastina
procrastination	procrastinación
profane	profano
profanity	profanidade
prohibit	prohibido
prohibitive	prohibitivo
prohibitively	prohibitivamente
propaganda	propaganda
propagandize	propaganda
proprietary	propietario
prosecute	procesar
protest	protesta
protested	protestou
protesting	protestando
protests	protestas
protracted	prolongada
provocation	provocación
provocative	provocativo
provoke	provocar
pry	picar
pugnacious	pugnacious
pugnaciously	contundentemente
pugnacity	pugnacidade
punch	golpe
punish	castigar
punishable	puníbel
punitive	punitiva
punk	punk
puny	puny
puppet	títere
puppets	títeres
puzzled	intrigado
puzzlement	confusión
puzzling	desconcertante
quack	quack
qualm	calm
qualms	rotos
quandary	quandary
quarrel	pelexa
quarrellous	alejados
quarrellously	pelexando
quarrels	pelexas
quarrelsome	peleas
quash	quash
queer	queer
questionable	cuestionable
quibble	quibble
quibbles	quibbles
quitter	quitter
rabid	rabioso
racism	racismo
racist	racista
racists	racistas
racy	racy
radical	radical
radicalization	radicalización
radically	radicalmente
radicals	radicais
rage	rabia
ragged	desgastado
raging	furor
rail	ferroviario
raked	raked
rampage	rebeldía
rampant	desenfreado
ramshackle	estropeado
rancor	rancor
randomly	aleatoriamente
rankle	rango
rant	rant
ranted	ranted
ranting	ranting
rantingly	descaradamente
rants	rants
rape	violación
raped	violada
raping	violando
rascal	canalla
rascals	bandidos
rash	erupción
rattle	traqueteo
rattled	ruidoso
rattles	chocos
ravage	estragos
raving	raving
reactionary	reaccionario
rebellious	rebeldes
rebuff	rexeitamento
rebuke	reprensión
recalcitrant	recalcitrante
recant	recente
recession	recesión
recessionary	recesiva
reckless	imprudente
recklessly	imprudente
recklessness	imprudencia
recoil	retroceso
recourses	recursos
redundancy	redundancia
redundant	redundante
refusal	negativa
refuse	rexeitar
refused	negouse
refuses	rexeita
refusing	negarse
refutation	refutación
refute	refutar
refuted	refutada
refutes	refuta
refuting	refutando
regress	regreso
regression	regresión
regressive	regresiva
regret	arrepentimento
regreted	arrepentido
regretful	arrepentido
regretfully	lamentablemente
regrets	lamenta
regrettable	lamentable
regrettably	lamentablemente
regretted	lamentou
reject	rexeitar
rejected	rexeitado
rejecting	rexeitando
rejection	rexeitamento
rejects	rexeita
relapse	recidiva
relentless	implacable
relentlessly	implacablemente
relentlessness	incansableidade
reluctance	reluctancia
reluctant	relutante
reluctantly	relutantemente
remorse	remordimiento
remorseful	arrepentido
remorsefully	remordialmente
renounce	renunciar
renunciation	renuncia
repel	repeler
repetitive	repetitivo
reprehensible	reprensible
reprehensibly	reprensiblemente
reprehension	reprensión
reprehensive	reprensivo
repress	reprimir
repression	represión
repressive	represivo
reprimand	reprimenda
reproach	reproche
reproachful	reproachful
reprove	reprender
reprovingly	reprobando
repudiate	repudiar
repudiation	repudio
repugn	repugnar
repugnance	repugnancia
repugnant	repugnante
repugnantly	repugnante
repulse	repulse
repulsed	rexeitado
repulsing	rexeitando
repulsive	repulsivo
repulsively	repulsivamente
repulsiveness	repulsividade
resent	resentirse
resentful	resentido
resentment	resentimento
resignation	renuncia
resigned	renunciou
resistance	resistencia
restless	inquedo
restlessness	inquietude
restrict	restrinxir
restricted	restrinxido
restriction	restrición
restrictive	restritiva
resurgent	resurgente
retaliate	represaliar
retaliatory	represalias
retard	retraso
retarded	retardado
retardedness	retraso
retards	demora
reticent	reticente
retract	retraerse
retreat	retiro
retreated	retirouse
revenge	vinganza
revengeful	vingativo
revengefully	vengamente
revert	volver
revile	revélase
reviled	reviled
revoke	revogar
revolt	revolta
revolting	revoltando
revoltingly	revoltemente
revulsion	revulsión
revulsive	revulsivo
rhapsodize	rhapsodize
rhetoric	retórica
rhetorical	retórica
ridicule	ridículo
ridicules	burlas
ridiculous	ridículo
ridiculously	ridículamente
rife	abundante
rift	rift
rifts	fisuras
rigid	ríxido
rigidity	rixidez
rigidness	rixidez
rile	trastorno
riled	riled
rip	rasgar
rip-off	rip-off
ripoff	ripoff
ripped	rasgado
risk	risco
risks	riscos
risky	arriscado
rival	rival
rivalry	rivalidade
rocky	rochoso
rogue	canalla
rot	podremia
rotten	podrido
rough	bruto
rremediable	rremediable
rubbish	lixo
rude	groseiro
rue	rue
ruffian	rufian
ruffle	ruffle
ruin	ruína
ruining	arruinando
ruinous	ruinoso
ruins	ruínas
rumbling	rumorando
rumor	rumor
rumors	rumores
rumours	rumores
rumple	rumple
run-down	atropelar
runaway	Fuxe
rupture	ruptura
rust	ferruxe
rusts	ferrugem
rusty	oxidado
rut	rut
ruthless	desapiadado
ruthlessly	despiadadamente
ruthlessness	crueldade
ruts	ruts
sabotage	sabotaxe
sack	saco
sacrificed	sacrificado
sad	triste
sadden	triste
sadness	tristeza
sag	sag
sagged	sagged
sagging	flaccidez
saggy	saggy
sags	sags
salacious	salaz
sanctimonious	sanctimonious
sap	sap
sarcasm	sarcasmo
sarcastic	sarcástico
sarcastically	sarcásticamente
sardonic	sardónico
sardonically	sardonicamente
sass	sass
satirical	satírico
satirize	satirize
savage	salvaxe
savaged	salvaxe
savagery	salvaxismo
savages	salvaxes
scaly	escamosa
scam	estafa
scams	golpes
scandal	escándalo
scandalize	escandalizar
scandalized	escandalizado
scandalous	escandalosa
scandalously	escandalosa
scandals	escándalos
scandel	escandalo
scandels	escandallos
scant	pouco
scar	cicatriz
scarce	escasos
scarcely	apenas
scarcity	escaseza
scare	asustar
scared	asustado
scarily	escasamente
scarred	cicatrizado
scars	cicatrices
scary	asustado
scathing	mordaz
scathingly	mordazmente
sceptical	escéptico
scoff	escoitar
scoffingly	burlonamente
scold	reprender
scolded	reprendido
scolding	reputación
scoldingly	regañadientes
scorching	escaldante
scorn	desprezo
scornful	desprezador
scornfully	desprezo
scoundrel	canalla
scourge	flaxelo
scowl	brillo
scramble	pelexar
scrambled	revoltos
scrambles	escándalos
scrambling	loitando
scrap	chatarra
scratch	cero
scratched	rascado
scratches	arañazos
scratchy	raspado
scream	gritar
screech	chillar
screw-up	parafuso
screwed	atornillado
screwed-up	atornillado
screwy	atornillado
scuff	peluche
scuffs	peluches
scum	escoria
scummy	escuro
secretive	segredo
sedentary	sedentario
seedy	severo
seethe	seethe
seething	fame
self-coup	auto-golpe
self-criticism	autocrítica
self-defeating	autoproclamante
self-destructive	autodestructiva
self-humiliation	auto-humillación
self-interested	autointerés
self-serving	autoservizo
selfinterested	selfinterested
selfish	egoísta
selfishly	egoístas
selfishness	egoísmo
senile	senil
sensationalize	sensacionalizar
seriousness	seriedade
sermonize	sermonizar
servitude	servitude
set-up	montar
setback	revés
setbacks	contratiempos
sever	cortar
severe	severo
severity	severidade
shabby	gastado
shadowy	sombrío
shady	sombreado
shake	sacudir
shaky	inestable
shallow	superficial
sham	farsa
shambles	rompe
shame	vergonza
shameful	vergonzoso
shamefully	vergonzosamente
shamefulness	vergonza
shameless	desvergonzado
shamelessly	desvergonzadamente
shamelessness	desvergonzado
shark	tiburón
sharply	bruscamente
shatter	romper
shemale	transexual
shimmer	brillo
shimmy	shimmy
shipwreck	naufraxio
shirk	fuxir
shirker	shirker
shit	merda
shiver	tremer
shock	choque
shocked	sorprendido
shocking	impactante
shockingly	sorprendentemente
shortage	escaseza
shortchange	shortchange
shortcoming	deficiencia
shortcomings	deficiencias
shortness	falta
shortsighted	miopía
shortsightedness	miopía
showdown	showdown
shrew	shrew
shriek	gritar
shrill	estridente
shrilly	reluciente
shrivel	descifrar
shroud	sudario
shrouded	cuberto
shun	escoitar
shunned	rexeitou
sick	enfermo
sicken	engordar
sickening	enfermo
sickeningly	enfermo
sickly	enfermo
sickness	enfermidade
sidetrack	desprazamento
sidetracked	desviado
siege	asedio
sillily	silenciosamente
silly	tonto
simplistic	simplista
sin	pecado
sinful	pecador
sinfully	sinuosamente
sinister	siniestro
sinisterly	sinistralmente
sink	afundir
sinking	afundíndose
skeletons	esqueletos
skeptic	escéptico
skeptical	escéptico
skeptically	escépticamente
skepticism	escepticismo
sketchy	incompleto
skimpy	escabroso
skinny	flaco
skittish	asqueroso
skittishly	inconsciente
skulk	skulk
slack	holgazán
slander	calumnias
slanderer	calumniador
slanderous	calumnioso
slanderously	calumnioso
slanders	calumnias
slap	bofetada
slashing	cortando
slaughter	masacre
slaughtered	matado
slave	escravo
slaves	escravos
sleazy	deslumbrante
slime	limo
slog	slog
slogged	inserido
slogging	slogging
slogs	slogs
sloooooooooooooow	sloooooooooooooow
sloooow	sloooow
slooow	slooow
sloow	sloow
sloppily	descabellado
sloppy	desleixo
sloth	perezoso
slothful	carente
slow	lento
slowed	desacelerou
slowly	lentamente
sloww	lento
slowww	slowww
slowwww	reducir
slug	babosa
sluggish	lento
slump	caída
slumping	caer
slumpping	desmoronándose
slur	rebelde
slut	puta
sluts	sluts
sly	astuto
smack	golpear
smallish	pequeno
smash	esmagar
smear	esfregar
smell	cheiro
smelled	olía
smelling	olfateando
smells	cheira
smelly	maloliente
smelt	olía
smoke	fume
smolder	olor
smoldering	ardoroso
smother	sofre
smoulder	olor
smouldering	ardoroso
smudge	mancha
smudged	borrosa
smudges	manchas
smudging	manchar
smug	presumible
smugly	presumiblemente
smut	smut
smuttier	smutter
smutty	sorriso
snag	atrapado
snagged	enganchados
snagging	agarrado
snags	snags
snappish	escoitar
snare	trampa
snarky	snarky
snarl	nariz
sneak	esgueirar
sneakily	sorprendentemente
sneaky	asustado
sneer	escoitar
sneering	burlándose
sneeringly	decepcionante
snob	snob
snobbish	snobbish
snobby	snobby
snobish	snobish
snobs	snobs
snub	deshonra
soapy	xabonoso
sob	sob
sober	sobrio
sobering	sobrio
solemn	solemne
solicitude	solicitude
somber	sombrío
sore	dorida
sorely	sorely
soreness	dor
sorrow	tristeza
sorrowful	triste
sorrowfully	tristemente
sorry	perdón
sour	agria
sourly	sinceramente
spade	espada
spank	spank
spendy	gasto
spew	derramar
spewed	lanzado
spewing	chorando
spews	lanzas
spilling	derramar
spinster	esposo
spiritless	espiritual
spiteful	rencoroso
spitefully	incómodo
splatter	salpicaduras
split	dividir
splitting	división
spoil	romper
spoilage	deterioración
spoilages	estragos
spoiled	estropeado
spoilled	esmagado
spoils	botín
spook	espanto
spookiest	asustado
spookily	asustado
spooky	aterrador
spoonfed	esponxados
sporadic	esporádico
spotty	irregular
spurious	espurio
spurn	esnaquizar
sputter	chisporroteo
squabble	disputa
squabbling	pelexando
squander	perder
squash	cabaza
squeak	escoitar
squeaks	chispas
squeaky	esquisito
squeal	chirrido
squealing	chillando
squeals	chillidos
squirm	escoitar
stab	apuñalar
stagnant	estancado
stagnate	estancarse
stagnation	estancamento
staid	staid
stain	manchar
stains	manchas
stale	obsoleto
stalemate	estancar
stall	parada
stalls	postos
stammer	balbuceiro
stampede	estampida
standstill	paralización
stark	agudo
starkly	duramente
startle	asustado
startling	sorprendente
startlingly	sorprendentemente
starvation	fame
static	estática
steal	roubar
stealing	roubar
steals	rouba
steep	abrupto
steeply	abruptamente
stench	hedor
stereotype	estereotipo
stereotypical	estereotipo
stereotypically	estereotipada
stern	popa
stew	estofado
sticky	pegajoso
stiff	ríxido
stiffness	rixidez
stifle	sofocar
stifling	sofocante
stiflingly	asfixiante
stigma	estigma
stigmatize	estigmatizar
sting	picadura
stinging	picadura
stingingly	picante
stingy	mordaz
stink	asfixia
stinks	apestosa
stodgy	asustado
stole	roubou
stolen	roubado
stooge	stooge
stooges	chocan
stormy	tormentoso
straggle	estraggle
straggler	estraño
strain	tensión
strained	tenso
straining	esforzándose
strange	estraño
strangely	curiosamente
stranger	estraño
strangle	estrangular
streaky	streaky
strenuous	extenuante
stress	estrés
stresses	tensións
stressful	estresante
stressfully	estresante
stricken	afectados
strict	estrita
strictly	estrictamente
strident	estridente
stridently	estridente
strife	pelexa
strike	folga
stringent	rigoroso
stringently	rigorosamente
struck	golpeado
struggle	loita
struggled	loitaba
struggles	loitas
struggling	loitando
strut	puntal
stubborn	obstinado
stubbornly	obstinadamente
stubbornness	obstinación
stuck	atrapado
stuffy	estofado
stumble	tropezar
stumbled	tropezou
stumbles	tropeza
stump	tocón
stumped	estropeado
stumps	tocones
stun	atordoamento
stunt	stunt
stunted	atrofiado
stupid	estúpido
stupidest	estúpido
stupidity	estupidez
stupidly	estúpidamente
stupified	estupido
stupify	estuperse
stupor	estupor
stutter	tartamudez
stuttered	asfixiada
stuttering	tartamudear
stutters	stutters
sty	estilo
stymied	estancado
sub-par	sub-par
subdued	sometido
subjected	sometido
subjection	suxeición
subjugate	subxugar
subjugation	subxugación
submissive	sumiso
subordinate	subordinado
subpoena	citación
subpoenas	citacións
subservience	subservience
subservient	subserviente
subtract	restar
subversion	subversión
subversive	subversivo
subversively	subversivamente
subvert	subverte
succumb	sucumbir
suck	chupar
sucked	aspirado
sucker	saltador
sucks	chupa
sucky	sucky
sue	demanda
sued	demandado
sueing	suing
sues	demanda
suffer	sufrir
suffered	sufriu
sufferer	sofredor
sufferers	enfermos
suffering	sufrimento
suffers	sofre
suffocate	asfixiarse
sugarcoated	azucarado
suicidal	suicida
suicide	suicidio
sulk	sulk
sullen	sullen
sully	sully
sunder	certo
sunk	afundido
sunken	afundido
superficial	superficial
superficiality	superficialidade
superficially	superficialmente
superfluous	superfluo
superstition	superstición
superstitious	supersticiosos
suppress	suprimir
suppression	supresión
surrender	rendición
susceptible	susceptibles
suspect	sospeitoso
suspicion	sospeita
suspicions	sospeitas
suspicious	sospeitoso
suspiciously	sospeitosamente
swagger	swagger
swamped	inundado
sweaty	sudorosa
swelled	inchada
swelling	inchazo
swindle	estafador
swipe	deslizar
swollen	inchada
symptom	síntoma
symptoms	síntomas
syndrome	síndrome
taboo	tabú
tacky	pegajoso
taint	tinto
tainted	contaminado
tamper	manipulación
tangle	enredo
tangled	enredado
tangles	enredos
tank	tanque
tanked	Tanked
tanks	tanques
tantrum	berrinche
tardy	tarde
tarnish	manchar
tarnished	manchados
tarnishes	espanta
tarnishing	tarnishing
tattered	desgarrado
taunt	taunt
taunting	asustado
tauntingly	inquietante
taunts	burlas
taut	taut
tawdry	taqueria
taxing	impostos
tease	burlarse
teasingly	escoitando
tedious	tedioso
tediously	tediosamente
temerity	temeridade
temper	temperamento
tempest	tempestade
temptation	tentación
tenderness	tenrura
tense	tenso
tension	tensión
tentative	tentativa
tentatively	tentativamente
tenuous	tenue
tenuously	tenuously
tepid	tibio
terrible	terrible
terribleness	terribles
terribly	terriblemente
terror	terror
terror-genic	terror-xénico
terrorism	terrorismo
terrorize	aterrorizar
testily	testily
testy	testy
tetchily	téticamente
tetchy	tético
thankless	agradecido
thirst	sede
thorny	espiñento
thoughtless	pensativo
thoughtlessly	pensativo
thoughtlessness	inconsciencia
thrash	thrash
threat	ameaza
threaten	ameazan
threatening	ameazando
threats	ameazas
threesome	trío
throb	golpear
throbbed	palpitou
throbbing	palpitante
throbs	golpes
throttle	acelerador
thug	matón
thumbs-down	pulgar-baixo
thwart	frustrar
timid	tímido
timidity	timidez
timidly	timidamente
timidness	timidez
tin-y	tin-y
tingled	formigado
tingling	formigueiro
tired	canso
tiresome	cansativo
tiring	cansativo
tiringly	cansadamente
toil	traballo
toll	peaxe
topple	derrubar
torment	tormento
tormented	atormentado
torrent	torrent
tortuous	tortuoso
torture	tortura
tortured	torturado
tortures	torturas
torturing	torturar
torturous	tortuoso
torturously	tortuoso
totalitarian	totalitario
touchy	tactil
toughness	dureza
tout	tout
touted	touted
touts	touts
toxic	tóxico
traduce	traducir
tragedy	traxedia
tragic	tráxico
tragically	traxicamente
traitor	traidor
traitorous	traidor
traitorously	traidoramente
tramp	vagabundo
trample	pisar
transgress	transgredir
transgression	transgresión
trap	trampa
traped	trampa
trapped	atrapado
trash	lixo
trashed	lixo
trashy	lixo
trauma	trauma
traumatic	traumático
traumatically	traumáticamente
traumatize	traumatizar
traumatized	traumatizado
travesties	travestis
travesty	travestia
treacherous	traizoeiro
treacherously	traizoeiro
treachery	traizón
treason	traizón
treasonous	traidor
trick	truco
tricked	enganado
trickery	trucos
tricky	complicado
trivial	trivial
trivialize	trivializar
trouble	problemas
troubled	preocupado
troublemaker	molestão
troubles	problemas
troublesome	molesto
troublesomely	molestamente
troubling	inquietante
troublingly	inquietante
truant	truant
tumble	caer
tumbled	caeu
tumbles	tumble
tumultuous	tumultuoso
turbulent	turbulento
turmoil	turbulencia
twist	torcer
twisted	torcido
twists	xiros
tyrannical	tiránico
tyrannically	tiranicamente
tyranny	tiranía
tyrant	tirano
ugh	ugh
ugliness	feiúra
ugly	feo
ulterior	ulterior
ultimatum	ultimátum
ultimatums	ultimátums
ultra-hardline	ultra-hardline
unable	incapaz
unacceptable	inaceptable
unacceptablely	inacceptablely
unacceptably	inaceptable
unaccessible	inaccesible
unaccustomed	inexplicable
unachievable	inalcanzable
unaffordable	inaccesible
unappealing	desapacible
unauthentic	unuthentic
unavoidably	inevitablemente
unbearable	insoportable
unbearablely	insoportablemente
unbelievable	increíble
unbelievably	increíblemente
uncaring	incómodo
uncertain	incerto
uncivil	incivil
uncivilized	incivilizados
unclean	impuro
unclear	escuro
uncollectible	incoloro
uncomfortable	incómodo
uncomfortably	incómodamente
uncomfy	incomodo
uncompromising	intransixente
unconstitutional	inconstitucional
unconvincingly	inconsciente
uncouth	inexorable
uncreative	inculto
undecided	indecisos
undefined	indefinido
undercut	baixo
undercuts	baixadas
undercutting	subcotización
underdog	underdog
underestimate	subestimar
underlings	subalternos
undermine	minar
undermined	minado
undermines	socava
undermining	socavando
underpaid	inadimplentes
undesirable	indeseable
undetermined	indeterminado
undid	desfíxose
undignified	indignado
undocumented	indocumentado
undone	desfacer
undue	indebido
unease	malestar
uneasily	inquieto
uneasiness	inquietud
uneasy	incómodo
unemployed	desempregados
unequal	desigual
uneven	desigual
uneventful	inconsciente
unexpected	inesperado
unexpectedly	inesperadamente
unexplained	inexplicable
unfairly	inxustamente
unfaithful	infiel
unfaithfully	unfaithfully
unfamiliar	descoñecido
unfavorable	desfavorable
unfeeling	insensible
unfinished	inacabado
unfit	incapaz
unforeseen	imprevisto
unforgiving	implacable
unfortunate	infeliz
unfounded	infundado
unfriendly	hostil
ungovernable	ingovernable
ungrateful	ingrato
unhappily	infeliz
unhappiness	infelicidade
unhappy	infeliz
unhealthy	insalubre
unhelpful	inútil
unilateralism	unilateralismo
unimaginable	inimaginable
unimaginably	inimaginablemente
unintelligible	ininteligible
unintelligile	unintelligile
unipolar	unipolar
unjust	inxusto
unjustifiable	injustificable
unjustifiably	inxustificadamente
unjustified	injustificado
unjustly	injustamente
unkind	indeciso
unkindly	inconsciente
unknown	descoñecido
unlawful	ilegal
unlawfully	ilegalmente
unlawfulness	ilegalidade
unleash	desencadear
unlikely	improbable
unlucky	desgraciado
unnatural	antinatural
unnaturally	desnaturalmente
unnecessary	innecesario
unneeded	innecesario
unnerve	desanimado
unnerved	nervioso
unnerving	inquietante
unnervingly	inconsciente
unnoticed	desapercibido
unorthodox	ortodoxo
unorthodoxy	ortodoxia
unpleasant	desagradable
unpleasantries	desagradables
unpopular	impopular
unpredictable	imprevisible
unproductive	improdutiva
unprofitable	inútil
unprove	desprender
unproving	desaprobación
unravel	desenrolar
unraveled	desenrolado
unreachable	inalcanzable
unreasonable	irracional
unrelenting	incansable
unrelentingly	incesante
unrest	disturbios
unruly	incondicional
unsafe	inseguro
unsatisfactory	insatisfactorio
unsavory	desagradable
unsecure	inseguro
unseemly	irrepetible
unsettle	inestable
unsettled	inestable
unsettling	inquietante
unsettlingly	inquietante
unspeakable	indecible
unspeakablely	inequívocamente
unstable	inestable
unsteadily	inexperto
unsteadiness	inestabilidade
unsteady	inestable
unsure	inseguro
unsuspecting	desprezo
unsustainable	insostible
untenable	insostenible
unthinkable	impensable
unthinkably	impensable
untimely	intempestivo
untouched	intacto
untrue	falso
untruthful	inexacto
unusable	inutilizable
unusably	inusamente
unuseable	inutilizable
unuseably	inutilmente
unusual	rara
unusually	inusualmente
unviewable	descoñecible
unwarranted	inxustificado
unwatchable	inviable
unwell	desgraciado
unwieldy	incómodo
unwise	imprudente
unwisely	inconsciente
unworkable	inactivo
unworthy	indigno
unyielding	incondicional
upbraid	upbraid
upheaval	trastorno
uprising	revolta
uproar	alboroto
uproarious	arrogante
uproariously	exageradamente
uproarous	alboroto
uproarously	arrogante
uproot	desarraigo
upset	chat
upseting	molestando
upsets	molestias
upsetting	molesto
upsettingly	atroz
urgent	urxente
useless	inútil
usurp	usurp
usurper	usurpador
utterly	absolutamente
vagrant	vagabundo
vague	vago
vagueness	vaguidade
vanity	vaidade
vehement	vehemento
vehemently	vehementemente
vengeance	vinganza
vengeful	vingativo
vengefully	vengativo
vengefulness	venganza
venom	veneno
venomous	veneno
venomously	venenosamente
vent	vento
vestiges	vestixios
vex	vex
vexation	vexación
vexing	vexing
vexingly	vexingly
vibrate	vibrar
vibrated	vibrado
vibrates	vibra
vibrating	vibrando
vibration	vibración
vice	vice
vicious	cruel
viciously	cruelmente
viciousness	vicioso
victimize	vítima
vile	vil
vileness	vileness
vilify	vilificar
villainous	villano
villainously	vilmente
villains	villanos
villian	villiana
villianous	viliana
villianously	vilmente
villify	villify
vindictive	vengativo
vindictively	vengativa
vindictiveness	vinganza
violate	violar
violation	violación
violator	infractor
violators	infractores
violent	violento
violently	violentamente
viper	viper
virulence	virulencia
virulent	virulento
virulently	virulento
virus	virus
vociferous	vociferante
vociferously	vociferous
volatile	volátil
volatility	volatilidade
vomit	vomitar
vomited	vomitou
vomiting	vómitos
vomits	vomita
vulgar	vulgar
vulnerable	vulnerables
wack	chorar
wail	chorar
wallow	wallow
wane	desaparecer
waning	menguante
wanton	querer
warily	cauteloso
wariness	cautela
warned	advertiu
warning	aviso
warp	urdidura
warped	deformado
wary	desconfiado
washed-out	lavado
waste	desperdicio
wasted	perdido
wasteful	desperdicio
wastefulness	desperdicio
wasting	perdendo
watered-down	aguado-down
wayward	camiñando
weak	débil
weaken	debilitar
weakening	debilitamento
weakness	debilidade
weaknesses	debilidades
weariness	cansazo
wearisome	desgastante
weary	cansado
wedge	cuña
weep	chorar
weird	raro
weirdly	extrañamente
wheedle	carallo
whimper	gemido
whine	gritar
whining	gritando
whiny	gemido
whips	látigos
whore	puta
whores	putas
wicked	malvado
wickedly	malvado
wickedness	maldade
wild	salvaxe
wildly	salvajemente
wiles	wiles
wilt	querer
wily	astuto
wimpy	wimpy
wince	estruendo
wobble	asombrar
wobbled	gritou
wobbles	seca
woe	ai
woebegone	woebegone
woeful	lamentable
woefully	lamentablemente
womanizer	mujeriego
womanizing	muller
worn	usado
worried	preocupado
worriedly	preocupado
worrier	correndo
worries	preocupacións
worrisome	preocupante
worry	preocupación
worrying	preocupante
worryingly	preocupante
worse	peor
worsen	empeorar
worsening	empeorando
worst	peor
worthless	inútil
worthlessly	inútil
worthlessness	inutilidade
wound	ferida
wounds	feridas
wrangle	desprezo
wrath	ira
wreak	wreak
wreaked	destruído
wreaks	wreaks
wreck	naufraxio
wrest	arrancar
wrestle	loitar
wretch	desgraciado
wretched	desgraciado
wretchedly	desgraciadamente
wretchedness	miseria
wrinkle	engurras
wrinkled	arrugado
wrinkles	engurras
wrip	adiviñar
wripped	enxugado
wripping	desnudarse
writhe	escribe
wrong	mal
wrongful	inxusto
wrongly	incorrectamente
wrought	forxado
yawn	bocexar
zap	zap
zapped	zapped
zaps	zaps
zealot	fanático
zealous	celoso
zealously	celosamente
zombie	zombie
