abound	abbondare
abounds	abbonda
abundance	abbondanza
abundant	abbondante
accessable	accessibile
accessible	accessibile
acclaim	acclamazione
acclaimed	acclamato
acclamation	acclamazione
accolade	encomio
accolades	riconoscimenti
accommodative	accomodante
accomodative	accomodanti
accomplish	realizzare
accomplished	compiuto
accomplishment	realizzazione
accomplishments	realizzazioni
accurate	preciso
achievable	realizzabile
achievement	realizzazione
achievements	realizzazioni
acumen	acume
adaptable	adattabile
adaptive	adattabile
adequate	adeguato
adjustable	regolabile
admirable	ammirevole
admirably	mirabilmente
admiration	ammirazione
admire	ammirare
admirer	ammiratore
admiring	ammirativo
adorable	adorabile
adore	adorare
adored	adorato
adorer	adoratore
adoring	adorare
adroit	abile
adroitly	abilmente
adulate	adulare
adulation	adulazione
advanced	Avanzate
advantage	vantaggio
advantageous	vantaggioso
advantageously	vantaggiosamente
advantages	vantaggi
adventuresome	avventuroso
adventurous	avventuroso
advocate	avvocato
advocated	sostenuto
advocates	sostenitori
affability	affabilità
affable	affabile
affably	affabile
affectation	affettazione
affection	affetto
affectionate	affettuoso
affinity	affinità
affirm	affermare
affirmation	affermazione
affirmative	affermativa
affluence	affluenza
affluent	affluente
afford	permettersi
affordably	conveniente
agilely	agilmente
agility	agilità
agreeable	piacevole
agreeableness	piacevolezza
agreeably	gradevolmente
alluring	allettante
altruistic	altruistico
altruistically	altruisticamente
amaze	stupire
amazed	stupito
amazement	stupore
amazes	stupisce
amazing	Stupefacente
amazingly	incredibilmente
ambitious	ambizioso
ambitiously	ambiziosamente
ameliorate	migliorare
amenable	docile
amenity	amenità
amiability	amabilità
amiable	amabile
amicable	amichevole
amicably	amichevolmente
amity	amicizia
ample	ampio
amply	ampiamente
amuse	divertire
amusing	divertente
angel	angelo
angelic	angelico
apotheosis	apoteosi
appeal	appello
appealing	attraente
applaud	applaudire
appreciable	apprezzabile
appreciate	apprezzare
appreciated	gradito
appreciates	apprezza
appreciative	riconoscente
appreciatively	apprezzamento
appropriate	adeguata
approval	approvazione
approve	approvare
ardent	ardente
ardently	ardentemente
ardor	ardore
articulate	articolare
aspiration	aspirazione
aspirations	aspirazioni
aspire	aspirare
assurance	garanzia
assurances	assicurazioni
assure	assicurare
assuredly	sicuramente
assuring	assicurando
astonish	stupire
astonished	stupito
astonishing	stupefacente
astonishingly	sorprendentemente
astonishment	stupore
astound	stupire
astounded	sbalordito
astounding	sbalorditivo
astutely	astutamente
attentive	attento
attraction	attrazione
attractive	attraente
attractively	gradevolmente
attune	armonizzare
audible	udibile
audibly	udibile
auspicious	fausto
authentic	autentico
authoritative	autorevole
autonomous	autonomo
aver	asserire
avid	avido
avidly	avidamente
award	premio
awarded	premiato
awards	premi
awe	soggezione
awed	intimorito
awesome	eccezionale
awesomely	incredibilmente
awesomeness	grandiosità
balanced	equilibrato
bargain	affare
beautiful	bellissimo
beautifully	magnificamente
beautify	abbellire
beauty	bellezza
beckon	accennare
beckoned	cenno
beckoning	cenno
beckons	Beckons
believable	credibile
beloved	Amati
benefactor	benefattore
beneficent	benefico
beneficial	benefico
beneficially	beneficamente
beneficiary	beneficiario
benefit	vantaggio
benefits	benefici
benevolence	benevolenza
benevolent	benevolo
best	migliore
best-selling	best-seller
better	meglio
blameless	irreprensibile
bless	benedire
blessing	benedizione
bliss	beatitudine
blissful	beato
blissfully	beatamente
blithe	allegro
bloom	fioritura
blossom	fiorire
bolster	sostenere
bonny	grazioso
bonus	indennità
bonuses	bonus
boost	Incremento
boundless	illimitato
bountiful	munifico
brainy	intelligente
brave	coraggioso
bravery	coraggio
bravo	Bravo
breakthrough	sfondamento
breakthroughs	innovazioni
breathlessness	affanno
breathtaking	mozzafiato
breeze	brezza
bright	luminosa
brighten	rallegrare
brilliance	brillantezza
brilliances	splendori
brilliant	brillante
brilliantly	brillantemente
brisk	vivace
brotherly	fraterno
bullish	rialzista
buoyant	galleggiante
cajole	persuadere
calm	calma
calming	calmante
calmness	quiete
capability	capacità
capable	capace
captivate	affascinare
captivating	travolgente
carefree	spensierato
catchy	orecchiabile
celebrate	celebrare
celebrated	celebre
celebration	celebrazione
celebratory	celebrativo
champ	campione
champion	campione
charisma	carisma
charismatic	carismatico
charitable	caritatevole
charm	fascino
charming	affascinante
charmingly	affascinante
chaste	casto
cheer	rallegrare
cheerful	allegro
cheery	allegro
cherish	accarezzare
cherished	caro
cherub	cherubino
chic	elegante
chivalrous	cavalleresco
chivalry	cavalleria
civility	civiltà
civilize	civilizzare
clarity	chiarezza
classic	classico
clean	pulito
cleanest	pulito
cleanliness	pulizia
cleanly	pulito
clear	chiaro
clear-cut	netto
cleared	eliminato
clearly	chiaramente
clears	cancella
clever	intelligente
cleverly	abilmente
coherence	coerenza
coherent	coerente
cohesive	coesivo
colorful	colorato
comely	avvenente
comfortable	confortevole
comfortably	comodamente
comforting	confortante
comfy	comodo
commend	lodare
commendable	lodevole
commendably	lodevolmente
commitment	impegno
commodious	spazioso
compact	compatto
compactly	compattamente
compassion	compassione
compassionate	compassionevole
compatible	compatibile
competitive	competitivo
complement	complemento
complementary	complementare
complemented	completato
complements	complementi
compliant	conforme
compliment	complimento
comprehensive	globale
conciliate	conciliare
conciliatory	conciliativo
concise	conciso
confidence	fiducia
confident	fiducioso
congenial	congeniale
congratulation	congratulazione
congratulations	complimenti
congratulatory	congratulazioni
conscientious	coscienzioso
considerate	premuroso
consistent	coerente
consistently	costantemente
constructive	costruttivo
consummate	consumato
contentment	contentezza
continuity	continuità
contrasty	contrastata
contribution	contributo
convenience	convenienza
convenient	conveniente
conveniently	opportunamente
convincing	convincente
convincingly	convincente
cool	freddo
coolest	cool
cooperative	cooperativa
cooperatively	cooperativo
correct	corretta
correctly	correttamente
counter-attack	contrattacco
counter-attacks	Contropiede
courage	coraggio
courageous	coraggioso
courageously	coraggiosamente
courteous	Cortese
courtly	cerimonioso
covenant	patto
cozy	accogliente
creative	creativo
credence	credito
credible	credibile
crisp	croccante
cure	cura
cure-all	toccasana
cushy	comodo
cute	carina
cuteness	carineria
danken	Danken
daring	audace
daringly	audacemente
darling	tesoro
dashing	focoso
dauntless	intrepido
dawn	alba
dazzle	abbagliamento
dazzled	abbagliato
dazzling	abbagliante
dead-cheap	dead-economico
dead-on	morto
decency	decenza
decent	decente
decisive	decisivo
decisiveness	risolutezza
dedicated	dedito
defeated	sconfitto
defeating	sconfiggendo
defeats	sconfitte
defender	difensore
deference	deferenza
deft	abile
delectable	delizioso
delicacy	delicatezza
delicate	delicato
delicious	delizioso
delight	diletto
delighted	Contentissimo
delightful	delizioso
delightfully	deliziosamente
delightfulness	piacevolezza
dependable	affidabile
deservedly	meritatamente
deserving	meritevole
desirable	auspicabile
desiring	desiderando
desirous	desideroso
destiny	destino
detachable	staccabile
devout	devoto
dexterous	abile
dexterously	destramente
dextrous	abile
dignified	dignitoso
dignify	nobilitare
dignity	dignità
diligence	diligenza
diligent	diligente
diligently	diligentemente
diplomatic	diplomatico
distinction	distinzione
distinctive	distintivo
distinguished	distinto
diversified	variegato
divinely	divinamente
dominate	dominare
dominated	dominato
dominates	domina
dumbfounded	interdetto
durable	durevole
dynamic	dinamico
eager	desideroso
eagerly	avidamente
eagerness	impazienza
earnest	serio
earnestly	ardentemente
earnestness	serietà
ease	alleviare
eased	facilitato
eases	facilita
easiness	facilità
easing	facilitando
easy	facile
easygoing	affabile
ebullient	bollente
economical	economico
ecstasies	estasi
ecstasy	estasi
ecstatic	estatico
ecstatically	estaticamente
edify	edificare
educated	educato
effective	efficace
effectively	efficacemente
effectiveness	efficacia
effectual	efficace
efficacious	efficace
efficient	efficiente
effusion	versamento
effusive	espansivo
effusively	effusione
elan	Elan
elate	inebriare
elated	euforico
elation	euforia
electrify	elettrificare
elegance	eleganza
elegant	elegante
elegantly	elegantemente
elevate	elevare
eloquence	eloquenza
eloquent	eloquente
eloquently	eloquentemente
embolden	incoraggiare
eminence	eminenza
eminent	eminente
empathize	empatizzare
empathy	empatia
empower	autorizzare
empowerment	l'empowerment
enchant	incantare
enchanted	incantata
enchanting	incantevole
enchantingly	incantevolmente
encourage	incoraggiare
encouragement	incoraggiamento
encouraging	incoraggiante
encouragingly	incoraggiante
endearing	accattivante
endorse	approvare
endorsed	omologati
endorsement	approvazione
endorses	approva
endorsing	avallando
energetic	energico
energize	eccitare
engaging	avvincente
engrossing	avvincente
enhance	accrescere
enhanced	migliorata
enhancement	aumento
enhances	migliora
enjoy	godere
enjoyable	piacevole
enjoyed	goduto
enjoying	godendo
enjoyment	godimento
enjoys	gode
enlighten	illuminare
enlightenment	illuminismo
enliven	ravvivare
ennoble	nobilitare
enough	abbastanza
enrapture	rapire
enraptured	rapito
enrich	arricchire
enrichment	arricchimento
enterprising	intraprendente
entertain	intrattenere
entertaining	divertente
entertains	intrattiene
enthral	affascinare
enthrall	affascinare
enthuse	entusiasmare
enthusiasm	entusiasmo
enthusiast	appassionato
enthusiastic	entusiasta
enthusiastically	entusiasticamente
entice	allettare
enticed	allettato
enticing	allettante
enticingly	seducente
entrancing	incantevole
entrust	affidare
enviable	invidiabile
enviably	invidiabile
envious	invidioso
enviously	invidia
enviousness	invidia
envy	invidia
equitable	equo
ergonomical	ergonomico
err-free	err-gratis
erudite	erudito
ethical	etico
eulogize	elogiare
euphoria	euforia
euphoric	euforico
euphorically	euforico
evaluative	valutativo
evenly	ugualmente
eventful	movimentato
everlasting	eterno
evocative	suggestivo
exalt	esaltare
exaltation	esaltazione
exalted	esaltato
exalting	esaltando
examplary	esemplare
exceed	superare
exceeded	superato
exceeding	superiore
exceedingly	eccessivamente
exceeds	supera
excel	eccellere
excelent	eccellente
excellant	eccellente
excelled	eccelso
excellence	eccellenza
excellency	Eccellenza
excellent	eccellente
excellently	ottimamente
excels	eccelle
exceptional	eccezionale
exceptionally	eccezionalmente
excite	eccitare
excited	eccitato
excitedly	animatamente
excitement	eccitazione
excites	eccita
exciting	eccitante
excitingly	eccitante
exellent	eccellente
exemplar	esemplare
exemplary	esemplare
exhilarate	esilarare
exhilarating	esilarante
exhilaratingly	esilarante
exhilaration	euforia
exonerate	scagionare
expansive	espansivo
expeditiously	speditamente
expertly	sapientemente
exquisite	squisito
exquisitely	squisitamente
extol	esaltare
extoll	esaltare
extraordinarily	eccezionalmente
extraordinary	straordinario
exuberance	esuberanza
exuberant	esuberante
exuberantly	esuberante
exult	esultare
exultant	esultante
exultation	esultanza
exultingly	esultanza
eye-catching	accattivante
eyecatch	Eyecatch
fabulous	favoloso
fabulously	favolosamente
facilitate	facilitare
fair	giusto
fairly	abbastanza
fairness	equità
faith	fede
faithful	fedele
faithfully	fedelmente
faithfulness	fedeltà
fame	fama
famed	famoso
famous	famoso
famously	notoriamente
fancier	amatore
fancy	fantasia
fanfare	fanfara
fans	fan
fantastic	fantastico
fantastically	fantasticamente
fascinate	affascinare
fascinating	affascinante
fascination	fascino
fashionably	moda
fast	veloce
faultless	perfetto
fave	Fave
favor	favore
favorable	favorevole
favored	favorito
favorite	preferito
favour	favore
fearless	impavido
feasible	fattibile
feasibly	tenerne
feat	impresa
feisty	Esuberante
felicitous	felice
felicity	felicità
fervent	fervente
fervently	fervore
fervid	fervido
fervidly	fervidamente
fervor	fervore
festive	festivo
fidelity	fedeltà
fiery	ardente
fine	bene
fine-looking	bell'aspetto
finely	finemente
firmer	soda
first-in-class	prima-in-class
first-rate	ottimo
flashy	vistoso
flatter	lusingare
flattering	lusinghiero
flawless	perfetto
flawlessly	impeccabile
flexibility	flessibilità
flexible	flessibile
flourish	fiorire
flourishing	fiorente
fluent	fluente
flutter	svolazzare
fond	affettuoso
fondness	predilezione
foolproof	infallibile
foremost	primo
foresight	lungimiranza
formidable	formidabile
fortuitous	fortuito
fortuitously	fortuitamente
fortunate	fortunato
fortunately	fortunatamente
fortune	fortuna
fragrant	fragrante
free	gratuito
freed	liberato
freedoms	libertà
fresh	fresco
fresher	matricola
friendliness	cordialità
friendly	amichevole
frolic	folleggiare
frugal	frugale
fruitful	fruttuoso
fulfillment	compimento
fun	divertimento
futuristic	futuristico
gaiety	allegria
gaily	allegramente
gain	guadagno
gained	guadagnato
gainful	lucrativa
gaining	guadagnando
gains	utile
gallant	galante
gallantly	galantemente
geeky	geek
gem	gemma
gems	gemme
generosity	generosità
generous	generoso
generously	generosamente
genial	cordiale
genius	genio
gentle	dolce
gentlest	delicato
genuine	genuino
gifted	dotato
glad	lieto
gladden	allietare
gladly	volentieri
gladness	contentezza
glamorous	affascinante
glee	gioia
gleeful	allegro
gleefully	allegramente
glimmer	barlume
glimmering	scintillante
glisten	luccicare
glistening	scintillante
glitter	luccichio
glitz	Glitz
glorify	glorificare
glorious	glorioso
gloriously	gloriosamente
glory	gloria
glow	splendore
glowing	raggiante
godlike	divino
godsend	fortuna
gold	oro
golden	d'oro
good	bene
goodly	bello
goodness	bontà
gorgeous	bellissima
gorgeously	magnificamente
grace	grazia
graceful	grazioso
gracefully	grazia
gracious	gentile
graciously	graziosamente
grand	grande
grandeur	grandezza
grateful	grato
gratification	gratificazione
gratified	gratificato
gratifies	gratifica
gratify	gratificare
gratifying	lusinghiero
gratitude	gratitudine
great	grande
greatness	grandezza
grin	sorriso
groundbreaking	innovativo
guarantee	garanzia
guidance	guida
guiltless	innocente
gumption	buonsenso
gush	sgorgare
gutsy	coraggioso
hail	grandinare
halcyon	calmo
hale	sano
hallmark	caratteristica
hallmarks	caratteristiche
hallowed	santificato
handily	comoda
handsome	bello
handsomely	profumatamente
handy	maneggevole
happily	felicemente
happiness	felicità
happy	contento
hard-working	laborioso
hardy	ardito
harmless	innocuo
harmonious	armonioso
harmoniously	armoniosamente
harmonize	armonizzare
harmony	armonia
headway	abbrivio
heal	guarire
healthful	sano
healthy	salutare
hearten	rinfrancare
heartening	incoraggiante
heartfelt	sincero
heartily	cordialmente
heartwarming	commovente
heaven	Paradiso
heavenly	celeste
helped	aiutato
helpful	utile
helping	porzione
hero	eroe
heroic	eroico
heroically	eroicamente
heroine	eroina
high-spirited	coraggioso
hilarious	divertente
holy	santo
homage	omaggio
honest	onesto
honesty	onestà
honor	onore
honorable	onorevole
honored	onorato
honoring	onorare
hooray	urrà
hospitable	ospitale
hot	caldo
hug	abbraccio
humane	umano
humble	umile
humility	umiltà
humor	umorismo
humorous	umoristico
humorously	umoristicamente
humour	umorismo
ideal	ideale
idealize	idealizzare
ideally	idealmente
idol	idolo
idolize	idolatrare
idolized	idolatrato
idyllic	idilliaco
illuminate	illuminare
illuminating	illuminante
illumine	illuminare
illustrious	illustre
imaculate	intonso
imaginative	fantasioso
immaculate	immacolato
immaculately	immacolato
immense	immenso
impartial	imparziale
impartiality	imparzialità
impartially	imparzialmente
impassioned	appassionato
impeccable	impeccabile
impeccably	impeccabilmente
important	importante
impress	impressionare
impressed	impressionato
impresses	impressiona
impressive	impressionante
impressively	impressionante
impressiveness	imponenza
improve	Migliorare
improved	migliorata
improvement	miglioramento
improvements	miglioramenti
improves	migliora
improving	miglioramento
incredible	incredibile
incredibly	incredibilmente
indebted	indebitato
individualized	individualizzato
indulgence	indulgenza
indulgent	indulgente
industrious	industrioso
inestimable	inestimabile
inexpensive	economico
infallibility	infallibilità
infallible	infallibile
infallibly	infallibilmente
influential	influente
ingenious	ingegnoso
ingeniously	ingegnosamente
ingenuity	ingegnosità
ingenuous	ingenuo
ingenuously	ingenuamente
innocuous	innocuo
innovation	innovazione
innovative	innovativo
insightful	penetranti
insightfully	acutamente
inspiration	ispirazione
inspirational	ispirazione
inspire	ispirare
inspiring	ispiratore
instantly	immediatamente
instructive	istruttivo
instrumental	strumentale
integral	integrante
integrated	integrato
intelligence	intelligenza
intelligent	intelligente
intelligible	intelligibile
interesting	interessante
interests	interessi
intimacy	intimità
intimate	intimo
intricate	intricato
intrigue	intrigo
intriguing	intrigante
intriguingly	intrigante
intuitive	intuitivo
invaluable	inestimabile
inventive	inventivo
invigorate	rinvigorire
invigorating	tonificante
invincibility	invincibilità
invincible	invincibile
inviolable	inviolabile
inviolate	inviolato
invulnerable	invulnerabile
irreplaceable	insostituibile
irreproachable	irreprensibile
irresistible	irresistibile
irresistibly	irresistibile
jaw-droping	mascella-droping
jaw-dropping	strabiliante
jolly	gioviale
jovial	gioviale
joy	gioia
joyful	gioioso
joyfully	gioia
joyous	gioioso
joyously	Gioiosamente
jubilant	giubilante
jubilantly	giubilante
jubilate	esultare
jubilation	giubilo
judicious	giudizioso
justly	giustamente
keen	acuto
keenly	avidamente
keenness	acutezza
kindliness	gentilezza
kindly	gentilmente
kindness	gentilezza
kudos	gloria
laud	lode
laudable	lodevole
laudably	lodevolmente
lavish	sontuoso
lavishly	riccamente
lawful	legale
lawfully	legalmente
lead	condurre
leading	principale
leads	conduce
lean	magro
led	guidato
legendary	leggendario
leverage	leva
levity	leggerezza
liberate	liberare
liberation	liberazione
liberty	libertà
lifesaver	salvavita
light-hearted	spensierato
lighter	accendino
likable	attraente
like	piace
likes	piace
liking	simpatia
lionhearted	audace
lively	vivace
logical	logico
lovable	amabile
love	amore
loved	amato
loveliness	bellezza
lovely	bello
lover	amante
loving	amorevole
loyal	leale
loyalty	lealtà
lucid	lucido
lucidly	lucidamente
luck	fortuna
luckiness	fortuna
lucky	fortunato
lucrative	lucrativo
luminous	luminoso
lush	lussureggiante
luster	lustro
lustrous	lustro
luxuriant	lussureggiante
luxuriate	lussureggiare
luxurious	lussuoso
luxuriously	lussuosamente
luxury	lusso
lyrical	lirico
magic	Magia
magical	magico
magnanimous	magnanimo
magnanimously	magnanimamente
magnificence	magnificenza
magnificent	magnifico
magnificently	magnificamente
majestic	maestoso
majesty	maestà
manageable	trattabile
maneuverable	maneggevole
marvel	meraviglia
marveled	meravigliato
marvelled	meravigliato
marvellous	meravigliosa
marvelous	meravigliosa
marvelously	meravigliosamente
marvels	meraviglie
master	maestro
masterful	imperioso
masterfully	magistralmente
masterpiece	capolavoro
masterpieces	capolavori
masters	maestri
mastery	padronanza
matchless	incomparabile
mature	maturo
maturely	maturo
maturity	scadenza
meaningful	significativo
memorable	memorabile
merciful	misericordioso
mercifully	misericordiosamente
mercy	misericordia
merit	merito
meritorious	meritorio
merrily	allegramente
merriment	allegria
merriness	allegria
merry	allegro
mesmerize	ipnotizzare
mesmerized	ipnotizzato
mesmerizes	ipnotizza
mesmerizing	ipnotizzante
meticulous	meticoloso
meticulously	meticolosamente
mightily	potentemente
mighty	potente
mind-blowing	mente-blowing
miracle	miracolo
miracles	miracoli
miraculous	miracoloso
miraculously	miracolosamente
modern	moderno
modest	modesto
modesty	modestia
momentous	importante
monumental	monumentale
monumentally	monumentalmente
morality	moralità
motivated	motivata
multi-purpose	multiuso
navigable	navigabile
neat	pulito
neatly	ordinatamente
nice	simpatico
nicely	piacevolmente
nifty	elegante
nimble	agile
noble	nobile
nobly	nobilmente
noiseless	silenzioso
notably	segnatamente
nourish	nutrire
nourishing	nutriente
nourishment	nutrimento
novelty	novità
nurturing	nutrimento
oasis	oasi
obsession	ossessione
obsessions	ossessioni
obtainable	ottenibile
openly	apertamente
openness	apertura
optimal	ottimale
optimism	ottimismo
optimistic	ottimista
opulent	opulento
orderly	ordinato
originality	originalità
outdo	superare
outperformed	sovraperformato
outperforming	sovraperformance
outperforms	Sorpassa
outshine	eclissare
outshone	eclissato
outstanding	eccezionale
outstandingly	eccezionale
outstrip	superare
ovation	ovazione
overjoyed	felicissimo
overtake	sorpassare
overtaken	superato
overtakes	sorpassi
overtaking	sorpasso
overtook	superato
pain-free	indolore
painless	indolore
painlessly	indolore
palatial	sontuoso
pamper	coccolare
pampered	coccolati
pampers	coccola
panoramic	panoramico
paradise	Paradiso
paramount	supremo
pardon	perdono
passion	passione
passionate	appassionato
passionately	appassionatamente
patience	pazienza
patient	paziente
patiently	pazienza
patriot	patriota
patriotic	patriottico
peace	pace
peaceable	pacifico
peacefully	pacificamente
peach	pesca
peerless	impareggiabile
pepping	Pepping
peppy	energico
perfect	perfezionare
perfection	perfezione
perfectly	perfettamente
permissible	ammissibile
perseverance	perseveranza
persevere	perseverare
personages	personaggi
personalized	personalizzato
phenomenal	fenomenale
phenomenally	fenomenale
picturesque	pittoresco
piety	religiosità
pinnacle	pinnacolo
playful	giocoso
playfully	giocosamente
pleasant	piacevole
pleasantly	piacevolmente
pleased	contento
pleases	aggrada
pleasing	piacevole
pleasingly	piacevolmente
pleasurable	piacevole
pleasurably	piacevolmente
pleasure	piacere
plentiful	abbondante
pluses	plus
plush	felpa
poetic	poetico
poeticize	poeticizzare
poignant	commovente
poise	equilibrio
polished	lucidato
polite	gentile
politeness	cortesia
popular	popolare
portable	portatile
posh	elegante
positive	positivo
positively	positivamente
positives	positivi
powerful	potente
praise	lode
praiseworthy	lodevole
praising	lodando
pre-eminent	preminente
precious	prezioso
precise	preciso
precisely	precisamente
preeminent	preminente
prefer	preferire
preferable	preferibile
preferably	preferibilmente
prefered	preferito
preferring	preferendo
prefers	preferisce
prestige	prestigio
prestigious	prestigioso
prettily	graziosamente
pretty	bella
priceless	inestimabile
pride	orgoglio
privilege	privilegio
privileged	privilegiato
prize	premio
proactive	proattivi
prodigious	prodigioso
prodigiously	prodigiosamente
prodigy	prodigio
productive	produttivo
productively	produttivamente
proficient	competente
proficiently	abilmente
profound	profondo
profoundly	profondamente
profuse	profuso
profusion	profusione
progress	progresso
progressive	progressivo
prolific	prolifico
prominence	prominenza
prominent	prominente
promise	promettere
promised	promesso
promises	promesse
promising	promettente
promoter	promotore
prompt	richiesta
promptly	prontamente
proper	corretto
properly	propriamente
propitious	propizio
propitiously	propizio
pros	professionisti
prosper	prosperare
prosperity	prosperità
prosperous	prospero
protect	proteggere
protection	protezione
protective	protettivo
proud	orgoglioso
proven	comprovata
proves	dimostra
providence	provvidenza
proving	dimostrando
prowess	prodezza
prudence	prudenza
prudent	prudente
prudently	prudentemente
punctual	puntuale
pure	puro
purify	purificare
purposeful	intenzionale
quaint	pittoresco
qualified	qualificato
qualify	qualificarsi
quiet	silenzioso
radiance	splendore
radiant	radiante
rapid	rapido
rapport	rapporto
rapt	rapito
rapture	rapimento
rapturous	estatico
rational	razionale
razor-sharp	affilatissimo
reachable	raggiungibile
readable	leggibile
readily	prontamente
ready	pronto
reaffirm	riaffermare
reaffirmation	riaffermazione
realistic	realistico
realizable	realizzabile
reasonable	ragionevole
reasonably	ragionevolmente
reasoned	motivata
reassurance	rassicurazione
reassure	rassicurare
receptive	ricettivo
reclaim	reclamare
recomend	raccomandare
recommend	raccomandare
recommendation	raccomandazione
recommendations	raccomandazioni
recommended	consigliato
reconcile	riconciliare
reconciliation	riconciliazione
recover	recuperare
recovery	recupero
rectification	rettifica
rectify	rettificare
rectifying	rettifica
redeem	riscattare
redeeming	redentrice
redemption	redenzione
refine	raffinare
refined	raffinato
refinement	raffinatezza
reform	riforma
reformed	riformato
reforming	riforma
reforms	riforme
refresh	ricaricare
refreshed	rinfrescato
refreshing	rinfrescante
refund	rimborso
refunded	rimborsato
regal	regale
regally	regalmente
regard	considerare
rejoice	rallegrarsi
rejoicing	gioia
rejuvenate	ringiovanire
rejuvenated	ringiovanito
rejuvenating	rigenerante
relaxed	rilassato
relent	cedere
reliable	affidabile
reliably	affidabile
relief	sollievo
relish	assaporare
remarkable	notevole
remarkably	notevolmente
remedy	rimedio
remission	remissione
remunerate	retribuire
renaissance	Rinascimento
renewed	rinnovato
renown	fama
renowned	rinomato
replaceable	sostituibile
reputable	rispettabile
reputation	reputazione
resilient	resiliente
resolute	risoluto
resound	echeggiare
resounding	clamoroso
resourcefulness	intraprendenza
respect	rispetto
respectable	rispettabile
respectful	rispettoso
respectfully	rispettosamente
respite	tregua
resplendent	risplendente
restful	riposante
restored	restaurato
restructure	ristrutturare
restructured	ristrutturato
restructuring	ristrutturazione
retractable	retrattile
revel	baldoria
revelation	rivelazione
revere	riverire
reverence	riverenza
reverent	riverente
reverently	riverenza
revitalize	ravvivare
revival	rinascita
revive	rivivere
revives	rianimazioni
revolutionary	rivoluzionario
revolutionize	rivoluzionare
revolutionized	rivoluzionato
revolutionizes	rivoluziona
reward	ricompensa
rewarding	gratificante
rewardingly	Incredibilmente
rich	ricco
richly	riccamente
richness	ricchezza
right	destra
righteous	giusto
righteously	giustamente
righteousness	giustizia
rightful	legittimo
rightfully	giustamente
rightly	giustamente
rightness	giustezza
robust	robusto
romantic	romantico
romantically	romanticamente
roomy	spazioso
rosy	roseo
safe	sicuro
safely	tranquillamente
sagacity	sagacia
sagely	saggemente
saint	santo
saintliness	santità
salutary	salutare
salute	saluto
satisfactory	soddisfacente
satisfied	soddisfatto
satisfies	soddisfa
satisfy	soddisfare
satisfying	soddisfacente
saver	risparmiatore
savings	risparmi
savior	salvatore
savvy	esperto
scenic	panoramico
seasoned	condito
secure	sicuro
selective	selettivo
self-determination	autodeterminazione
self-satisfaction	autocompiacimento
self-sufficiency	autosufficienza
self-sufficient	autosufficiente
sensation	sensazione
sensational	sensazionale
sensationally	clamorosamente
sensations	sensazioni
sensible	sensibile
sensibly	Sensibilmente
sensitive	sensibile
serene	sereno
serenity	serenità
sharp	acuto
shimmering	scintillante
shine	brillare
shiny	brillante
significant	significativo
silent	silenzioso
simplified	semplificato
simplifies	semplifica
simplify	semplificare
simplifying	semplificando
sincere	sincero
sincerity	sincerità
skill	abilità
skilled	qualificato
skillful	abile
skillfully	abilmente
sleek	elegante
smart	inteligente
smartly	elegantemente
smile	Sorriso
smiles	sorrisi
smiling	sorridente
smilingly	sorridendo
smitten	colpito
smooth	liscio
smoothes	leviga
smoothest	liscio
smoothly	liscio
snappy	elegante
sociable	socievole
soft	morbido
solace	conforto
solicitous	sollecito
solicitously	sollecitudine
solid	solido
solidarity	solidarietà
soothe	lenire
soothingly	rassicurante
sophisticated	sofisticato
soulful	sentimentale
soundly	sonoramente
soundness	solidità
spacious	spazioso
sparkle	scintillare
sparkling	scintillante
spectacular	spettacolare
spectacularly	spettacolare
speedily	velocemente
speedy	veloce
spellbind	affascinare
spellbound	incantato
spirited	brioso
spiritual	spirituale
splendid	splendida
splendidly	splendidamente
splendor	splendore
spontaneous	spontaneo
sporty	sportivo
spotless	immacolato
sprightly	arzillo
stability	stabilità
stabilize	stabilizzare
stable	stabile
stainless	inossidabile
standout	spicca
state-of-the-art	all'avanguardia
stately	maestoso
statuesque	statuario
staunch	convinto
steadfast	costante
steadfastly	fermamente
steadfastness	fermezza
steadiness	costanza
steady	costante
stellar	stellare
stimulate	stimolare
stimulates	stimola
stimulating	stimolante
straighten	raddrizzare
straightforward	schietto
streamlined	aerodinamico
striking	suggestivo
strikingly	sorprendentemente
striving	sforzandosi
strong	forte
stunned	stordito
stunning	sbalorditivo
stunningly	incredibilmente
stupendous	stupendo
stupendously	stupendamente
sturdy	robusto
stylish	elegante
stylishly	elegantemente
stylized	stilizzato
suave	soave
subsidize	sovvenzionare
subsidized	sovvenzionato
subsidizes	sovvenziona
subsidizing	sovvenzionando
substantive	sostanziale
succeeded	successo
succeeding	successivo
succeeds	riesce
success	successo
successes	successi
successful	riuscito
suffice	bastare
sufficed	sufficiente
sufficient	sufficiente
sufficiently	sufficientemente
suitable	adatto
sumptuous	sontuoso
sumptuously	sontuosamente
sumptuousness	sontuosità
superb	superbo
superbly	superbamente
superior	superiore
superiority	superiorità
supple	flessibile
support	supporto
supported	supportato
supporter	sostenitore
supporting	supporto
supportive	supporto
supports	supporti
supremacy	supremazia
supreme	supremo
supremely	supremamente
supurbly	superbamente
surmount	superare
surpass	superare
surreal	surreale
survival	sopravvivenza
survivor	sopravvissuto
sustainability	sostenibilità
sustainable	sostenibile
swank	ostentazione
swanky	sciccoso
sweeping	radicale
sweet	dolce
sweeten	addolcire
sweetheart	Tesoro
sweetly	dolcemente
sweetness	dolcezza
swift	veloce
swiftness	sveltezza
talent	talento
talented	talentuoso
talents	talenti
tantalize	stuzzicare
tantalizing	allettante
tempt	tentare
tempting	allettante
tenacious	tenace
tenaciously	tenacemente
tenacity	tenacia
tender	tenero
tenderly	teneramente
terrific	terribile
thank	grazie
thankful	grato
thoughtful	riflessivo
thoughtfully	pensierosamente
thoughtfulness	pensosità
thrift	parsimonia
thrifty	parsimonioso
thrill	brivido
thrilled	entusiasti
thrilling	eccitante
thrills	emozioni
thrive	prosperare
thriving	fiorente
thumb-up	pollice-up
tickle	solletico
tidy	ordinato
timely	tempestivo
tingle	formicolare
titillate	titillare
titillating	pruriginoso
togetherness	solidarieta
tolerable	tollerabile
top	superiore
tops	cime
tough	difficile
traction	trazione
tranquil	tranquillo
transparent	trasparente
treasure	Tesoro
tremendously	tremendamente
triumph	trionfo
triumphal	trionfale
triumphant	trionfante
triumphantly	trionfalmente
trivially	banalmente
trophy	trofeo
trump	briscola
trumpet	tromba
trust	fiducia
trusting	fiducia
trustworthiness	attendibilità
trustworthy	fidato
trusty	fidato
truthful	veritiero
truthfully	sinceramente
truthfulness	veracità
ultra-crisp	ultra-nitido
unabashed	imperturbabile
unabashedly	sfacciatamente
unassailable	inattaccabile
unbeatable	imbattibile
unbiased	imparziale
unbound	Unbound
uncomplicated	semplice
unconditional	incondizionato
undaunted	imperterrito
understandable	comprensibile
undisputably	indiscutibilmente
undisputed	indiscusso
unequivocal	inequivocabile
unequivocally	inequivocabilmente
unfazed	impassibile
unforgettable	indimenticabile
unity	unità
unlimited	illimitato
unmatched	impareggiabile
unparalleled	ineguagliabile
unquestionable	indiscutibile
unquestionably	indiscutibilmente
unreal	irreale
unrestricted	illimitato
unselfish	altruista
unwavering	incrollabile
upbeat	ottimista
upgradable	aggiornabile
upgradeable	aggiornabile
upgraded	aggiornato
upheld	confermata
uphold	sostenere
uplift	sollevamento
uplifting	edificante
usable	utilizzabile
useable	utilizzabile
useful	utile
valiant	valoroso
valiantly	valorosamente
valor	valore
valuable	prezioso
variety	varietà
venerate	venerare
verifiable	verificabile
veritable	vero
versatility	versatilità
vibrant	vibrante
vibrantly	vibrante
victorious	vittorioso
victory	vittoria
viewable	visualizzabile
vigilance	vigilanza
vigilant	vigile
virtue	virtù
virtuous	virtuoso
virtuously	onestamente
visionary	visionario
vivacious	vivace
vivid	vivido
vouch	garantire
warm	caldo
warmly	calorosamente
warmth	calore
wealthy	ricco
welcome	benvenuto
well	bene
well-balanced	equilibrato
well-behaved	beneducato
well-being	benessere
well-bred	beneducato
well-known	notorio
well-mannered	educato
well-wishers	sostenitori
wellbeing	benessere
wholesome	sano
whoooa	Whoooa
wieldy	maneggevole
willing	disposto
willingly	volentieri
win	vincere
windfall	manna
winner	vincitore
winners	vincitori
winning	vincente
wins	vittorie
wisdom	saggezza
wise	saggio
witty	spiritoso
wonder	meravigliarsi
wonderful	meraviglioso
wonderfully	meravigliosamente
wonders	meraviglie
wondrous	meraviglioso
woo	corteggiare
work	lavoro
workable	lavorabile
worked	lavorato
works	lavori
worthiness	merito
worthwhile	utile
worthy	degno
wow	Wow
wowed	entusiasmato
wowing	allietando
yay	Sìì
youthful	giovanile
zeal	zelo
zenith	zenit
zest	gusto
zippy	vigoroso
2-faces	2-facce
abnormal	anormale
abolish	abolire
abominable	abominevole
abominably	abominevolmente
abominate	abominare
abomination	abominio
abort	abortire
aborted	abortito
aborts	interrompe
abrade	erodere
abrasive	abrasivo
abrupt	brusco
abruptly	improvvisamente
abscond	scappare
absence	assenza
absent-minded	distratto
absentee	assente
absurd	assurdo
absurdity	assurdità
absurdly	assurdo
absurdness	assurdità
abuse	abuso
abused	abusato
abuses	abusi
abusive	abusivo
abysmal	abissale
abysmally	abissalmente
abyss	abisso
accidental	accidentale
accost	accostare
accursed	maledetto
accusation	accusa
accusations	accuse
accuse	accusare
accuses	accusa
accusing	accusando
acerbically	aspramente
ache	dolore
ached	doleva
aches	dolori
achey	Achey
aching	dolorante
acrid	acre
acrimonious	acrimonioso
acrimony	acrimonia
adamant	inflessibile
adamantly	categoricamente
addict	dipendente
addicted	dipendente
addicting	avvincente
addicts	tossicodipendenti
admonish	ammonire
admonisher	ammonitore
admonishingly	ammonitore
admonishment	ammonimento
admonition	ammonizione
adulterate	adulterare
adulterated	alterato
adulteration	adulterazione
adversarial	contraddittorio
adversary	avversario
adverse	avverso
adversity	avversità
afflict	affliggere
affliction	afflizione
affront	affronto
afraid	impaurito
aggravate	aggravare
aggravating	aggravante
aggravation	aggravamento
aggression	aggressione
aggressive	aggressivo
aggressiveness	aggressività
aggressor	aggressore
aggrieve	addolorare
aggrieved	addolorato
aghast	inorridito
agonies	agonie
agonize	agonizzare
agonizing	agonizzante
agonizingly	agonisingly
agony	agonia
ailing	malaticcio
ailment	malattia
alarm	allarme
alarmed	allarmato
alarming	allarmante
alarmingly	allarmante
alienate	alienare
alienated	alienato
alienation	alienazione
allegation	allegazione
allegations	accuse
allege	asserire
allergic	allergico
allergies	allergie
allergy	allergia
aloof	distaccato
altercation	alterco
ambiguity	ambiguità
ambiguous	ambiguo
ambivalence	ambivalenza
ambivalent	ambivalente
ambush	imboscata
amiss	male
amputate	amputare
anarchism	anarchia
anarchist	anarchico
anarchistic	anarchica
anarchy	anarchia
anemic	anemico
anger	rabbia
angrily	irosamente
angry	arrabbiato
anguish	angoscia
animosity	animosità
annihilate	annientare
annihilation	annientamento
annoy	infastidire
annoyance	fastidio
annoyances	fastidi
annoyed	infastidito
annoying	fastidioso
annoyingly	fastidiosamente
annoys	infastidisce
anomalous	anomalo
anomaly	anomalia
antagonism	antagonismo
antagonist	antagonista
antagonistic	antagonistico
antagonize	inimicarsi
anti-american	anti-americano
anti-israeli	anti-israeliana
anti-occupation	anti-occupazione
anti-proliferation	anti-proliferazione
anti-semites	antisemiti
anti-social	antisociale
anti-white	anti-bianco
antipathy	antipatia
antiquated	antiquato
antithetical	antitetico
anxieties	ansie
anxiety	ansia
anxious	ansioso
anxiousness	ansia
apathetic	apatico
apathy	apatia
apocalypse	apocalisse
apocalyptic	apocalittico
apologist	apologeta
apologists	apologeti
appal	atterrire
appall	atterrire
appalled	inorridito
appalling	terribile
appallingly	spaventosamente
apprehension	apprensione
apprehensions	apprensioni
apprehensive	apprensivo
apprehensively	apprensione
arbitrary	arbitrario
arcane	arcano
archaic	arcaico
arduous	arduo
argumentative	polemico
arrogance	arroganza
arrogant	arrogante
arrogantly	arrogantemente
asinine	stupido
asperse	calunniare
aspersion	aspersione
aspersions	calunnie
assail	assalire
assassin	assassino
assassinate	assassinare
assault	assalto
atrocious	atroce
atrocities	atrocità
atrocity	atrocità
atrophy	atrofia
attack	attacco
attacks	attacchi
audacious	audace
audaciously	audacemente
audacity	audacia
austere	austero
authoritarian	autoritario
autocrat	autocrate
autocratic	autocratico
avalanche	valanga
avarice	avarizia
avaricious	avaro
avariciously	avarizia
avenge	vendicare
averse	avverso
aversion	avversione
aweful	pessima
awful	terribile
awfully	terribilmente
awfulness	terribilità
awkward	scomodo
awkwardness	imbarazzo
ax	ascia
babble	balbettio
back-logged	back-registrati
back-wood	back-legno
back-woods	back-boschi
backbite	calunniare
backbiting	maldicenza
backward	arretrato
backwardness	arretratezza
bad	cattivo
badly	male
baffle	deflettore
baffled	sconcertato
baffling	sconcertante
bait	esca
balk	ostacolo
banal	banale
banalize	banalizzare
bane	veleno
banish	bandire
banishment	esilio
bankrupt	fallito
barbarian	barbaro
barbaric	barbaro
barbarically	barbaramente
barbarity	barbarie
barbarous	barbaro
barbarously	barbaramente
barren	sterile
baseless	infondato
bashful	vergognoso
bashing	colpire
bastard	bastardo
bastards	bastardi
battered	malconcio
battering	avariato
batty	pazzo
bearish	ribassista
beastly	bestiale
bedlam	manicomio
bedlamite	pazzo
befoul	insudiciare
beg	elemosinare
beggar	mendicante
beggarly	povero
begging	accattonaggio
beguile	ingannare
belated	tardivo
beleaguer	assediare
belie	smentire
belittle	sminuire
belittled	sminuito
belittling	sminuire
bellicose	bellicoso
belligerence	belligeranza
belligerent	belligerante
belligerently	bellicoso
bemoan	lamentarsi
bemoaning	lamentando
bemused	perplesso
bent	piegato
berate	rimproverare
bereave	spogliare
bereavement	lutto
bereft	privo
berserk	frenetico
beseech	supplicare
beset	assalire
besiege	assediare
besmirch	imbrattare
bestial	bestiale
betray	tradire
betrayal	tradimento
betrayals	tradimenti
betrayer	traditore
betraying	tradire
betrays	tradisce
bewail	lamentare
beware	diffidare
bewilder	disorientare
bewildered	sconcertato
bewildering	sconcertante
bewilderment	smarrimento
bewitch	ammaliare
bias	pregiudizio
biased	parziale
biases	pregiudizi
bicker	bisticciare
bickering	battibecco
bigotry	bigottismo
bitch	cagna
bitchy	bisbetico
biting	pungente
bitter	amaro
bitterly	amaramente
bitterness	amarezza
bizarre	bizzarro
blab	spifferare
blabber	chiacchierone
blackmail	ricatto
blah	bla
blame	colpa
blameworthy	biasimevole
bland	blando
blandish	blandire
blaspheme	bestemmiare
blasphemous	blasfemo
blasphemy	bestemmia
blasted	maledetto
blatant	sfacciato
blatantly	platealmente
blather	ciarlare
bleak	brullo
bleakness	squallore
bleed	sanguinare
bleeding	emorragia
bleeds	sanguina
blemish	macchia
blind	cieco
blinding	accecante
blindingly	accecante
blister	bolla
blistering	vesciche
bloated	gonfio
blockage	ostruzione
blockhead	stupido
bloodthirsty	sanguinario
bloody	sanguinoso
blotchy	macchiata
blow	soffio
blunder	abbaglio
blunders	errori
blunt	smussato
blur	sfocatura
blurred	sfocato
blurring	sfocatura
blurry	sfocato
blurs	sfocature
blurt	spifferare
boastful	vanagloriosi
boggle	trasecolare
bogus	finto
boil	Bollire
boiling	bollente
boisterous	chiassoso
bomb	bomba
bombard	bombardare
bombardment	bombardamento
bombastic	ampolloso
bondage	servitù
bore	foro
bored	annoiato
bores	fori
boring	noioso
botch	pasticcio
bother	preoccuparsi
bothered	seccato
bothering	fastidioso
bothers	fastidio
bothersome	fastidioso
bowdlerize	espurgare
boycott	boicottare
braggart	spaccone
brash	insolente
brat	monello
bravado	bravata
brazen	sfacciato
brazenly	sfacciatamente
brazenness	sfacciataggine
breach	violazione
break	rompere
break-up	rottura
break-ups	break-up
breakdown	abbattersi
breaking	rottura
breaks	pause
breakup	rottura
breakups	rotture
bribery	corruzione
brimstone	zolfo
bristle	setola
brittle	fragile
broke	rotto
broken	rotto
broken-hearted	affranto
brood	covata
bruise	livido
bruised	contuso
bruises	contusioni
bruising	ecchimosi
brusque	brusco
brutal	brutale
brutalising	brutalizzante
brutalities	brutalità
brutality	brutalità
brutalize	abbrutire
brutalizing	brutalizzante
brutally	brutalmente
brute	bruto
brutish	brutale
buckle	fibbia
bug	insetto
bugging	intercettazioni
buggy	passeggino
bugs	bug
bulkier	ingombranti
bulkiness	voluminosità
bulky	ingombrante
bull****	Toro****
bull----	Toro----
bullies	bulli
bullshit	cazzate
bully	prepotente
bullying	bullismo
bum	culo
bump	urto
bumped	urtato
bumping	urtando
bumps	urti
bumpy	accidentato
bungle	pasticciare
bungler	pasticcione
bunk	cuccetta
burden	fardello
burdensome	gravoso
burn	bruciare
burned	bruciato
burning	ardente
burns	ustioni
bust	busto
busts	busti
busybody	ficcanaso
butcher	macellaio
buzzing	ronzio
byzantine	bizantino
cackle	schiamazzare
calamities	calamità
calamitous	calamitoso
calamity	calamità
callous	insensibile
calumniate	calunniare
calumnies	calunnie
calumnious	calunnioso
calumny	calunnia
cancer	cancro
cancerous	canceroso
cannibal	cannibale
cannibalize	cannibalizzare
capitulate	arrendersi
capricious	capriccioso
capriciously	capricciosamente
capriciousness	capricciosità
capsize	capovolgersi
careless	negligente
carelessness	trascuratezza
caricature	caricatura
carnage	carneficina
carp	carpa
castigate	castigare
castrated	castrato
casualty	vittima
cataclysm	cataclisma
cataclysmic	cataclisma
cataclysmically	cataclisma
catastrophe	catastrofe
catastrophes	catastrofi
catastrophic	catastrofico
catastrophically	catastroficamente
catastrophies	catastrofi
caustic	caustico
caustically	causticamente
cautionary	cauzionale
cave	grotta
censure	censura
chafe	logorare
chaff	pula
chagrin	disappunto
challenging	stimolante
chaos	caos
chaotic	caotico
chasten	castigare
chastise	castigare
chastisement	castigo
chatter	vibrazione
chatterbox	chiacchierone
cheapen	menomare
cheat	truffare
cheated	truffato
cheater	imbroglione
cheating	imbrogliare
cheats	trucchi
checkered	scacchi
cheerless	triste
cheesy	formaggio
chide	rimproverare
childish	infantile
chill	freddo
chilly	freddo
choke	soffocare
choleric	collerico
choppy	increspato
chore	lavoretto
chronic	cronico
chunky	grosso
clamor	clamore
clamorous	clamoroso
clash	scontro
cliche	cliché
clique	cricca
clog	zoccolo
clogged	intasato
clogs	zoccoli
cloud	nube
clouding	annebbiamento
cloudy	nuvoloso
clumsy	maldestro
clunky	goffo
coarse	grossolano
cocky	spavaldo
coerce	costringere
coercion	coercizione
coercive	coercitivo
cold	freddo
coldly	freddamente
collapse	crollo
collusion	collusione
combative	combattivo
comical	comico
commiserate	commiserare
commotion	confusione
commotions	commozioni
complacent	compiaciuto
complain	lamentarsi
complained	lamentato
complaining	lamentarsi
complaint	denuncia
complex	complesso
complicated	complicato
complication	complicazione
complicit	complici
compulsion	costrizione
compulsive	compulsivo
concede	concedere
conceded	concesso
conceit	presunzione
conceited	presuntuoso
concern	preoccupazione
concerns	preoccupazioni
concession	concessione
concessions	concessioni
condemn	condannare
condemnable	condannabile
condemnation	condanna
condemned	condannato
condemns	condanna
condescend	condiscendere
condescending	condiscendente
condescendingly	condiscendente
condescension	condiscendenza
confess	confessare
confession	confessione
confessions	confessioni
confined	confinato
conflict	conflitto
conflicted	conflitto
conflicting	conflitto
conflicts	conflitti
confound	confondere
confounded	confuso
confounding	confusione
confront	affrontare
confrontation	confronto
confrontational	conflittuale
confuse	confuso
confused	confuso
confuses	confonde
confusing	confusione
confusion	confusione
confusions	confusioni
congested	congestionato
congestion	congestione
conservative	prudente
conspicuous	cospicuo
conspicuously	cospicuamente
conspiracies	cospirazioni
conspiracy	cospirazione
conspirator	cospiratore
conspiratorial	complice
conspire	cospirare
consternation	sbigottimento
contagious	contagioso
contaminate	contaminare
contaminated	contaminati
contaminates	contamina
contaminating	contaminando
contamination	contaminazione
contempt	disprezzo
contemptible	spregevole
contemptuous	sprezzante
contemptuously	sprezzante
contend	contendersi
contention	contesa
contentious	contenzioso
contort	contorcere
contortions	contorsioni
contradict	contraddire
contradiction	contraddizione
contradictory	contraddittorio
contrariness	contrarietà
contravene	contravvenire
contrive	escogitare
contrived	artificiosa
controversial	controverso
controversy	controversia
convoluted	involuto
corrode	corrodersi
corrosion	corrosione
corrosions	corrosioni
corrosive	corrosivo
corrupt	corrotto
corrupted	corrotti
corrupting	corruttore
corruption	corruzione
corrupts	corrompe
costly	costoso
counter-productive	controproducente
counterproductive	controproducente
covetous	avido
coward	codardo
cowardly	vigliaccamente
crabby	scorbutico
crack	crepa
cracked	screpolato
cracks	crepe
craftily	astutamente
crafty	furbo
cramp	crampo
cramped	ristretto
cramping	crampi
cranky	irritabile
crappy	scadente
crash	schianto
crashed	incidentato
crashing	schiantarsi
crass	grossolano
craven	codardo
cravenly	vigliaccamente
craze	mania
crazily	follemente
craziness	follia
crazy	pazzo
creak	scricchiolare
creaking	cigolio
creaks	scricchiola
credulous	credulo
creep	strisciamento
creeping	strisciante
creeps	brividi
creepy	raccapricciante
crept	insinuato
crime	crimine
criminal	penale
cringe	strisciare
cripple	storpio
crippled	paralizzato
cripples	storpi
crippling	paralizzante
crisis	crisi
critic	critico
critical	critico
criticism	critica
criticisms	critiche
criticize	criticare
criticized	criticato
criticizing	criticando
critics	critica
cronyism	clientelismo
crook	truffatore
crooked	storto
crooks	truffatori
crowded	affollato
crude	greggio
cruel	crudele
cruelly	crudelmente
cruelties	crudeltà
cruelty	crudeltà
crumble	crollare
crumbling	cadente
crummy	scadente
crumple	stropicciare
crumpled	spiegazzato
crumples	accartoccia
crush	schiacciare
crushed	schiacciato
crushing	schiacciamento
cry	piangere
culpable	colpevole
culprit	colpevole
cumbersome	ingombrante
cunt	fica
cunts	fiche
curse	maledizione
cursed	maledetto
curses	maledizioni
curt	conciso
cuss	maledizione
cussed	maledetto
cutthroat	assassino
cynical	cinico
cynicism	cinismo
damage	danno
damaged	danneggiato
damages	danni
damaging	danneggiamento
damn	Dannazione
damnable	dannabile
damnation	dannazione
damned	dannato
damning	schiacciante
damper	ammortizzatore
danger	Pericolo
dangerous	pericoloso
dangerousness	pericolosità
dark	buio
darken	scurire
darkened	buia
darkness	buio
dastard	vigliacco
daunt	scoraggiare
daunting	scoraggiante
dauntingly	scoraggiante
dawdle	gingillarsi
daze	stordimento
dazed	stordito
dead	morto
deadbeat	scroccone
deadly	mortale
deaf	sordo
dearth	scarsità
death	Morte
debacle	sfacelo
debase	avvilire
debasement	svilimento
debaser	Debaser
debatable	discutibile
debauch	corrompere
debaucher	corruttore
debauchery	dissolutezza
debilitate	debilitare
debilitating	debilitante
debility	debolezza
debt	debito
debts	debiti
decadence	decadenza
decadent	decadente
decay	decadimento
decayed	cariato
deceit	inganno
deceitful	ingannevole
deceitfulness	falsità
deceive	ingannare
deceiver	ingannatore
deceivers	ingannatori
deceiving	ingannando
deception	inganno
deceptive	ingannevole
deceptively	ingannevolmente
declaim	declamare
decline	declino
declines	declini
decrement	diminuzione
decrepit	decrepito
decrepitude	decrepitezza
defamation	diffamazione
defamations	diffamazioni
defamatory	diffamatorio
defame	diffamare
defect	difetto
defective	difettoso
defects	difetti
defensive	difensiva
defiance	sfida
defiant	provocatorio
deficiencies	carenze
deficiency	carenza
deficient	deficiente
defile	profanare
deform	deformare
deformed	deforme
defrauding	frodare
defunct	defunto
defy	sfidare
degenerate	degenerare
degeneration	degenerazione
degradation	degradazione
degrade	degradare
degrading	degradante
degradingly	degradante
dehumanization	disumanizzazione
dehumanize	disumanare
deign	degnare
deject	deprimere
dejected	sconsolato
dejectedly	sconsolato
dejection	sconforto
delay	ritardo
delayed	ritardato
delaying	dilatoria
delays	ritardi
delinquency	delinquenza
delinquent	delinquente
delirious	delirante
delirium	delirio
delude	illudere
deluded	illuso
deluge	diluvio
delusion	illusione
delusional	delirante
delusions	deliri
demean	avvilire
demeaning	avvilente
demise	decesso
demolish	demolire
demon	demone
demonic	demonico
demonize	demonizzare
demonized	demonizzato
demonizes	demonizza
demonizing	demonizzazione
demoralize	demoralizzare
demoralizing	demoralizzante
denial	rifiuto
denied	negato
denies	nega
denigrate	denigrare
denounce	denunciare
dense	denso
dent	ammaccatura
dented	ammaccato
dents	ammaccature
denunciation	denuncia
denunciations	denunce
deny	negare
denying	negando
deplete	esaurire
deplorable	deplorevole
deplorably	deplorevolmente
deplore	deplorare
deploring	deplorando
deploringly	deplorazione
deprave	depravare
depraved	depravato
deprecate	disapprovare
depress	deprimere
depressed	depresso
depressing	deprimente
depression	depressione
depressions	depressioni
deprive	privare
deprived	deprivato
deride	deridere
derision	derisione
derisive	derisorio
derisively	derisorio
derogatory	dispregiativo
desecrate	profanare
desert	deserto
desertion	diserzione
desiccate	essiccare
desiccated	essiccato
desolate	desolato
desolately	desolatamente
desolation	desolazione
despair	disperazione
despairing	disperato
desperate	disperato
desperately	disperatamente
desperation	disperazione
despicable	spregevole
despise	disprezzare
despised	disprezzato
despoil	depredare
despondence	sconforto
despondency	abbattimento
despondent	scoraggiato
despot	despota
despotic	dispotico
despotism	dispotismo
destabilisation	destabilizzazione
destitute	indigente
destitution	miseria
destroy	distruggere
destroyer	distruttore
destruction	distruzione
destructive	distruttivo
desultory	sconnesso
deter	scoraggiare
deteriorate	deteriorare
deteriorating	deterioramento
deterioration	deterioramento
deterrent	deterrente
detest	detestare
detestable	detestabile
detestably	detestabilmente
detested	detestato
detesting	detestando
detests	detesta
detract	detrarre
detracted	detratto
detraction	detrazione
detracts	detrae
detriment	detrimento
detrimental	dannoso
devastate	devastare
devastated	devastato
devastates	devasta
devastating	devastante
devastation	devastazione
deviate	deviare
deviation	deviazione
devil	diavolo
devilish	diabolico
devilishly	diabolicamente
devilment	diavoleria
devilry	diavoleria
devious	indiretto
devoid	privo
diabolic	diabolico
diabolical	diabolico
diabolically	diabolicamente
diametrically	diametralmente
diatribe	diatriba
diatribes	diatribe
dick	cazzo
dictator	dittatore
dictatorial	dittatoriale
die	morire
died	morto
dies	muore
difficult	difficile
difficulty	difficoltà
diffidence	timidezza
dilapidated	cadente
dilly-dally	temporeggiare
dim	offuscare
dimmer	oscuratore
din	frastuono
dings	ammaccature
dinky	grazioso
dire	terribile
dirt	sporco
dirty	sporco
disable	disattivare
disabled	Disabilitato
disaccord	disaccordo
disadvantage	svantaggio
disadvantaged	svantaggiati
disadvantageous	svantaggioso
disadvantages	svantaggi
disaffect	disamorare
disaffected	ostile
disagree	disaccordo
disagreeable	sgradevole
disagreeably	sgradevolmente
disagreed	dissentito
disagreeing	disaccordo
disagreement	disaccordo
disallow	rifiutare
disapointed	delusi
disapointing	deludente
disapointment	delusione
disappoint	deludere
disappointed	deluso
disappointing	deludente
disappointingly	deludentemente
disappointment	delusione
disappointments	delusioni
disappoints	delude
disapprobation	disapprovazione
disapproval	disapprovazione
disapprove	disapprovare
disapproving	disapprovazione
disarm	disarmare
disarray	scompiglio
disaster	disastro
disastrous	disastroso
disastrously	disastrosamente
disavow	sconfessare
disavowal	disconoscimento
disbelief	incredulità
disbeliever	miscredente
disclaim	disconoscere
discomfit	sconcertare
discomfort	sconforto
discompose	scomporre
disconcert	sconcertare
disconcerted	sconcertato
disconcerting	sconcertante
disconcertingly	sconcertante
disconsolate	sconsolato
disconsolately	sconsolato
discontent	malcontento
discontented	scontento
discontinued	interrotto
discontinuity	discontinuità
discontinuous	discontinuo
discord	discordia
discordance	discordanza
discordant	discordante
discountenance	sconcertare
discourage	scoraggiare
discouragement	scoraggiamento
discouraging	sconfortante
discouragingly	scoraggiante
discourteous	scortese
discourteously	scortesemente
discredit	discredito
discrepant	discrepante
discriminate	discriminare
discrimination	discriminazione
discriminatory	discriminatorio
disdain	disprezzo
disdained	disdegnato
disdainful	sdegnoso
disdainfully	sdegnosamente
disfavor	disgrazia
disgrace	disonore
disgraceful	vergognoso
disgracefully	vergognosamente
disgruntle	scontentare
disgruntled	scontento
disgust	disgusto
disgusted	disgustato
disgustedly	disgustato
disgustful	disgustoso
disgusting	disgustoso
disgustingly	disgustosamente
dishearten	avvilire
disheartening	scoraggiante
dishonest	disonesto
dishonestly	disonestamente
dishonesty	disonestà
dishonor	disonore
dishonorable	disonorevole
disillusion	disillusione
disillusioned	disilluso
disillusionment	disinganno
disillusions	disillusioni
disinclination	avversione
disingenuous	falso
disingenuously	malafede
disintegrate	disintegrare
disintegrated	disintegrato
disintegrates	disintegra
disintegration	disintegrazione
disinterest	disinteressare
disinterested	disinteressato
dislike	antipatia
disliked	malvisto
disliking	antipatia
dislocated	slogato
disloyal	sleale
disloyalty	slealtà
dismal	triste
dismay	sgomento
dismayed	costernato
dismaying	sconcertante
dismissive	sprezzante
dismissively	sprezzante
disobedience	disobbedienza
disobedient	disobbediente
disobey	disobbedire
disorder	disturbo
disordered	disordinato
disorderly	disordinato
disorganized	disorganizzato
disorient	disorientare
disoriented	disorientato
disown	rinnegare
disparage	screditare
disparaging	dispregiativo
disparagingly	dispregiativo
dispensable	dispensabile
dispirit	scoraggiare
dispirited	scoraggiato
dispiriting	scoraggiante
displace	spostare
displaced	sfollati
displease	dispiacere
displeased	scontento
displeasing	spiacevole
displeasure	dispiacere
disproportionate	sproporzionato
disprove	confutare
disputable	discutibile
dispute	controversia
disputed	contestato
disquiet	inquietudine
disquieting	inquietante
disquietingly	inquietante
disquietude	inquietudine
disregard	indifferenza
disreputable	sconveniente
disrepute	discredito
disrespectful	irrispettoso
disrupt	disgregare
disruption	rottura
disruptive	dirompente
dissapointed	delusi
dissappointed	delusi
dissappointing	delusione
dissatisfaction	insoddisfazione
dissatisfied	insoddisfatto
dissatisfies	ordissatisfies
dissatisfy	scontentare
dissemble	dissimulare
dissension	dissenso
dissent	dissenso
dissenter	dissidente
dissention	dissenso
disservice	disservizio
dissidence	dissidenza
dissident	dissidente
dissidents	dissidenti
dissocial	dissociale
dissolute	dissoluto
dissolution	dissoluzione
dissonance	dissonanza
dissonant	dissonante
dissuade	dissuadere
distaste	disgusto
distasteful	sgradevole
distort	falsare
distorted	distorto
distortion	distorsione
distorts	distorce
distract	distrarre
distracting	distrazione
distraction	distrazione
distraught	sconvolto
distress	angoscia
distressed	afflitto
distressing	doloroso
distrust	diffidenza
distrustful	diffidente
distrusting	diffidente
disturb	disturbare
disturbance	disturbo
disturbed	disturbato
disturbing	inquietante
disturbingly	inquietantemente
disunity	disunità
disvalue	disvalore
divergent	divergente
divisiveness	divisione
dizzy	vertiginoso
dogged	accanito
doggedly	tenacemente
dogmatic	dogmatico
doldrums	depressione
domineer	spadroneggiare
domineering	dispotico
donside	Donside
doom	destino
doomed	condannato
dope	droga
doubt	dubbio
doubtful	dubbioso
doubts	dubbi
douchebag	cretino
downcast	abbattuto
downer	Downer
downfall	Caduta
downgrade	retrocedere
downhearted	abbattuto
downhill	discesa
downside	svantaggio
downturn	recessione
downturns	flessioni
drab	grigiastro
draconian	draconiana
drag	trascinare
dragged	trascinato
dragging	trascinamento
dragoon	dragone
drags	trascina
drain	drenare
drained	drenato
draining	drenante
drastic	drastico
drastically	drasticamente
drawback	inconveniente
drawbacks	inconvenienti
dread	terrore
dreadful	terribile
dreadfully	terribilmente
dreadfulness	terribilità
dreary	triste
dripped	gocciolava
dripping	gocciolante
drips	gocciola
drones	droni
droop	abbassamento
drop-outs	cadere-out
dropouts	forcellini
drought	siccità
drowning	annegamento
drunk	ubriaco
drunkard	ubriacone
drunken	ubriaco
dubious	dubbioso
dubiously	dubbiosamente
dud	bidone
dull	noioso
dullard	tonto
dumb	muto
dumbfound	stupire
dumped	scaricati
dumps	discariche
dunce	somaro
dungeon	prigione
dungeons	dungeon
dupe	ingannare
dust	polvere
dusty	polveroso
dwindling	diminuzione
earsplitting	assordante
eccentric	eccentrico
eccentricity	eccentricità
effigy	effigie
effrontery	sfrontatezza
egocentric	egocentrico
egotism	egotismo
egotistical	egoista
egotistically	egoisticamente
egregious	egregio
egregiously	egregiamente
election-rigger	elezione-rigger
elimination	eliminazione
emaciated	emaciato
emasculate	evirare
embarrass	imbarazzare
embarrassing	imbarazzante
embarrassingly	imbarazzante
embarrassment	imbarazzo
embattled	merlato
embroil	coinvolgere
embroiled	coinvolto
emergency	emergenza
emphatic	enfatico
emphatically	enfaticamente
emptiness	vuoto
encroach	usurpare
encroachment	invasione
enemies	nemici
enemy	nemico
enervate	snervare
enfeeble	indebolire
enflame	infiammare
engulf	fagocitare
enjoin	ingiungere
enmity	inimicizia
enrage	imbestialire
enraged	inferocito
enraging	Infuriante
enslave	asservire
entangle	impigliare
entanglement	aggrovigliamento
entrap	intrappolare
entrapment	intrappolamento
envious	invidioso
enviously	invidia
enviousness	invidia
epidemic	epidemico
equivocal	equivoco
erase	cancellare
erode	erodere
erodes	erode
erosion	erosione
err	sbagliare
errant	errante
erratic	irregolare
erroneous	erroneo
erroneously	erroneamente
error	errore
errors	errori
eruptions	eruzioni
escapade	scappatella
estranged	estraniato
evade	eludere
evasion	evasione
evasive	evasivo
evildoer	malfattore
evils	mali
eviscerate	sventrare
exacerbate	esacerbare
exagerated	esagerato
exagerates	esagera
exaggerate	esagerare
exaggeration	esagerazione
exasperate	esasperare
exasperated	esasperato
exasperating	esasperante
exasperatingly	esasperatamente
exasperation	esasperazione
excessive	eccessivo
excessively	eccessivamente
exclusion	esclusione
excoriate	scorticare
excruciating	straziante
excruciatingly	atrocemente
excuse	scusa
excuses	scuse
execrate	esecrare
exhaust	scarico
exhausted	esausto
exhaustion	esaurimento
exhausts	SCARICHI
exhort	esortare
exile	esilio
exorbitant	esorbitante
expel	espellere
expensive	costoso
expire	scadere
expired	scaduto
explode	esplodere
exploit	sfruttare
exploitation	sfruttamento
explosive	esplosivo
expropriate	espropriare
expropriation	espropriazione
expunge	espungere
exterminate	sterminare
extermination	sterminio
extinguish	spegnere
extort	estorcere
extortion	estorsione
extraneous	estraneo
extravagant	stravagante
extravagantly	stravagante
extremism	estremismo
extremist	estremista
extremists	estremisti
eyesore	obbrobrio
fabricate	fabbricare
fabrication	costruzione
facetious	faceto
facetiously	scherzosamente
fail	fallire
failed	mancato
failure	fallimento
failures	fallimenti
faint	svenire
faithless	sleale
fake	falso
fall	autunno
fallacies	fallacie
fallacious	fallace
fallaciously	fallace
fallaciousness	fallacia
fallacy	fallacia
fallen	caduto
falling	caduta
fallout	cadere
falls	cascate
false	falso
falsehood	falsità
falsely	falsamente
falsify	falsificare
falter	vacillare
faltered	vacillato
famine	carestia
famished	affamato
fanatic	fanatico
fanatical	fanatico
fanatically	fanaticamente
fanaticism	fanatismo
fanatics	fanatici
fanciful	fantasioso
far-fetched	forzato
farce	farsa
farcical	farsesco
farcical-yet-provocative	farsesca-ancora-provocatorio
farfetched	inverosimile
fascism	fascismo
fascist	fascista
fastidious	fastidioso
fastidiously	fastidiosamente
fastuous	fastoso
fat	Grasso
fatal	fatale
fatalistic	fatalista
fatalistically	fatalisticamente
fatally	fatalmente
fateful	fatidico
fatefully	fatalmente
fathomless	incommensurabile
fatigue	fatica
fatigued	lasso
fatique	fatica
fatty	Grasso
fatuity	fatuità
fatuous	fatuo
fault	colpa
faults	difetti
faulty	difettoso
faze	sconcertare
fear	paura
fearful	pauroso
fears	paure
fearsome	terribile
feckless	inefficiente
feeble	debole
feign	fingere
feint	finta
fell	abbattere
felon	fellone
felonious	criminale
ferociously	ferocemente
ferocity	ferocia
fetid	fetido
fever	febbre
feverish	febbrile
fevers	febbri
fib	frottola
fickle	volubile
fiction	finzione
fictional	immaginario
fictitious	fittizio
fidget	agitarsi
fidgety	irrequieto
fiend	demone
fiendish	demoniaco
fierce	feroce
figurehead	polena
filth	sporcizia
filthy	sporco
finagle	Finagle
finicky	pignolo
fissures	fessure
fist	pugno
flabbergast	sbalordire
flabbergasted	sbalordito
flagging	segnalazione
flagrant	flagrante
flagrantly	flagrante
flair	fiuto
flak	Flak
flake	fiocco
flaking	desquamazione
flare	bagliore
flares	razzi
flaunt	ostentare
flaw	difetto
flawed	imperfetto
flaws	difetti
flee	fuggire
fleed	Fleed
flees	fugge
fleeting	fugace
flicker	barlume
flickering	tremolante
flickers	sfarfallio
flighty	capriccioso
flimsy	fragile
flirt	flirtare
flirty	provocante
floored	pavimentato
flounder	platessa
floundering	dibatte
flout	disprezzare
fluster	agitazione
foe	nemico
fool	scemo
fooled	ingannare
foolhardy	avventato
foolish	folle
foolishly	follemente
foolishness	sciocchezza
forbid	vietare
forbidden	proibito
forbidding	ostile
forceful	forte
foreboding	presentimento
forfeit	pegno
forged	forgiato
forgetful	dimentico
forgetfulness	dimenticanza
forlorn	abbandonato
forsake	abbandonare
forsaken	abbandonato
forswear	rinnegare
foul	fallo
foully	vergognosamente
foulness	sporcizia
fractious	litigioso
fracture	frattura
fragmented	frammentato
frail	fragile
frantic	frenetico
frantically	freneticamente
fraud	frode
fraudulent	fraudolento
fraught	gravido
frazzle	logorare
frazzled	esausto
freak	mostro
freaking	impazzendo
freakish	bizzarro
freaks	freak
freeze	congelare
freezing	congelamento
frenetic	forsennato
frenetically	freneticamente
frenzied	frenetico
frenzy	frenesia
fret	greca
fretful	irritabile
frets	tasti
friction	attrito
frictions	frizioni
fried	fritte
fright	paura
frighten	impaurire
frightening	spaventoso
frighteningly	spaventosamente
frightful	spaventevole
frightfully	spaventosamente
frigid	frigido
frost	brina
frown	cipiglio
froze	congelato
frozen	congelato
fruitless	infruttuoso
fruitlessly	infruttuosamente
frustrate	frustrare
frustrated	frustrato
frustrates	frustate
frustrating	frustrante
frustratingly	frustrante
frustration	frustrazione
frustrations	frustrazioni
fuck	Fanculo
fucking	cazzo
fugitive	fuggitivo
fulminate	fulminare
fumble	armeggiare
fume	fumo
fumes	vapore
fundamentalism	fondamentalismo
funky	impaurito
funnily	comicamente
funny	divertente
furious	furioso
furiously	furiosamente
furor	furore
fury	furia
fuss	confusione
fussy	schizzinoso
fusty	ammuffito
futilely	inutilmente
futility	futilità
fuzzy	sfocato
gabble	borbottio
gaff	rampone
gainsay	contraddire
gall	fiele
galling	irritante
galls	galle
garbage	spazzatura
garish	vistoso
gasp	respiro
gauche	maldestro
gaudy	sgargiante
gawky	goffo
genocide	genocidio
ghastly	orribile
gibber	borbottio
gibberish	borbottio
gibe	frecciata
giddy	stordito
gimmick	trovata
gimmicks	espedienti
gimmicky	ingannevole
glare	bagliore
glaringly	vistosamente
glib	facondo
glitches	glitch
gloom	oscurità
gloomy	cupo
glum	accigliato
glut	eccesso
gnawing	rodente
goad	pungolo
goof	cantonata
goofy	Sciocco
gossip	pettegolezzo
graft	innestare
grainy	granuloso
grapple	rampino
grate	grattugiare
grating	grata
gravely	gravemente
greasy	unto
greed	avidità
greedy	avido
grief	dolore
grievance	reclamo
grievances	rimostranze
grieve	addolorarsi
grieving	lutto
grievous	grave
grim	truce
grimace	smorfia
grind	macinare
gripe	lamentela
gripes	lamentele
grisly	macabro
gritty	grintoso
gross	schifoso
grossly	grossolanamente
grotesque	grottesco
grouch	malumore
grouchy	brontolone
groundless	infondato
growl	ringhiare
grudge	astio
grudges	rancori
grudging	invidioso
gruesome	macabro
gruff	burbero
grumble	brontolare
grumpy	scontroso
guile	astuzia
guilt	colpa
guiltily	colpevolmente
guilty	colpevole
gullible	ingenuo
gutless	codardo
gutter	grondaia
hack	mod
hacks	hack
haggard	sparuto
haggle	mercanteggiare
halfhearted	svogliato
halfheartedly	malavoglia
hallucination	allucinazione
hamper	ostacolare
hampered	ostacolato
hang	appendere
hapless	sfortunato
harangue	arringa
harass	molestare
harassed	molestati
harasses	molesti
harassment	molestia
harboring	l'ospitare
harbors	porti
hard	difficile
harden	indurire
hardened	indurito
hardship	disagio
hardships	disagi
harm	danno
harmed	offeso
harmful	dannoso
harms	Harms
harpy	arpia
harridan	strega
harried	tormentato
harrow	erpice
harsh	duro
harshly	duramente
hassle	problemi
hassles	fastidi
haste	fretta
hastily	frettolosamente
hasty	frettoloso
hate	odiare
hated	odiato
hateful	odioso
hatefully	odiosamente
haters	odiatori
hates	odia
hating	odiare
hatred	odio
haughtily	altezzosamente
haughty	altezzoso
haunt	infestare
haunting	ossessionante
havoc	devastazione
haywire	confuso
hazard	rischio
hazardous	pericoloso
haze	foschia
hazy	nebbioso
head-aches	testa-mal
heartbreaker	strage
heartbreaking	straziante
heathen	pagano
heavy-handed	maldestro
heck	diamine
heckle	molestare
hectic	febbrile
hedge	siepe
hedonistic	edonistico
heedless	disattento
hefty	forte
hegemonism	egemonismo
hegemonistic	egemonica
hegemony	egemonia
heinous	atroce
hell	inferno
hell-bent	decisa
hells	inferni
helpless	indifeso
helplessly	impotente
helplessness	impotenza
heresy	eresia
heretic	eretico
heretical	eretico
hesitant	esitante
hideous	orrendo
hideously	orribilmente
hideousness	mostruosità
high-priced	costoso
hinder	ostacolare
hindrance	ostacolo
hiss	sibilo
hissed	sibilò
hissing	sibilo
hoard	tesoro
hoax	inganno
hobble	zoppicare
hogs	maiali
hollow	cavo
hoodwink	ingannare
hooligan	teppista
hopelessly	perdutamente
horde	orda
horrendous	orrendo
horrendously	orrendamente
horrible	orribile
horrid	orrido
horrific	orribile
horrified	inorridito
horrifies	inorridire
horrify	inorridire
horrifying	orripilante
hostage	ostaggio
hostile	ostile
hostilities	ostilità
hostility	ostilità
hotbeds	focolai
hothouse	serra
hubris	tracotanza
hum	ronzio
humid	umido
humiliate	umiliare
humiliating	umiliante
humiliation	umiliazione
humming	ronzio
hung	sospeso
hurt	male
hurted	ferito
hurtful	dannoso
hurting	male
hustler	Hustler
hype	montatura
hypocricy	ipocrisia
hypocrisy	ipocrisia
hypocrite	ipocrita
hypocrites	ipocriti
hypocritical	ipocrita
hypocritically	ipocritamente
hysteria	isterismo
hysteric	isterico
hysterical	isterico
idiocies	idiozie
idiocy	idiozia
idiot	idiota
idiotic	idiota
idiots	idioti
idle	inattivo
ignoble	ignobile
ignominious	ignominioso
ignominiously	ignominiosamente
ignominy	ignominia
ignorance	ignoranza
ignorant	ignorante
ignore	ignorare
ill-advised	sconsiderato
ill-fated	sfortunato
ill-favored	sgraziato
ill-mannered	maleducato
ill-natured	cattivo
ill-sorted	ill-ordinato
ill-treated	maltrattati
ill-treatment	maltrattamenti
ill-usage	maltrattamenti
illegal	illegale
illegally	abusivamente
illegitimate	illegittimo
illicit	illecito
illiterate	analfabeta
illness	malattia
illogic	illogicità
illogical	illogico
illogically	illogicamente
illusion	illusione
illusions	illusioni
illusory	illusorio
imaginary	immaginario
imbalance	squilibrio
imbecile	imbecille
immaterial	immateriale
immature	immaturo
imminence	imminenza
imminently	imminente
immobilized	immobilizzato
immoderate	smodato
immodest	immodesto
immoral	immorale
immorality	immoralità
immovable	immobile
impair	danneggiare
impaired	alterata
impatience	impazienza
impatient	impaziente
impatiently	impazientemente
impeach	accusare
impedance	impedenza
impede	impedire
impediment	impedimento
impending	imminente
impenitent	impenitente
imperfect	imperfetto
imperfection	imperfezione
imperfections	imperfezioni
imperfectly	imperfetto
imperialist	imperialista
imperious	imperioso
imperiously	imperiosamente
impermissible	inammissibile
impersonal	impersonale
impertinent	impertinente
impetuous	impetuoso
impetuously	impetuosamente
impiety	empietà
impinge	violare
impious	empio
implacable	implacabile
implicate	implicare
implication	coinvolgimento
implode	implodere
impolite	scortese
impolitic	impolitico
importunate	importuno
importune	importunare
impose	imporre
imposing	imponente
imposition	imposizione
impossible	impossibile
impossibly	impossibile
impotent	impotente
impoverish	impoverire
impoverished	impoverito
imprecate	imprecare
imprecise	approssimativo
imprecisely	impreciso
imprecision	imprecisione
imprison	imprigionare
imprisonment	reclusione
improbability	improbabilità
improbable	improbabile
improbably	inverosimilmente
improper	improprio
impropriety	scorrettezza
imprudence	imprudenza
imprudent	imprudente
impudence	impudenza
impudent	impudente
impudently	sfacciatamente
impugn	impugnare
impulsive	impulsivo
impulsively	impulsivamente
impunity	impunità
impure	impuro
impurity	impurità
inability	incapacità
inaccuracies	inesattezze
inaccuracy	inesattezza
inaccurate	impreciso
inaccurately	impreciso
inaction	inattività
inactive	inattivo
inadequacy	inadeguatezza
inadequate	insufficiente
inadequately	inadeguatamente
inadvisable	sconsigliabile
inane	vacuo
inappropriately	impropriamente
inapt	inadatto
inarticulate	inarticolato
inattentive	disattento
inaudible	impercettibile
incapable	incapace
incautious	incauto
incendiary	incendiario
incense	incenso
incessant	incessante
incessantly	incessantemente
incite	incitare
incitement	incitamento
incivility	inciviltà
inclement	inclemente
incognizant	inconsapevole
incoherence	incoerenza
incoherent	incoerente
incoherently	incoerentemente
incommensurate	sproporzionato
incomparable	incomparabile
incomparably	incomparabilmente
incompatability	incompatibilità
incompatibility	incompatibilità
incompatible	incompatibile
incompetence	incompetenza
incompetent	incompetente
incompetently	incompetente
incomplete	incompleto
incompliant	inadempiente
incomprehensible	incomprensibile
incomprehension	incomprensione
inconceivable	inconcepibile
inconceivably	inconcepibilmente
incongruous	incongruo
inconsequent	inconseguente
inconsequential	inconseguente
inconsiderate	sconsiderato
inconsiderately	sconsiderato
inconsistence	inconsistenza
inconsistencies	incongruenze
inconsistency	incoerenza
inconsistent	incoerente
inconsolable	inconsolabile
inconsolably	inconsolabile
inconstant	incostante
inconvenience	disagio
incorrect	scorretto
incorrigible	incorreggibile
incorrigibly	incorreggibilmente
incredulous	incredulo
incredulously	Incredibilmente
inculcate	inculcare
indecency	indecenza
indecent	indecente
indecently	indecentemente
indecision	indecisione
indecisive	indeciso
indefensible	indifendibile
indelicate	indelicato
indeterminable	indeterminabile
indeterminate	indeterminato
indifference	indifferenza
indifferent	indifferente
indigent	indigente
indignant	indignato
indignantly	indignato
indignation	indignazione
indignity	indegnità
indiscernible	indiscernibile
indiscreet	indiscreto
indiscreetly	indiscretamente
indiscretion	indiscrezione
indiscriminate	indiscriminato
indiscriminately	indiscriminatamente
indiscriminating	indiscriminato
indistinguishable	indistinguibile
indoctrinate	indottrinare
indoctrination	indottrinamento
indolent	indolente
indulge	indulgere
ineffective	inefficace
ineffectively	inefficace
ineffectiveness	inefficacia
ineffectual	inefficace
ineffectually	inutilmente
ineffectualness	inefficacia
inefficacious	inefficace
inefficacy	inefficacia
inefficiency	inefficienza
inefficient	inefficiente
inefficiently	inefficiente
inelegance	ineleganza
inelegant	inelegante
ineligible	ineleggibile
inept	inetto
ineptitude	inettitudine
inequalities	disuguaglianze
inequality	disuguaglianza
inequitably	iniquo
inequities	disuguaglianze
inescapable	inevitabile
inescapably	ineluttabilmente
inevitable	inevitabile
inevitably	inevitabilmente
inexcusable	imperdonabile
inexcusably	imperdonabilmente
inexorable	inesorabile
inexorably	inesorabilmente
inexperience	inesperienza
inexperienced	inesperto
inexpert	inesperto
inexpertly	maldestramente
inexpiable	inespiabile
inexplainable	inspiegabili
inextricable	inestricabile
inextricably	inestricabilmente
infamous	infame
infamy	infamia
infected	infetto
infection	infezione
infections	infezioni
inferior	inferiore
inferiority	inferiorità
infernal	infernale
infest	infestare
infested	infestato
infidel	infedele
infidels	infedeli
infiltrator	infiltrato
infiltrators	infiltrati
infirm	infermo
inflame	infiammare
inflammation	infiammazione
inflammatory	infiammatorio
inflammed	infiammata
inflated	gonfio
inflationary	inflazionistico
inflexible	inflessibile
inflict	infliggere
infraction	infrazione
infringe	violare
infringement	violazione
infringements	violazioni
infuriated	infuriato
infuriating	esasperante
inglorious	inglorioso
ingrate	ingrato
ingratitude	ingratitudine
inhibit	inibire
inhibition	inibizione
inhospitable	inospitale
inhospitality	inospitalità
inhuman	inumano
inhumane	inumano
inhumanity	inumanità
inimical	ostile
iniquitous	iniquo
iniquity	iniquità
injure	ferire
injurious	dannoso
injury	ferita
injustice	ingiustizia
injustices	ingiustizie
innuendo	insinuazione
inoperable	inoperabile
inopportune	inopportuno
inordinate	smodato
inordinately	disordinatamente
insane	folle
insanely	follemente
insanity	follia
insatiable	insaziabile
insecure	insicuro
insecurity	insicurezza
insensible	insensibile
insensitive	insensibile
insensitivity	insensibilità
insidious	insidioso
insidiously	insidiosamente
insignificance	piccolezza
insignificant	insignificante
insignificantly	insignificante
insincere	insincero
insincerity	insincerità
insinuate	insinuare
insinuating	insinuante
insinuation	insinuazione
insolence	insolenza
insolent	insolente
insolently	insolentemente
insolvent	insolvente
instability	instabilità
instable	instabile
instigate	istigare
instigator	istigatore
instigators	istigatori
insubordinate	insubordinato
insubstantial	inconsistente
insufferable	insopportabile
insufferably	insopportabilmente
insufficiency	insufficienza
insufficient	insufficiente
insufficiently	insufficientemente
insular	insulare
insult	insulto
insulted	offeso
insulting	offensivo
insultingly	offensivamente
insults	insulti
insupportable	insopportabile
insupportably	insopportabilmente
insurmountable	insormontabile
insurmountably	insormontabile
insurrection	insurrezione
intense	intenso
interfere	interferire
interference	interferenza
interferes	interferisce
intermittent	intermittente
interrupt	interrompere
interruption	interruzione
interruptions	interruzioni
intimidate	intimidire
intimidating	intimidatorio
intimidation	intimidazione
intolerable	intollerabile
intolerance	intolleranza
intoxicate	inebriare
intractable	intrattabile
intransigence	intransigenza
intransigent	intransigente
intrude	intromettersi
intrusion	intrusione
intrusive	invadente
inundate	inondare
inundated	inondato
invader	invasore
invalidate	infirmare
invalidity	invalidità
invasive	dilagante
invective	invettiva
inveigle	adescare
invidious	spiacevole
invidiously	invidiosamente
invisible	invisibile
involuntarily	involontariamente
involuntary	involontario
irascible	irascibile
irate	irato
ire	ira
irk	infastidire
irks	Irks
irksome	seccante
irksomeness	fastidiosità
ironic	ironico
ironical	ironico
ironically	ironicamente
ironies	ironie
irony	ironia
irrational	irrazionale
irrationalities	irrazionalità
irrationality	irragionevolezza
irrationally	irrazionalmente
irrationals	irrazionali
irreconcilable	inconciliabile
irrecoverable	irrecuperabile
irrecoverableness	irrecuperabilità
irrecoverably	irrimediabilmente
irredeemable	irredimibile
irredeemably	irrimediabilmente
irreformable	irreformabile
irregular	irregolare
irregularity	irregolarità
irreparable	irreparabile
irrepressible	irrefrenabile
irresolute	irresoluto
irresolvable	irrisolvibile
irresponsible	irresponsabile
irresponsibly	irresponsabile
irretrievable	irrimediabile
irreversible	irreversibile
irritable	irritabile
irritably	irritabile
irritant	irritante
irritate	irritare
irritated	irritata
irritating	irritante
irritation	irritazione
irritations	irritazioni
isolate	isolato
isolated	isolato
isolation	isolamento
issue	problema
issues	problemi
itch	prurito
itching	pizzicore
itchy	pruriginoso
jabber	blaterare
jaded	affaticato
jagged	frastagliato
jam	marmellata
jarring	stridente
jaundiced	itterico
jealous	geloso
jealously	gelosamente
jealousy	gelosia
jeer	scherno
jeeringly	scherno
jeers	fischi
jeopardy	pericolo
jerk	cretino
jerky	convulso
jitters	nervosismo
jittery	nervoso
job-killing	lavoro-uccisione
joke	scherzo
joker	burlone
jolt	scossa
jumpy	eccitabile
junk	giunca
junky	Junky
junkyard	discarica
jutter	Jutter
jutters	Jutters
kaput	rovinato
kill	uccidere
killed	ucciso
killer	uccisore
killing	uccisione
killjoy	guastafeste
kills	uccide
knave	fante
knife	coltello
knock	battere
knotted	annodato
kooky	Kooky
lack	mancanza
lackadaisical	apatico
lacked	mancava
lackey	lacchè
lackeys	lacchè
lacking	carente
lacks	manca
laconic	laconico
lag	ritardo
lagged	lag
laggy	lag
lags	GAL
laid-off	licenziato
lame	noioso
lament	lamento
lamentable	lamentevole
languid	languido
languish	languire
languor	languore
languorous	languida
languorously	languidamente
lapse	periodo
lapsed	decaduto
lapses	decade
lascivious	lascivo
latency	latenza
laughable	ridicolo
laughably	ridicolmente
laughingstock	zimbello
lazy	pigro
leak	perdita
leakage	perdita
leakages	perdite
leaks	perdite
lecher	libertino
lecherous	lascivo
lechery	lascivia
leech	sanguisuga
leery	astuto
lemon	Limone
lengthy	lungo
lethal	letale
lethargic	letargico
lethargy	letargo
lewd	lascivo
lewdness	lascivia
liability	responsabilità
liable	responsabile
liar	bugiardo
liars	Bugiardi
licentious	licenzioso
licentiously	licenziosamente
licentiousness	licenziosità
lie	menzogna
lied	mentito
lier	Lier
lies	bugie
limit	limite
limitation	limitazione
limitations	limitazioni
limited	limitato
limits	limiti
limp	zoppicare
listless	svogliato
litigious	litigioso
livid	livido
lividly	lividamente
loath	restio
loathe	detestare
loathing	ripugnanza
loathsome	ripugnante
lone	solitario
loneliness	solitudine
lonely	solitario
loner	solitario
lonesome	solitario
long-winded	prolisso
longing	brama
longingly	nostalgia
loophole	scappatoia
loopholes	scappatoie
loose	sciolto
loot	bottino
lose	perdere
loser	perdente
losers	perdenti
loses	perde
losing	perdere
loss	perdita
losses	perdite
lost	perduto
loud	forte
lousy	schifoso
lovelorn	infelice
lowly	umile
ludicrous	ridicolo
ludicrously	ridicolmente
lugubrious	lugubre
lukewarm	tiepido
lull	pausa
lumpy	granuloso
lunatic	lunatico
lurch	barcollare
lure	adescare
lurid	livido
lurk	appostarsi
macabre	macabro
mad	pazzo
madden	impazzire
maddening	fastidioso
madder	robbia
madly	follemente
madman	pazzo
madness	follia
maladjusted	disadattato
maladjustment	inadattabilità
malady	malattia
malaise	malessere
malcontent	malcontento
malevolence	malevolenza
malevolent	malevolo
malice	malizia
malicious	maligno
maliciously	maliziosamente
malign	maligno
malignant	maligno
malodorous	maleodorante
maltreatment	maltrattamento
mangle	mangano
mangled	maciullato
mangles	mangani
mangling	storpiatura
maniac	maniaco
maniacal	maniacale
manic	maniaco
manipulate	manipolare
manipulation	manipolazione
manipulative	manipolativo
manipulators	manipolatori
marginal	marginale
marginally	marginalmente
martyrdom	martirio
mashed	schiacciato
massacre	massacro
massacres	massacri
mawkish	svenevole
mawkishness	sdolcinatezza
meager	magro
meanness	ristrettezza
measly	miserabile
meddle	immischiarsi
meddlesome	ficcanaso
mediocrity	mediocrità
melancholy	malinconia
melodramatic	melodrammatico
melodramatically	melodrammatico
menace	minaccia
menacing	minaccioso
menacingly	minacciosamente
mendacious	mendace
mendacity	mendacia
menial	servile
merciless	spietato
mess	pasticcio
messed	incasinato
messes	pasticci
messing	pasticciano
messy	disordinato
midget	nano
miff	battibecco
militancy	militanza
mindless	irragionevole
mirage	miraggio
mire	fango
misalign	disallineare
misaligned	disallineato
misapprehend	fraintendere
misbecoming	sconveniente
misbegotten	illegittimo
miscalculate	sbagliare
miscellaneous	miscellaneo
mischief	dispetto
mischievous	malizioso
mischievously	maliziosamente
miscreant	furfante
miser	avaro
miserable	miserabile
miserably	miserabilmente
miseries	miserie
miserly	avaro
misery	miseria
misfit	disadattato
misfortune	sventura
misgiving	apprensione
misgivings	perplessità
misguided	fuorviato
mishandle	maltrattare
mishap	disavventura
misinformed	disinformato
misleading	ingannevole
misleadingly	ingannevolmente
mispronounces	storpia
misreading	travisamento
misrepresent	travisare
misrepresentation	travisamento
miss	Perdere
missed	perse
misses	miss
misstatement	errata
mist	nebbia
mistake	sbaglio
mistaken	sbagliato
mistakenly	erroneamente
mistakes	errori
mistress	padrona
mistrust	diffidare
mistrustful	diffidente
mists	nebbie
misunderstand	fraintendere
misunderstanding	malinteso
misunderstandings	incomprensioni
misunderstood	frainteso
misuse	abuso
moan	gemito
mobster	gangster
mock	finto
mocked	deriso
mockery	beffa
mocking	beffardo
mockingly	beffardamente
mocks	deride
molest	molestare
molestation	molestia
monotonous	monotono
monotony	monotonia
monster	mostro
monstrosities	mostruosità
monstrosity	mostruosità
monstrous	mostruoso
monstrously	mostruosamente
moody	lunatico
moot	discutibile
mope	avvilirsi
morbid	morboso
morbidly	morbosamente
mordant	mordente
mordantly	causticamente
moribund	moribondo
moron	deficiente
moronic	idiota
morons	idioti
mortification	mortificazione
mortified	mortificato
mortify	mortificare
mortifying	mortificante
motionless	immobile
motley	eterogeneo
mourn	piangere
mournful	luttuoso
muddle	confusione
muddy	fangoso
mulish	testardo
multi-polarization	multi-polarizzazione
mundane	mondano
murder	omicidio
murderer	assassino
murderous	omicida
murderously	mortalmente
murky	oscuro
muscle-flexing	muscolo-flessione
mushy	pastoso
musty	ammuffito
mysterious	misterioso
mysteriously	misteriosamente
mystery	mistero
mystify	mistificare
myth	mito
nag	ronzino
nagging	fastidioso
naive	ingenuo
naively	ingenuamente
narrower	stretto
nastiness	sporcizia
nasty	cattiva
naughty	cattivo
nauseate	stomacare
nauseates	nausea
nauseating	nauseante
naïve	ingenuo
nebulous	nebuloso
needless	inutile
needlessly	inutilmente
needy	bisognoso
nefarious	malvagio
negate	negare
negation	negazione
negative	negativo
negatives	negativi
negativity	negatività
neglect	trascurare
neglected	trascurato
negligence	negligenza
negligent	negligente
nemesis	nemesi
nepotism	nepotismo
nervous	nervoso
nervously	nervosamente
nervousness	nervosismo
nettle	ortica
neurotic	nevrotico
neurotically	nevroticamente
niggles	pecche
nightmare	incubo
nightmarishly	incubo
nitpicking	pignolo
noise	rumore
noises	rumori
noisy	rumoroso
nonexistent	inesistente
nosey	ficcanaso
notoriety	notorietà
notorious	famigerato
notoriously	notoriamente
noxious	nocivo
nuisance	fastidio
numb	intorpidire
obese	obeso
object	oggetto
objection	obiezione
objectionable	sgradevole
objections	obiezioni
oblique	obliquo
obliterate	cancellare
obliterated	obliterato
oblivious	ignaro
obnoxious	odioso
obnoxiously	disgustosamente
obscene	osceno
obscenely	oscenamente
obscenity	oscenità
obscure	oscuro
obscured	oscurato
obscurity	oscurità
obsess	ossessionare
obsessive	ossessivo
obsessively	Ossessivamente
obsessiveness	ossessività
obsolete	obsoleto
obstacle	ostacolo
obstinate	ostinato
obstinately	ostinatamente
obstruct	ostacolare
obstructed	ostruito
obstructing	ostruente
obstruction	ostruzione
obstructs	ostacola
obtrusive	importuno
obtuse	ottuso
occlude	occludere
occluded	occluso
occludes	occlude
occluding	occlusione
odd	dispari
oddities	stranezze
oddity	stranezza
oddly	stranamente
odor	odore
offence	offesa
offend	offendere
offender	colpevole
offending	offendere
offenses	reati
offensive	offensivo
offensively	offensivamente
offensiveness	offensività
officious	ufficioso
ominous	infausto
ominously	minacciosamente
omission	omissione
omit	omettere
one-sided	unilaterale
onerous	oneroso
onerously	oneroso
opinionated	supponente
opponent	avversario
opportunistic	opportunistico
oppose	opporsi
opposition	opposizione
oppositions	opposizioni
oppress	opprimere
oppression	oppressione
oppressive	opprimente
oppressively	oppressivamente
oppressors	oppressori
ordeal	calvario
orphan	orfano
outbreak	scoppio
outburst	sfogo
outbursts	esplosioni
outcast	emarginato
outcry	protesta
outlaw	fuorilegge
outrage	indignazione
outraged	oltraggiato
outrageous	oltraggioso
outrageously	scandalosamente
outrageousness	sfacciataggine
outrages	oltraggi
over-acted	over-agito
over-balanced	sovra-bilanciato
over-priced	caro
over-valuation	sopravvalutazione
overact	strafare
overawe	intimidire
overbalance	sbilanciare
overbalanced	sbilanciato
overbearing	prepotente
overbearingly	prepotentemente
overblown	spampanato
overdo	esagerare
overdone	esagerato
overheat	surriscaldare
overkill	eccessivo
overloaded	stracarico
overlook	trascurare
overpaid	strapagati
overpower	sopraffare
overpriced	caro
overrated	sopravvalutato
overreach	oltrepassare
overrun	invadere
overshadow	oscurare
oversight	svista
oversights	sviste
oversimplified	semplificato
overstate	esagerare
overstated	sopravvalutato
overstatement	esagerazione
overstatements	esagerazioni
overstates	esagera
overtaxed	oberati
overthrow	rovesciare
overthrows	rovesciamenti
overturn	rovesciare
overweight	sovrappeso
overwhelm	sopraffare
overwhelmed	sopraffatto
overwhelming	travolgente
overwhelmingly	schiacciante
overwhelms	travolge
pain	dolore
painful	doloroso
painfully	dolorosamente
pains	dolori
pale	pallido
pales	impallidisce
paltry	meschino
pan	Pan
pandemonium	pandemonio
pander	assecondare
panders	Panders
panic	panico
paradoxical	paradossale
paradoxically	paradossalmente
paralize	paralizzare
paralyzed	paralizzato
paranoid	paranoico
parasite	parassita
pariah	paria
parody	parodia
partiality	parzialità
partisan	partigiano
partisans	partigiani
passive	passivo
passiveness	passività
pathetic	patetico
pathetically	pateticamente
patronize	patrocinare
paucity	scarsezza
pauper	indigente
paupers	poveri
payback	restituire
peculiar	peculiare
peculiarly	peculiare
pedantic	pedante
peeled	pelato
peeve	indispettire
peeved	innervosito
peevish	stizzoso
peevishly	stizza
penalize	penalizzare
penalty	pena
perfidious	perfido
perfidity	perfidia
perfunctory	superficiale
peril	pericolo
perilous	pericoloso
perilously	pericolosamente
perish	perire
pernicious	pernicioso
perplex	imbarazzare
perplexed	perplesso
perplexing	perplessi
perplexity	perplessità
persecute	perseguitare
persecution	persecuzione
pertinacious	pertinace
pertinacity	pertinacia
perturb	perturbare
perturbed	perturbato
pervasive	pervasivo
perverse	perverso
perversely	perversamente
perversion	perversione
perversity	perversità
pervert	pervertito
perverted	pervertito
perverts	pervertiti
pessimism	pessimismo
pessimistic	pessimistico
pessimistically	pessimisticamente
pest	peste
pestilent	pestilenziale
petrified	impietrito
petrify	pietrificarsi
petty	meschino
phobia	fobia
phobic	fobico
phony	falso
picket	picchetto
picketed	picchettato
picketing	picchettaggio
pickets	picchetti
picky	schizzinosi
pig	maiale
pigs	maiali
pillage	saccheggio
pillory	berlina
pimple	foruncolo
pinch	pizzico
pique	puntiglio
pitiable	pietoso
pitiful	pietoso
pitifully	pietosamente
pitiless	spietato
pittance	miseria
pity	pietà
plagiarize	plagiare
plague	peste
plasticky	plasticoso
plaything	giocattolo
plea	richiesta
pleas	suppliche
plebeian	plebeo
plot	tracciare
plotters	plotter
ploy	stratagemma
plunder	saccheggiare
plunderer	saccheggiatore
pointless	inutile
pointlessly	inutilmente
poison	veleno
poisonous	velenoso
poisonously	velenosamente
pokey	angusto
poky	angusto
polarisation	polarizzazione
polemize	polemizzare
pollute	inquinare
polluters	inquinatori
polution	inquinamento
pompous	pomposo
poor	povero
poorly	male
posturing	atteggiamento
pout	broncio
poverty	povertà
powerless	impotente
prate	chiacchierare
prattle	balbettio
precarious	precario
precariously	precariamente
precipitate	precipitato
precipitous	precipitoso
predatory	predatore
predicament	predica
prejudge	pregiudizio
prejudice	pregiudizio
prejudices	pregiudizi
prejudicial	pregiudizievole
premeditated	premeditato
preoccupy	assorbire
preposterous	assurdo
presumptuous	presuntuoso
presumptuously	presuntuosamente
pretence	finzione
pretense	finzione
pretentious	pretenzioso
pretentiously	pretenziosamente
prevaricate	equivocare
pricey	costoso
prick	puntura
prickle	formicolio
prickles	spine
primitive	primitivo
prison	prigione
prisoner	prigioniero
problem	problema
problematic	problematico
procrastinate	procrastinare
procrastinates	procrastina
procrastination	indugio
profane	profano
profanity	profanità
prohibit	vietare
prohibitive	proibitivo
prohibitively	proibitivamente
propagandize	propagandare
proprietary	proprio
prosecute	perseguire
protest	protesta
protested	protestò
protesting	protestare
protests	proteste
protracted	protratta
provocation	provocazione
provocative	provocatorio
provoke	provocare
pry	leva
pugnacious	battagliero
pugnaciously	bellicosamente
punish	punire
punishable	punibile
punitive	punitivo
puny	gracile
puppet	fantoccio
puppets	burattini
puzzled	perplesso
puzzlement	perplessità
puzzling	sconcertante
quack	ciarlatano
qualm	nausea
qualms	scrupoli
quandary	imbarazzo
quarrel	litigare
quarrels	liti
quarrelsome	litigioso
quash	annullare
queer	strano
questionable	discutibile
quibble	cavillare
quibbles	cavilli
rabid	rabbioso
racism	razzismo
racist	razzistA
racists	razzisti
racy	vivace
radical	radicale
radicalization	radicalizzazione
radically	radicalmente
rage	rabbia
ragged	cencioso
raging	furioso
rail	rotaia
raked	rastrellato
rampage	furia
rampant	dilagante
ramshackle	sgangherato
rancor	rancore
rant	declamazione
ranting	invettiva
rants	sproloqui
rape	stupro
raped	violentata
raping	stupro
rascal	mascalzone
rascals	mascalzoni
rattle	sonaglio
rattled	scosso
rattles	sonagli
ravage	devastare
raving	delirio
reactionary	reazionario
rebellious	ribelle
rebuff	rifiuto
rebuke	rimprovero
recalcitrant	ricalcitrante
recant	ritrattare
recession	recessione
recessionary	recessiva
reckless	spericolato
recklessly	incautamente
recklessness	temerarietà
recoil	rinculo
recourses	ricorsi
redundancy	ridondanza
redundant	ridondante
refusal	rifiuto
refuse	rifiuto
refused	rifiutato
refuses	rifiuta
refusing	rifiuto
refutation	confutazione
refute	confutare
refuted	confutato
refutes	confuta
refuting	confutare
regress	regredire
regression	regressione
regressive	regressivo
regret	rimpiangere
regrets	rimpianti
regrettable	deplorevole
regrettably	purtroppo
regretted	pentito
reject	rifiutare
rejected	respinto
rejecting	respingendo
rejection	rifiuto
rejects	respinge
relapse	ricaduta
relentless	implacabile
reluctance	riluttanza
reluctant	riluttante
remorse	rimorso
remorsefully	rimorso
remorseless	spietato
remorselessness	spietatezza
renounce	rinunciare
renunciation	rinuncia
repel	respingere
repetitive	ripetitivo
reprehensible	riprovevole
reprehensibly	riprovevole
reprehensive	riprensibili
repress	reprimere
repression	repressione
repressive	repressivo
reprimand	rimproverare
reproach	rimprovero
reprove	riprendere
reprovingly	rimprovero
repudiate	ripudiare
repudiation	ripudio
repugnance	ripugnanza
repugnant	ripugnante
repugnantly	ripugnante
repulse	respingere
repulsed	respinto
repulsive	ripugnante
resentful	risentito
resentment	risentimento
resignation	dimissioni
resigned	rassegnato
resistance	resistenza
restless	irrequieto
restlessness	irrequietezza
restrict	limitare
restricted	limitato
restriction	restrizione
restrictive	restrittivo
resurgent	risorgente
retaliate	rivalersi
retaliatory	rappresaglia
retard	ritardare
retarded	ritardato
retards	ritarda
reticent	reticente
retract	ritrattare
retreat	ritiro
retreated	ritirato
revenge	vendetta
revengeful	vendicativo
revert	ritornare
revile	ingiuriare
reviled	vituperato
revoke	revocare
revolt	rivolta
revolting	orrendo
revoltingly	disgustosamente
revulsion	repulsione
rhetoric	retorica
rhetorical	retorico
ridicule	ridicolo
ridicules	ridicolo
ridiculous	ridicolo
ridiculously	ridicolosamente
rife	abbondante
rift	spaccatura
rifts	spaccature
rigid	rigido
rigidity	rigidità
rigidness	rigidità
rile	irritare
rip-off	strappare
ripoff	strappare
ripped	strappato
risk	rischio
risks	rischi
risky	rischioso
rival	rivale
rivalry	rivalità
rocky	roccioso
rogue	furfante
rot	marcire
rotten	marcio
rough	ruvido
rubbish	sciocchezze
rude	maleducato
rue	ruta
ruffian	facinoroso
ruffle	increspatura
ruin	rovinare
ruined	rovinato
ruining	rovinando
ruinous	rovinoso
ruins	rovine
rumbling	brontolio
rumor	pettegolezzo
rumors	voci
rumours	voci
rumple	arruffare
runaway	scappa
rupture	rottura
rust	ruggine
rusts	ruggini
rusty	arrugginito
rut	carreggiata
ruthless	spietato
ruthlessly	spietatamente
ruthlessness	spietatezza
ruts	solchi
sabotage	sabotaggio
sack	sacco
sacrificed	sacrificato
sad	triste
sadden	rattristare
sadly	purtroppo
sadness	tristezza
sag	incurvarsi
sagged	afflosciò
sagging	cascante
saggy	cedevole
sags	abbassamenti
salacious	salace
sanctimonious	bigotto
sap	linfa
sarcasm	sarcasmo
sarcastic	sarcastico
sarcastically	sarcasticamente
sardonic	sardonico
sardonically	sardonicamente
sass	insolenza
satirical	satirico
satirize	satireggiare
savage	selvaggio
savagery	ferocia
savages	selvaggi
scaly	squamoso
scam	truffa
scams	truffe
scandal	scandalo
scandalize	scandalizzare
scandalized	scandalizzato
scandalous	scandaloso
scandalously	scandalosamente
scandals	scandali
scant	scarso
scar	cicatrice
scarce	scarso
scarcely	appena
scarcity	scarsità
scare	spavento
scared	impaurito
scarred	sfregiato
scars	cicatrici
scary	pauroso
scathing	caustico
sceptical	scettico
scoff	deridere
scoffingly	derisione
scold	sgridare
scolded	rimproverò
scolding	rimprovero
scorching	rovente
scorn	disprezzo
scornful	sprezzante
scornfully	sprezzante
scoundrel	farabutto
scourge	flagellare
scowl	cipiglio
scramble	corsa
scrambled	strapazzate
scrambles	arrampica
scrambling	rimescolando
scrap	rottame
scratch	graffiare
scratched	graffiato
scratches	graffi
scratchy	ruvido
scream	urlare
screech	stridio
screw-up	rovinare
screwed	avvitato
screwed-up	avvitato
screwy	matto
scuff	strascicare
scuffs	graffi
scum	feccia
scummy	schiumoso
secretive	segreto
sedentary	sedentario
seethe	ribollire
seething	ribollente
self-criticism	autocritica
self-defeating	controproducente
self-destructive	autodistruttivo
self-humiliation	auto-umiliazione
self-interested	auto-interessati
selfish	egoista
selfishly	egoisticamente
selfishness	egoismo
semi-retarded	semi-ritardato
senseless	insensato
senselessly	insensatamente
seriousness	gravità
servitude	schiavitù
set-up	impostare
setback	contrattempo
sever	separarsi
severe	grave
severity	gravità
shabby	squallido
shadowy	ombroso
shady	ombreggiato
shake	scuotere
shaky	traballante
shallow	superficiale
sham	finzione
shambles	caos
shame	vergogna
shameful	vergognoso
shamefully	vergognosamente
shamefulness	vergogna
shamelessly	spudoratamente
shamelessness	spudoratezza
shark	squalo
sharply	acutamente
shatter	frantumare
shemale	Transessuali
shimmer	bagliore
shipwreck	naufragio
shirk	sottrarre
shirker	scansafatiche
shit	merda
shiver	brivido
shocked	scioccato
shocking	scioccante
shockingly	scandalosamente
shoddy	scadente
short-lived	fugace
shortage	carenza
shortcoming	difetto
shortcomings	carenze
shortness	brevità
shortsighted	miope
shortsightedness	miopia
shrew	toporagno
shriek	strillare
shrill	stridulo
shrilly	stridula
shrivel	avvizzire
shroud	sudario
shun	schivare
shunned	evitato
sick	malato
sicken	ammalarsi
sickening	nauseabondo
sickeningly	disgustosamente
sickly	malaticcio
sickness	malattia
sidetrack	sviare
siege	assedio
silly	sciocco
simplistic	semplicistico
simplistically	semplicisticamente
sin	peccato
sinful	peccaminoso
sinfully	peccaminosamente
sinister	sinistro
sinisterly	sinistramente
sink	Lavello
sinking	naufragio
skeletons	scheletri
skeptic	scettico
skeptical	scettico
skeptically	scettica
skepticism	scetticismo
sketchy	abbozzato
skimpy	striminzito
skinny	magro
skittish	ombroso
skulk	nascondersi
slack	allentato
slander	calunnia
slanderer	calunniatore
slanderous	calunnioso
slanders	calunnie
slap	schiaffo
slashing	tagliando
slaughter	macello
slaughtered	macellati
slave	schiavo
slaves	schiavi
sleazy	squallido
slime	limo
slog	sgobbare
sloow	Sloow
sloppy	sciatto
sloth	bradipo
slothful	indolente
slow	lento
slowed	rallentato
slowly	lentamente
slug	lumaca
sluggish	lento
slump	crollo
slumping	crolli
slur	legatura
sluts	troie
sly	sornione
smack	schiaffo
smash	distruggere
smear	sbavatura
smell	odore
smelled	odore
smelling	odorare
smells	odori
smelly	puzzolente
smelt	sperlano
smoke	Fumo
smoldering	fumanti
smother	soffocare
smouldering	fumanti
smudge	macchia
smudged	sbavato
smudges	sbavature
smudging	sbavature
smug	compiaciuto
smugly	compiaciuto
smut	oscenità
smutty	fuligginoso
snag	intoppo
snagging	sbavatura
snags	strappi
snappish	permaloso
snare	laccio
snarl	ringhio
sneak	spione
sneaky	subdolo
sneer	sogghigno
sneering	beffardo
sneeringly	beffardamente
snobbish	snob
snobby	snob
snobs	snob
snub	affronto
so-cal	così-cal
soapy	insaponato
sob	singhiozzare
sober	sobrio
solemn	solenne
solicitude	sollecitudine
somber	tetro
sore	dolorante
sorely	dolorosamente
soreness	indolenzimento
sorrow	tristezza
sorrowful	dolente
sorrowfully	tristemente
sorry	scusa
sour	aspro
sourly	acidamente
spade	vanga
spank	sculacciare
spew	vomitare
spewed	vomitato
spewing	vomitando
spews	SPEWS
spilling	versamento
spinster	zitella
spiritless	avvilito
spite	dispetto
spiteful	dispettoso
spitefully	dispettosamente
splatter	schizzare
split	Diviso
splitting	scissione
spoil	rovinare
spoilage	deterioramento
spoiled	viziato
spoils	bottino
spook	spettro
spookier	schivo
spooky	spaventoso
spoon-fed	nutriti
sporadic	sporadico
spotty	macchiato
spurious	spuria
spurn	respingere
sputter	farfugliare
squabble	battibecco
squabbling	litigi
squander	sperperare
squash	schiacciare
squeak	squittio
squeaks	cigolii
squeaky	stridulo
squeal	strillo
squealing	strillando
squeals	strilli
squirm	contorcersi
stab	pugnalata
stagnant	stagnante
stagnate	ristagnare
stagnation	stagnazione
staid	compassato
stain	macchia
stains	macchie
stale	stantio
stalemate	stallo
stall	stalla
stalls	stalle
stammer	balbettare
standstill	arresto
stark	rigido
starkly	crudamente
startle	spaventare
startling	sorprendente
startlingly	sorprendentemente
starvation	fame
static	statico
steal	rubare
stealing	furto
steals	ruba
steep	ripido
steeply	ripidamente
stench	fetore
stereotype	stereotipo
stereotypical	stereotipato
stereotypically	stereotipicamente
stern	poppa
stew	stufato
sticky	appiccicoso
stiff	rigido
stiffness	rigidezza
stifle	soffocare
stifling	soffocante
stigmatize	stigmatizzare
sting	puntura
stinging	pungente
stingy	avaro
stink	puzza
stinks	puzza
stodgy	indigesto
stolen	rubare
stooge	fantoccio
stooges	tirapiedi
stormy	tempestoso
straggle	disperdersi
straggler	disperso
strain	sforzo
strained	teso
straining	sforzare
strange	strano
strangely	stranamente
stranger	sconosciuto
strangle	strangolare
strenuous	faticoso
stresses	sollecitazioni
stressful	stressante
stricken	colpito
strict	rigoroso
strictly	rigorosamente
strident	stridente
stridently	stridente
strife	conflitto
strike	sciopero
stringent	rigoroso
stringently	rigorosamente
struck	colpito
struggle	lotta
struggled	lottato
struggles	lotte
struggling	lottando
strut	pavoneggiarsi
stubborn	testardo
stubbornly	ostinatamente
stubbornness	testardaggine
stuck	incollato
stuffy	chiuso
stumble	inciampare
stumbled	inciampato
stumbles	inciampa
stump	ceppo
stumped	perplesso
stumps	monconi
stun	stordire
stunt	acrobazia
stunted	rachitico
stupid	stupido
stupidest	stupido
stupidity	stupidità
stupidly	stupidamente
stupor	stupore
stutter	balbettare
stuttered	balbettato
stuttering	balbuzie
stutters	balbetta
sty	porcile
subdued	sottomesso
subjected	sottoposto
subjection	soggezione
subjugate	soggiogare
subjugation	soggiogazione
submissive	sottomesso
subordinate	subordinare
subpoena	citazione
subservience	sottomissione
subservient	sottomesso
substandard	scadente
subtract	sottrarre
subversion	sovversione
subversive	sovversivo
subversively	sovversivo
subvert	sovvertire
succumb	soccombere
suck	succhiare
sucked	succhiato
sucker	ventosa
sucks	succhia
sues	Sues
suffer	soffrire
suffered	subito
sufferer	malato
suffering	sofferenza
suffers	soffre
suffocate	soffocare
sugar-coat	zucchero-coat
suicidal	suicida
suicide	suicidio
sulk	broncio
sullen	scontroso
sully	macchiare
sunder	scindere
sunk	affondato
sunken	affondata
superficial	superficiale
superficiality	superficialità
superficially	superficialmente
superfluous	superfluo
superstition	superstizione
superstitious	superstizioso
suppress	reprimere
suppression	repressione
surrender	resa
susceptible	suscettibile
suspect	sospettare
suspicion	sospetto
suspicions	sospetti
suspicious	sospetto
swagger	pavoneggiarsi
swamped	sommerso
sweaty	sudato
swelled	gonfiato
swelling	gonfiore
swindle	truffa
swipe	rubare
swollen	gonfio
symptom	sintomo
symptoms	sintomi
syndrome	sindrome
taboo	tabù
tacky	viscoso
taint	macchia
tainted	contaminato
tamper	manomettere
tangle	groviglio
tangled	ingarbugliato
tangles	grovigli
tanked	tankato
tantrum	collera
tardy	tardivo
tarnish	offuscare
tarnished	appannato
tarnishes	appanna
tarnishing	appannamento
tattered	sbrindellato
taunt	schernire
taunting	scherno
taunts	insulti
taut	teso
tawdry	pacchiano
taxing	oneroso
tease	stuzzicare
teasingly	scherzosamente
tedious	noioso
tediously	noiosamente
temerity	audacia
temper	temperare
tempest	tempesta
temptation	tentazione
tenderness	tenerezza
tense	teso
tension	tensione
tentative	provvisorio
tentatively	provvisoriamente
tenuous	tenue
tepid	tiepido
terrible	terribile
terribleness	terribilità
terribly	terribilmente
terror	terrore
terror-genic	terror-genica
terrorism	terrorismo
terrorize	terrorizzare
testy	irritabile
tetchy	irritabile
thankless	ingrato
thicker	spessa
thirst	sete
thorny	spinoso
thoughtlessly	sconsideratamente
thoughtlessness	sconsideratezza
thrash	bastonare
threat	minaccia
threaten	minacciare
threatening	minaccioso
threats	minacce
threesome	terzetto
throb	pulsare
throbbed	pulsava
throbbing	pulsazione
throbs	pulsa
thug	teppista
thwart	contrastare
timid	timido
timidity	timidezza
timidly	timidamente
tin-y	stagno-y
tingled	formicolato
tingling	formicolio
tired	stanco
tiresome	faticoso
tiring	faticoso
tiringly	faticosamente
toil	fatica
toll	Pedaggio
top-heavy	sbilanciato
topple	rovesciare
torment	tormento
tormented	tormentato
torrent	torrente
tortuous	tortuoso
torture	tortura
tortured	torturati
tortures	torture
torturing	torturando
torturous	tortuoso
totalitarian	totalitario
touchy	permaloso
toughness	durezza
touted	propagandato
touts	bagarini
toxic	tossico
traduce	calunniare
tragedy	tragedia
tragic	tragico
tragically	tragicamente
traitor	traditore
traitorous	traditore
traitorously	tradimento
tramp	vagabondo
trample	calpestare
transgress	trasgredire
transgression	trasgressione
trap	trappola
traped	Traped
trapped	intrappolati
trash	spazzatura
trashed	Cestinati
trashy	scadente
traumatic	traumatico
traumatically	traumaticamente
traumatize	traumatizzare
traumatized	Traumatizzato
travesties	travestimenti
travesty	parodia
treacherous	infido
treacherously	proditoriamente
treachery	tradimento
treason	tradimento
trick	trucco
tricked	ingannato
trickery	inganno
tricky	difficile
trivial	banale
trivialize	banalizzare
trouble	guaio
troubled	agitato
troublemaker	piantagrane
troubles	guai
troublesome	fastidioso
troublesomely	fastidiosamente
troubling	preoccupante
truant	pigro
tumble	caduta
tumbled	caduto
tumultuous	tumultuoso
turbulent	turbolento
turmoil	agitazione
twisted	contorto
tyrannical	tirannico
tyrannically	tirannicamente
tyranny	tirannia
tyrant	tiranno
ugliness	bruttezza
ugly	brutta
ulterior	ulteriore
ultimatums	ultimatum
un-viewable	non-visibile
unable	incapace
unacceptable	inaccettabile
unacceptably	inaccettabilmente
unaccustomed	insolito
unachievable	irraggiungibile
unaffordable	insostenibile
unavoidably	inevitabilmente
unbearable	insopportabile
unbelievable	incredibile
unbelievably	incredibilmente
uncaring	menefreghista
uncertain	incerto
uncivil	incivile
uncivilized	incivile
unclean	immondo
uncomfortable	scomodo
uncomfortably	disagio
uncomfy	scomodi
uncompromising	intransigente
unconstitutional	anticostituzionale
uncontrolled	sfrenato
uncouth	rozzo
undecided	indeciso
undependable	inaffidabile
undercut	sottosquadro
undercuts	sottosquadri
undercutting	sottoquotazione
underdog	perdente
underestimate	sottovalutare
underlings	subalterni
undermine	minare
undermined	minato
undermines	mina
undermining	minando
underpaid	sottopagato
underpowered	sottodimensionato
undesirable	indesiderabile
undetermined	indeterminato
undone	disfatto
undue	indebito
unease	disagio
uneasily	disagio
uneasiness	disagio
uneasy	inquieto
uneconomical	antieconomico
unemployed	disoccupato
unequal	ineguale
uneven	irregolare
unexpected	inaspettato
unexpectedly	inaspettatamente
unfairly	ingiustamente
unfaithful	infedele
unfamiliar	sconosciuto
unfavorable	sfavorevole
unfeeling	insensibile
unfinished	incompiuto
unfit	inadatto
unforeseen	imprevisto
unforgiving	imperdonabile
unfortunate	sfortunato
unfortunately	purtroppo
unfounded	infondato
unfriendly	ostile
unfulfilled	insoddisfatto
ungovernable	indisciplinato
ungrateful	ingrato
unhappily	infelicemente
unhappiness	infelicità
unhappy	infelice
unhealthy	malsano
unhelpful	inutile
unilateralism	unilateralismo
unimaginable	inimmaginabile
unimaginably	inimmaginabilmente
unimportant	irrilevante
uninformed	disinformato
unintelligible	incomprensibile
unipolar	unipolare
unjust	ingiusto
unjustifiable	ingiustificabile
unjustifiably	ingiustificatamente
unjustified	ingiustificato
unjustly	Ingiustamente
unkind	scortese
unknown	sconosciuto
unlawful	illegale
unlawfully	abusivamente
unlawfulness	illegittimità
unleash	sguinzagliare
unlikely	improbabile
unlucky	sfortunato
unmoved	fermo
unnatural	innaturale
unnaturally	innaturalmente
unnerve	snervare
unnerved	snervato
unnerving	snervante
unnoticed	inosservato
unobserved	inosservato
unpleasant	sgradevole
unpopular	impopolare
unpredictable	imprevedibile
unprepared	impreparato
unproductive	improduttivo
unprofitable	infruttuoso
unravel	sbrogliare
unraveled	districato
unreachable	irraggiungibile
unreadable	illeggibile
unreasonable	irragionevole
unreasonably	irragionevolmente
unrelenting	inesorabile
unrelentingly	inesorabilmente
unreliability	inaffidabilità
unreliable	inaffidabile
unresolved	irrisolto
unrest	agitazione
unruly	indisciplinato
unsafe	pericoloso
unsatisfactory	insoddisfacente
unsavory	sgradevole
unsecure	insicuro
unseemly	sconveniente
unsettle	sconvolgere
unsettled	incerto
unsettling	inquietante
unsound	debole
unspeakable	indicibile
unspecified	imprecisato
unstable	instabile
unsteadily	incerto
unsteadiness	instabilità
unsteady	instabile
unsupported	supportato
unsure	incerto
unsuspecting	ignaro
unsustainable	insostenibile
untenable	insostenibile
unthinkable	impensabile
untimely	prematuro
untouched	intatto
untrue	falso
untrustworthy	inaffidabile
unusable	inutilizzabile
unuseable	inutilizzabile
unusual	insolito
unusually	insolitamente
unviewable	visualizzabile
unwarranted	ingiustificato
unwatchable	inguardabile
unwelcome	sgradito
unwell	indisposto
unwieldy	ingombrante
unwilling	riluttante
unwillingly	controvoglia
unwillingness	riluttanza
unwise	malaccorto
unwisely	incautamente
unworkable	inattuabile
unworthy	indegno
unyielding	inflessibile
upbraid	rimproverare
upheaval	sconvolgimento
uprising	rivolta
uproar	tumulto
uproarious	tumultuoso
uproot	sradicare
upset	irritato
upsets	disturbi
upsetting	sconvolgente
urgent	urgente
useless	inutili
usurp	usurpare
usurper	usurpatore
utterly	completamente
vagrant	vagabondo
vague	vago
vagueness	indeterminatezza
vain	vano
vainly	invano
vanity	vanità
vehement	veemente
vehemently	veemenza
vengeance	vendetta
vengeful	vendicativo
venom	veleno
venomous	velenoso
venomously	velenosamente
vent	sfogo
vestiges	vestigia
vex	vessare
vexation	irritazione
vexing	assillante
vibrate	vibrare
vibrated	vibrato
vibrates	vibra
vibrating	vibrante
vibration	vibrazione
vicious	vizioso
viciously	cattiveria
viciousness	viziosità
victimize	vittimizzare
vileness	viltà
vilify	diffamare
villainous	malvagio
villains	cattivi
vindictive	vendicativo
vindictiveness	vendicatività
violate	violare
violation	violazione
violator	trasgressore
violators	trasgressori
violent	violento
violently	violentemente
viper	vipera
virulence	virulenza
virulent	virulento
virulently	virulento
vociferous	vociferante
volatility	volatilità
vomit	vomito
vomited	vomitato
vomiting	vomito
vomits	vomita
vulgar	volgare
vulnerable	vulnerabile
wack	Wack
wail	lamento
wallow	sguazzare
wane	declino
waning	declino
wanton	lascivo
war-like	guerra-like
warily	circospezione
wariness	cautela
warlike	bellicoso
warned	avvertito
warning	avvertimento
warp	ordito
warped	deformato
wary	diffidente
washed-out	lavato
waste	rifiuto
wasted	sprecato
wasteful	dispendioso
wastefulness	prodigalità
wasting	sprecare
water-down	diluire
watered-down	annacquato
wayward	ribelle
weak	debole
weaken	indebolire
weakening	indebolimento
weakness	debolezza
weaknesses	debolezze
weariness	stanchezza
wearisome	faticoso
weary	stanco
wedge	cuneo
weed	erba
weep	piangere
weird	strano
weirdly	stranamente
wheedle	adulare
whimper	piagnucolare
whine	gemito
whining	piagnisteo
whiny	lamentosa
whips	fruste
whore	puttana
whores	puttane
wicked	malvagio
wickedly	perfidamente
wickedness	malvagità
wild	selvaggio
wildly	selvaggiamente
wiles	Wiles
wilt	appassire
wily	astuto
wimpy	Wimpy
wince	sussultare
wobble	oscillare
wobbled	vacillato
wobbles	traballa
woe	dolore
woebegone	addolorato
woeful	doloroso
womanizer	donnaiolo
womanizing	donnaiolo
worn	logoro
worried	preoccupato
worriedly	preoccupato
worries	preoccupazioni
worrisome	preoccupante
worry	preoccupazione
worrying	preoccupante
worryingly	preoccupante
worse	peggio
worsen	peggiorare
worsening	peggioramento
worst	peggio
worthlessness	indegnità
wound	ferita
wounds	ferite
wrangle	disputa
wrath	ira
wreak	sfogare
wreaks	Provoca
wreck	relitto
wrest	strappare
wrestle	lottare
wretch	disgraziato
wretched	infelice
wretchedly	miseramente
wretchedness	miseria
wrinkle	grinza
wrinkled	rugoso
wrinkles	rughe
writhe	contorcersi
wrong	sbagliato
wrongful	illegittimo
wrought	battuto
yawn	sbadiglio
zealot	fanatico
zealous	zelante
zealously	zelo
