abounds	overvloed
abundance	overvloed
abundant	overvloedig
accessable	toegankelijk
accessible	beschikbaar
acclaim	bijval
acclaimed	geprezen
acclamation	acclamatie
accolades	onderscheidingen
accommodative	accommoderende
accomplish	bereiken
accomplished	volbracht
accomplishment	prestatie
accomplishments	prestaties
accurate	accuraat
accurately	nauwkeurig
achievable	haalbare
achievement	prestatie
achievements	verwezenlijkingen
acumen	scherpzinnigheid
adaptable	aanpasbaar
adaptive	aangepaste
adequate	voldoende
adjustable	verstelbaar
admirable	bewonderenswaardig
admirably	bewonderenswaardig
admiration	bewondering
admire	bewonderen
admirer	bewonderaar
admiring	bewonderend
admiringly	bewonderend
adorable	aanbiddelijk
adored	aanbeden
adorer	aanbidder
adoring	bewonderende
adroit	behendig
adroitly	handig
adulate	flikflooien
adulation	vleierij
adulatory	kruiperig
advanced	gevorderd
advantage	voordeel
advantageous	voordelig
advantageously	voordelig
advantages	voordelen
adventuresome	avontuurlijk
adventurous	avontuurlijk
advocated	bepleit
advocates	voorstanders
affability	minzaamheid
affable	minzaam
affably	minzaam
affectation	aanstellerij
affection	genegenheid
affectionate	hartelijk
affinity	affiniteit
affirm	bevestigen
affirmation	bevestiging
affirmative	bevestigend
affluence	rijkdom
affluent	zijrivier
afford	veroorloven
affordable	betaalbare
affordably	betaalbaar
agile	behendig
agilely	behendig
agility	behendigheid
agreeable	aangenaam
agreeableness	aangenaamheid
agreeably	prettig
all-around	overal
alluring	verleidelijk
alluringly	verleidelijk
altruistic	altruïstisch
altruistically	onbaatzuchtig
amaze	verbazen
amazement	verbazing
amazes	verbaast
amazing	verbazingwekkend
amazingly	verbazend
ambitious	ambitieus
ambitiously	ambitieus
ameliorate	verbeteren
amenable	vatbaar
amenity	faciliteiten
amiability	beminnelijkheid
amiable	beminnelijk
amicability	beminnelijkheid
amicable	minnelijk
amicably	vriendschappelijk
amity	vriendschap
ample	ruim
amply	ruimschoots
amuse	amuseren
amusing	amusant
amusingly	vermakelijk
angel	engel
angelic	engelachtig
apotheosis	apotheose
appealing	aantrekkelijk
applaud	toejuichen
appreciable	merkbaar
appreciated	gewaardeerd
appreciates	waardeert
appreciative	waarderend
appreciatively	waarderend
appropriate	geschikt
approval	goedkeuring
approve	goedkeuren
ardent	vurig
ardently	vurig
ardor	ijver
articulate	articuleren
aspiration	aspiratie
aspirations	aspiraties
aspire	streven
assurance	zekerheid
assurances	verzekeringen
assure	verzekeren
assuredly	zeker
assuring	verzekeren
astonish	verbazen
astonished	verwonderd
astonishing	verbazingwekkend
astonishingly	verbazend
astonishment	verbazing
astound	verbazen
astounded	verbijsterd
astounding	verbazend
astoundingly	verbazingwekkend
astutely	geslepen
attentive	attent
attraction	aantrekkelijkheid
attractive	aantrekkelijk
attractively	aantrekkelijk
audible	hoorbaar
audibly	hoorbaar
auspicious	gunstig
authentic	authentiek
authoritative	gezaghebbend
autonomous	autonoom
available	beschikbaar
aver	beweren
avid	begerig
avidly	gretig
award	onderscheiding
awarded	toegekend
awe	ontzag
awesome	geweldig
awesomely	vreselijk
awesomeness	geweldigheid
backbone	ruggegraat
balanced	evenwichtige
bargain	koopje
beauteous	schoon
beautiful	mooi
beautifully	mooi
beauty	schoonheid
beckon	wenken
beckoned	wenkte
beckoning	wenkend
beckons	wenkt
believable	geloofwaardig
beloved	geliefd
benefactor	weldoener
beneficent	weldadig
beneficial	gunstig
beneficially	gunstig
beneficiary	begunstigde
benefit	voordeel
benefits	voordelen
benevolence	welwillendheid
benevolent	welwillend
benifits	Voordelen
best-known	bekendste
best-performing	best-presterende
better	beter
blameless	onberispelijk
bless	zegenen
blessing	zegen
bliss	geluk
blissful	zalig
blissfully	gelukzalig
bloom	bloeien
blossom	bloesem
bolster	ondersteunen
bonny	aardig
bonuses	bonussen
boundless	grenzeloos
bountiful	rijkelijk
brainy	snugger
brand-new	gloednieuw
brave	dapper
bravery	moed
bravo	Bravo
breakthrough	doorbraak
breakthroughs	doorbraken
breathlessness	ademloosheid
breathtaking	adembenemend
breathtakingly	adembenemend
breeze	bries
bright	helder
brighten	opvrolijken
brighter	helderder
brightest	helderste
brilliance	glans
brilliant	briljant
brilliantly	briljant
brisk	levendig
brotherly	broederlijk
buoyant	drijvend
cajole	vleien
calm	kalmte
calming	rustgevende
calmness	rust
capability	geschiktheid
capably	bekwaam
captivate	boeien
captivating	boeiende
carefree	zorgeloos
celebrate	vieren
celebrated	beroemd
celebration	viering
celebratory	feestelijke
champion	kampioen
charismatic	charismatische
charitable	liefdadig
charm	betoveren
charming	charmant
charmingly	charmant
chaste	kuis
cheaper	goedkoper
cheapest	goedkoopste
cheer	juichen
cheerful	vrolijk
cheery	vrolijk
cherish	koesteren
cherished	gekoesterde
cherub	cherubijn
chic	chique
chivalrous	ridderlijk
chivalry	ridderlijkheid
civility	beleefdheid
civilize	beschaven
clarity	helderheid
classic	klassiek
clean	schoon
cleaner	schoonmaakster
cleanest	schoonste
cleanliness	zindelijkheid
cleanly	schoon
clear	duidelijk
cleared	ontruimd
clearer	duidelijkere
clearly	duidelijk
clears	ontruimt
clever	knap
cleverly	knap
cohere	samenhangen
coherence	samenhang
coherent	samenhangend
cohesive	samenhangend
colorful	kleurrijk
comely	bevallig
comfortable	comfortabel
comfortably	aangenaam
comforting	troostend
commend	aanprijzen
commendable	prijzenswaardig
commitment	inzet
commodious	geriefelijk
compactly	compact
compassion	mededogen
compassionate	medelijdend
compatible	verenigbaar
competitive	competitief
complement	aanvulling
complementary	complementair
complemented	aangevuld
complements	complementen
complimentary	gratis
comprehensive	uitgebreid
conciliate	verzoenen
conciliatory	verzoenend
concise	beknopt
confidence	vertrouwen
confident	zelfverzekerd
congenial	sympathiek
congratulate	feliciteren
congratulation	felicitatie
congratulatory	felicitatie-
conscientious	gewetensvol
considerate	attent
consistent	consequent
consistently	consistent
constructive	constructief
consummate	doortrapt
contentment	tevredenheid
continuity	continuïteit
contribution	bijdrage
convenience	gemak
convenient	geschikt
conveniently	gunstig
convincing	overtuigend
convincingly	overtuigend
cool	koel
coolest	coolste
cooperative	coöperatieve
cooperatively	coöperatief
cornerstone	hoeksteen
correctly	correct
cost-effective	kostenefficient
cost-saving	kostenbesparend
counter-attack	Tegenaanval
counter-attacks	tegenaanvallen
courage	moed
courageous	moedig
courageously	moedig
courteous	beleefd
courtly	hoofs
covenant	verbond
cozy	knus
creative	creatief
credence	geloof
credible	geloofwaardig
crisp	knapperig
crisper	scherper
cure	genezen
cute	schattig
danken	Danken
daring	gedurfd
daringly	gedurfd
darling	schat
dashing	zwierig
dauntless	onverschrokken
dawn	dageraad
dazzle	verblinden
dazzled	verblind
dazzling	schitterende
dead-cheap	dead-goedkoop
decency	fatsoen
decent	fatsoenlijk
decisive	beslissend
decisiveness	daadkracht
dedicated	toegewijd
defeat	nederlaag
defeated	verslagen
defeating	verslaan
defeats	nederlagen
defender	verdediger
deference	eerbied
deft	handig
delectable	verrukkelijk
delicacy	lekkernij
delicate	delicaat
delicious	heerlijk
delight	genot
delighted	verrukt
delightful	verrukkelijk
delightfully	heerlijk
dependable	betrouwbaar
dependably	betrouwbaar
deservedly	terecht
deserving	verdienstelijk
desirable	wenselijk
desiring	verlangen
desirous	verlangend
destiny	lotsbestemming
detachable	afneembaar
devout	vroom
dexterous	behendig
dextrous	handig
dignified	waardig
dignify	verheffen
dignity	waardigheid
diligence	ijver
diligent	ijverig
diligently	ijverig
diplomatic	diplomatisch
dirt-cheap	spotgoedkoop
distinction	onderscheid
distinctive	kenmerkend
distinguished	voornaam
diversified	afwisselend
divine	goddelijk
divinely	goddelijk
dominate	heersen
dominated	gedomineerd
dominates	domineert
doubtless	ongetwijfeld
dreamland	dromenland
dumbfounded	verbluft
durable	duurzaam
dynamic	dynamisch
eager	gretig
eagerly	gretig
eagerness	gretigheid
earnest	ernstig
earnestly	ernstig
earnestness	ernst
ease	gemak
eased	versoepeld
eases	vereenvoudigt
easier	gemakkelijker
easiest	gemakkelijkst
easiness	gemakkelijkheid
easing	versoepeling
easy	gemakkelijk
ebullience	opgewondenheid
ebullient	levendig
ebulliently	uitbundig
economical	zuinig
ecstasies	extase
ecstasy	extase
ecstatic	extatisch
ecstatically	extatisch
edify	stichten
educated	geleerd
effective	effectief
effectively	effectief
effectiveness	effectiviteit
effectual	doeltreffend
efficacious	effectief
efficient	doeltreffend
efficiently	efficiënt
effortlessly	moeiteloos
effusion	uitstorting
effusive	overdreven
effusiveness	uitbundigheid
elate	opgetogen
elated	opgetogen
elatedly	uitgelaten
elation	opgetogenheid
electrify	elektrificeren
elegance	elegantie
elegantly	elegant
elevate	verheffen
eloquence	welsprekendheid
eloquent	welsprekend
eloquently	welsprekend
embolden	verstouten
eminence	eminentie
empathize	inleven
empathy	empathie
empower	machtigen
enchant	betoveren
enchanted	betoverde
enchanting	betoverend
enchantingly	betoverend
encourage	aanmoedigen
encouragement	aanmoediging
encouraging	bemoedigend
encouragingly	bemoedigend
endear	inboezemen
endearing	innemend
endorse	onderschrijven
endorsed	onderschreven
endorsement	bekrachtiging
endorses	onderschrijft
endorsing	onderschrijven
energetic	energiek
energy-efficient	energiezuinige
energy-saving	energiebesparend
engaging	innemend
enhance	verbeteren
enhanced	versterkte
enhances	verbetert
enjoy	genieten
enjoyable	aangenaam
enjoyed	genoten
enjoyment	genot
enjoys	geniet
enlighten	verlichten
enlightenment	verlichting
enliven	verlevendigen
ennoble	veredelen
enough	genoeg
enraptured	vervoering
enrich	verrijken
enrichment	verrijking
enterprising	ondernemend
entertain	vermaken
entertaining	onderhoudend
entertains	entertaint
enthral	betoveren
enthrall	betoveren
enthralled	ban
enthusiasm	enthousiasme
enthusiast	enthousiast
enthusiastic	enthousiast
enthusiastically	enthousiast
entice	verleiden
enticed	verleid
enticing	verleidelijk
enticingly	verleidelijk
entrancing	bekoorlijk
entrust	toevertrouwen
enviable	benijdenswaardig
envious	jaloers
enviously	afgunstig
enviousness	afgunst
envy	afgunst
equitable	billijk
ergonomical	ergonomische
err-free	err-vrij
erudite	erudiet
ethical	ethisch
eulogize	ophemelen
euphoria	euforie
euphoric	euforisch
euphorically	euforisch
evaluative	evaluatieve
evenly	gelijkmatig
eventful	veelbewogen
everlasting	eeuwigdurend
evocative	suggestieve
exalt	verheffen
exaltation	verheerlijking
exalted	verheven
exalting	verheffen
examplary	voorbeeldig
exceed	overtreffen
exceeded	overschreden
exceeding	overschrijding
exceedingly	buitengewoon
exceeds	overschrijdt
excel	uitmunten
excelent	uitstekende
excellant	uitstekend
excelled	excelleerde
excellence	uitmuntendheid
excellency	hoogheid
excellent	uitstekend
excellently	uitstekend
exceptional	buitengewoon
exceptionally	buitengewoon
excite	prikkelen
excited	opgewonden
excitedly	opgewonden
excitedness	opgewondenheid
excitement	opwinding
excites	prikkelt
exciting	opwindend
exemplar	voorbeeld
exemplary	voorbeeldig
exhilarate	opvrolijken
exhilarating	opwindende
exhilaration	opvrolijking
exonerate	zuiveren
expansive	expansieve
expeditiously	snel
expertly	vakkundig
exquisite	voortreffelijk
exquisitely	fijn
extol	verheffen
extoll	verheffen
extraordinarily	buitengewoon
extraordinary	buitengewoon
exuberance	uitbundigheid
exuberant	uitbundig
exuberantly	uitbundig
exult	jubelen
exultant	opgetogen
exultation	opgetogenheid
eye-catch	blikvanger
eye-catching	opvallende
eyecatch	blikvanger
eyecatching	opvallende
fabulous	fabelachtig
fabulously	fabelachtig
facilitate	vergemakkelijken
fair	eerlijk
fairly	tamelijk
fairness	eerlijkheid
faith	geloof
faithful	getrouw
faithfully	trouw
faithfulness	trouw
fame	roem
famed	beroemd
famous	beroemd
famously	beroemd
fancier	liefhebber
fantastic	fantastisch
fantastically	grillig
fascinate	fascineren
fascinating	fascinerend
fascinatingly	betoverend
fascination	betovering
fashionably	modieus
fast	snel
faster	sneller
fastest	snelst
faultless	onberispelijk
favor	gunst
favorable	gunstig
favored	begunstigd
favorite	favoriete
favour	gunst
fearless	onbevreesd
fearlessly	onbevreesd
feasible	uitvoerbaar
feat	prestatie
feisty	pittige
felicity	geluk
fertile	vruchtbaar
fervent	vurig
fervently	vurig
fervid	vurig
fervidly	vurig
fervor	ijver
festive	feestelijk
fidelity	trouw
fiery	vurig
fine	fijn
finely	fijn
finer	fijnere
finest	fijnste
firmer	steviger
first-rate	eersteklas
flashy	opzichtig
flatter	vleien
flattering	vleiend
flatteringly	vleiend
flawless	vlekkeloos
flawlessly	feilloos
flexibility	flexibiliteit
flexible	flexibele
flourish	floreren
flourishing	bloeiend
fluent	vloeiend
flutter	fladderen
fondly	innig
fondness	genegenheid
foremost	voorop
foresight	vooruitziendheid
formidable	formidabel
fortitude	standvastigheid
fortuitous	toevallig
fortuitously	toevallig
fortunate	gelukkig
fortunately	gelukkig
fortune	fortuin
fragrant	geurig
free	gratis
freed	bevrijd
freedom	vrijheid
freedoms	vrijheden
fresh	vers
fresher	frisser
freshest	verste
friendliness	vriendelijkheid
friendly	vriendelijk
frolic	dartelen
frugal	zuinig
fruitful	vruchtbaar
fulfillment	vervulling
fun	pret
futuristic	futuristische
gaiety	vrolijkheid
gaily	vrolijk
gain	krijgen
gained	opgedaan
gainful	winstgevend
gainfully	bezoldigde
gaining	wint
gains	aanwinsten
gallant	galante
gallantly	galant
gem	edelsteen
gems	edelstenen
generosity	vrijgevigheid
generous	genereus
generously	royaal
genial	geniaal
genius	genie
gentle	teder
gentlest	zachtste
genuine	oprecht
gifted	begaafd
glad	blij
gladden	verblijden
gladly	graag
gladness	blijdschap
glamorous	betoverend
glee	vrolijkheid
gleefully	vrolijk
glimmer	schijnsel
glimmering	tinteling
glisten	glinsteren
glistening	fonkelend
glitter	schitteren
glorify	verheerlijken
glorious	glorieus
gloriously	glorieus
glory	heerlijkheid
glow	gloed
glowing	gloeiend
glowingly	vurig
godlike	goddelijk
godsend	buitenkansje
gold	goud
golden	gouden
good	goed
goodly	flink
goodness	goedheid
goodwill	welwillendheid
gorgeous	prachtig
gorgeously	prachtig
grace	genade
graceful	bevallig
gracefully	sierlijk
gracious	genadig
graciously	genadig
graciousness	heerlijkheid
grand	groots
grandeur	grootsheid
grateful	dankbaar
gratefully	dankbaar
gratification	bevrediging
gratified	bevredigd
gratifies	bevredigt
gratify	bevredigen
gratifying	verheugend
gratifyingly	verheugend
gratitude	dankbaarheid
greatest	beste
greatness	grootheid
grin	grijns
groundbreaking	baanbrekende
guarantee	garantie
guiltless	onschuldig
gush	gutsen
halcyon	ijsvogel
hale	flink
hallmark	keurmerk
hallmarks	keurmerken
hallowed	geheiligd
handier	handiger
handsome	knap
handsomely	knap
handy	handig
happier	gelukkiger
happily	gelukkig
happiness	geluk
happy	gelukkig
hard-working	hardwerkend
harmless	ongevaarlijk
harmonious	harmonisch
harmoniously	harmonieus
harmonize	harmoniëren
harmony	harmonie
headway	vooruitgang
heal	genezen
healthful	gezond
healthy	gezond
hearten	bemoedigen
heartening	bemoedigend
heartfelt	oprecht
heartily	hartelijk
heartwarming	hartverwarmend
heaven	hemel
heavenly	hemels
helped	geholpen
helpful	nuttig
helping	helpen
hero	held
heroic	heldhaftig
heroically	heldhaftig
heroine	heldin
high-spirited	hooghartig
hilarious	hilarisch
holy	heilig
homage	hulde
honest	eerlijk
honesty	eerlijkheid
honor	eer
honorable	eervol
honored	geëerd
honoring	huldiging
hooray	Hoera
hopeful	hoopvol
hospitable	gastvrij
hot	warm
hottest	heetste
hug	omhelzing
humane	humaan
humble	vernederen
humility	nederigheid
humorous	humoristisch
humorously	humoristische
humour	humor
humourous	humoristische
ideal	ideaal
idealize	idealiseren
ideally	ideaal
idol	afgod
idolize	verafgoden
idolized	verafgood
idyllic	idyllisch
illuminate	verlichten
illuminating	verlichtings-
illumine	verlichten
illustrious	illustere
imaculate	onberispelijk
imaginative	fantasierijke
immaculate	vlekkeloos
immaculately	onberispelijk
immense	onmetelijk
impartial	onpartijdig
impartiality	onpartijdigheid
impartially	onpartijdig
impassioned	hartstochtelijk
impeccable	onberispelijk
impeccably	onberispelijk
important	belangrijk
impresses	imponeert
impressive	indrukwekkend
impressively	indrukwekkend
improve	verbeteren
improved	verbeterd
improvement	verbetering
improvements	verbeteringen
improves	verbetert
improving	verbeteren
incredible	ongelooflijk
incredibly	ongelooflijk
indebted	verschuldigd
individualized	geïndividualiseerde
indulgence	aflaat
indulgent	toegeeflijk
industrious	ijverig
inestimable	onschatbaar
inestimably	onschatbare
inexpensive	goedkoop
infallibility	onfeilbaarheid
infallible	onfeilbaar
infallibly	onfeilbaar
influential	invloedrijk
ingenious	vernuftig
ingeniously	ingenieus
ingenuity	vindingrijkheid
ingenuous	naïef
innocuous	onschadelijk
innovation	innovatie
innovative	innovatief
insightful	inzichtelijk
inspiration	inspiratie
inspirational	inspirerende
inspire	inspireren
inspiring	inspirerende
instantly	ogenblikkelijk
instructive	leerzaam
instrumental	instrumentaal
integral	integraal
integrated	geïntegreerde
intelligence	intelligentie-
intelligible	begrijpelijk
interesting	interessant
interests	belangen
intimacy	vertrouwelijkheid
intimate	intiem
intricate	ingewikkeld
intrigue	intrigeren
intriguing	intrigerend
intriguingly	intrigerend
intuitive	intuïtief
invaluable	onschatbaar
inventive	vindingrijk
invigorate	versterken
invigorating	verkwikkende
invincibility	onoverwinnelijkheid
invincible	onoverwinnelijk
inviolable	onschendbaar
inviolate	ongeschonden
invulnerable	onkwetsbaar
irreplaceable	onvervangbaar
irreproachable	onberispelijk
irresistible	onweerstaanbaar
irresistibly	onweerstaanbaar
issue-free	probleem-vrij
jolly	vrolijk
jovial	joviaal
joy	vreugde
joyful	blijde
joyfully	blij
joyous	vreugdevol
jubilant	jubelend
jubilantly	juichend
jubilate	jubelen
jubilation	gejubel
judicious	oordeelkundig
justly	terecht
keen	scherp
keenly	scherp
kid-friendly	kindvriendelijk
kindliness	vriendelijkheid
kindly	vriendelijk
kindness	vriendelijkheid
knowledgeable	geïnformeerde
kudos	roem
laud	lofzang
laudable	prijzenswaardig
laudably	prijzenswaardig
lavish	kwistig
lavishly	rijkelijk
law-abiding	ordelievend
lawful	rechtmatig
lawfully	rechtmatig
lead	lood
leading	leidend
lean	mager
led	LED
legendary	legendarisch
leverage	hefboomwerking
levity	lichtzinnigheid
liberate	bevrijden
liberation	bevrijding
liberty	vrijheid
light-hearted	luchthartig
lighter	aansteker
likable	aardig
liked	vond
likes	sympathieën
lively	levendig
logical	logisch
long-lasting	langdurig
lovable	lief
love	liefde
loved	geliefde
loveliness	liefelijkheid
lovely	heerlijk
lover	minnaar
loves	houdt
loving	liefhebbend
low-cost	goedkoop
loyal	loyaal
loyalty	loyaliteit
lucid	helder
luck	geluk
luckier	geluk
luckiest	gelukkigste
lucky	Lucky
lucrative	winstgevend
luminous	lichtgevend
lush	weelderig
luster	glans
lustrous	glanzend
luxuriant	weelderig
luxurious	luxueus
luxuriously	weelderig
luxury	luxe
lyrical	lyrisch
magic	magie
magical	magisch
magnanimous	grootmoedig
magnanimously	grootmoedig
magnificence	pracht
magnificent	prachtig
magnificently	prachtig
majestic	majestueus
majesty	majesteit
manageable	handelbaar
maneuverable	wendbaar
marvel	wonder
marveled	verwonderd
marvelled	verwonderd
marvellous	wonderbaar
marvelous	wonderbaar
marvelously	verbazend
marvels	wonderen
master	meester
masterful	meesterlijk
masterfully	meesterlijk
masterpiece	meesterwerk
masterpieces	meesterwerken
mastery	meesterschap
matchless	weergaloos
mature	volwassen
maturely	weloverwogen
maturity	rijpheid
meaningful	belangrijk
memorable	gedenkwaardig
merciful	barmhartig
mercifully	genadig
mercy	genade
merit	verdienste
meritorious	verdienstelijk
merrily	vrolijk
merriment	vreugde
merry	vrolijk
mesmerize	hypnotiseren
mesmerized	gebiologeerd
mesmerizing	betoverende
meticulous	nauwkeurig
meticulously	minutieus
mightily	geweldig
mighty	machtig
mind-blowing	geestverruimend
miracle	wonder
miracles	wonderen
miraculous	wonderbaarlijk
miraculously	wonderbaarlijk
modest	bescheiden
modesty	bescheidenheid
momentous	gewichtig
monumental	monumentaal
morality	moraliteit
motivated	gemotiveerd
navigable	bevaarbaar
neat	netjes
neatest	netste
neatly	netjes
nice	leuk
nicely	aardig
nicer	mooier
nicest	aardigste
nifty	handig
nimble	lenig
noble	edele
nobly	adellijk
noiseless	geruisloos
non-violence	geweldloosheid
non-violent	niet-gewelddadige
noteworthy	opmerkelijk
nourish	voeden
nourishing	voedzaam
nourishment	voeding
novelty	nieuwigheid
nurturing	verzorgende
oasis	oase
obsession	obsessie
obsessions	obsessies
obtainable	verkrijgbaar
openly	openlijk
openness	openheid
optimal	optimale
optimism	optimisme
optimistic	optimistisch
opulent	weelderig
orderly	ordelijk
originality	oorspronkelijkheid
outdo	overtreffen
outdone	overtroffen
outperform	overtreffen
outperformed	overtrof
outshine	overschaduwen
outstanding	voortreffelijk
outstandingly	uitstekend
outstrip	overtreffen
outwit	verschalken
ovation	ovatie
overjoyed	dolblij
overtake	inhalen
overtaken	ingehaald
overtakes	overvalt
overtaking	inhalen
overtook	overviel
overture	ouverture
pain-free	pijnloos
painless	pijnloos
painlessly	pijnloos
palatial	paleisachtig
pamper	verwennen
pampered	verwend
panoramic	panoramisch
paradise	paradijs
pardon	Pardon
passion	passie
passionate	hartstochtelijk
patience	geduld
patient	geduldig
patiently	geduldig
patriotic	vaderlandslievend
peace	vrede
peaceable	vredelievend
peaceful	vredig
peacefully	vreedzaam
peacekeepers	vredesmacht
peach	perzik
peerless	weergaloos
pep	fut
pepped	opgepept
pepping	Pepping
peppy	pittig
perfection	perfectie
perfectly	volmaakt
permissible	toelaatbaar
perseverance	volharding
persevere	volharden
personalized	gepersonaliseerde
phenomenal	fenomenaal
phenomenally	fenomenaal
picturesque	pittoreske
piety	vroomheid
pinnacle	hoogtepunt
playful	speels
playfully	speels
pleasant	aangenaam
pleasantly	aangenaam
pleased	verheugd
pleases	behaagt
pleasing	aangenaam
pleasingly	aangenaam
pleasurable	plezierig
pleasure	genoegen
plentiful	overvloedig
pluses	plussen
plush	pluche
plusses	plussen
poetic	poëtisch
poeticize	poëtiseren
poignant	schrijnend
poise	evenwicht
poised	klaar
polished	gepolijst
polite	beleefd
politeness	beleefdheid
popular	populair
posh	chique
positive	positief
positively	positief
positives	positieven
powerful	krachtig
powerfully	krachtig
praise	lof
praiseworthy	lofwaardig
praising	prees
precious	kostbaar
precise	nauwkeurig
precisely	precies
prefer	verkiezen
preferable	verkieslijk
prefered	geprefereerde
prestigious	prestigieus
prettily	mooi
pretty	mooi
priceless	onschatbaar
pride	trots
principled	principiële
privilege	voorrecht
privileged	bevoorrecht
prize	prijs
proactive	proactieve
problem-free	probleemloze
problem-solver	probleemoplosser
prodigious	wonderbaarlijk
prodigiously	verbazend
prodigy	wonderkind
productive	produktief
productively	productief
proficient	bedreven
proficiently	bekwaam
profound	diepgaand
profoundly	diep
profuse	overvloedig
profusion	overvloed
progress	vooruitgang
progressive	progressief
prolific	vruchtbaar
prominence	uitsteeksel
prominent	vooraanstaand
promise	belofte
promised	beloofde
promises	beloften
promising	veelbelovend
promoter	promotor
promptly	prompt
proper	gepast
propitious	gunstig
propitiously	voorspoedig
pros	profs
prosper	gedijen
prosperity	welvaart
prosperous	welvarend
protect	beschermen
protection	bescherming
protective	beschermend
proud	trots
proven	bewezen
proves	bewijst
providence	voorzienigheid
proving	bewijzen
prowess	dapperheid
prudence	voorzichtigheid
prudent	voorzichtig
prudently	voorzichtig
punctual	stipt
pure	zuiver
purify	zuiveren
purposeful	doelbewust
quaint	vreemd
qualified	gekwalificeerd
qualify	kwalificeren
quicker	sneller
quiet	rustig
quieter	stiller
radiance	glans
radiant	stralend
rapid	snel
rapt	verrukt
rapture	vervoering
rapturous	opgetogen
rational	rationeel
razor-sharp	vlijmscherp
reachable	bereikbaar
readable	leesbaar
readily	gemakkelijk
ready	klaar
reaffirm	herbevestigen
reaffirmation	herbevestiging
realistic	realistisch
realizable	uitvoerbaar
reasonable	redelijk
reasonably	redelijk
reassurance	geruststelling
reassure	geruststellen
receptive	ontvankelijk
reclaim	terugeisen
recomend	aanraden
recommend	adviseren
recommendation	aanbeveling
recommendations	aanbevelingen
recommended	aanbevolen
reconcile	verzoenen
reconciliation	verzoening
record-setting	opname-instelling
recover	herstellen
recovery	herstel
rectification	rectificatie
rectify	rectificeren
rectifying	rectificeren
redeem	verlossen
redeeming	verlossende
redemption	verlossing
refine	verfijnen
refined	verfijnd
refinement	raffinage
reform	hervorming
reformed	hervormd
reforming	hervormen
reforms	hervormingen
refresh	verversen
refreshed	vernieuwd
refreshing	verfrissend
refund	terugbetaling
refunded	terugbetaald
regal	vorstelijk
regally	vorstelijk
regard	beschouwen
rejoice	verheugen
rejoicing	vreugdebetoon
rejoicingly	verheugend
rejuvenate	verjongen
rejuvenated	verjongd
rejuvenating	verjongende
relaxed	ontspannen
reliable	betrouwbaar
reliably	betrouwbaar
relief	reliëf
relish	genieten
remarkable	opmerkelijk
remarkably	opmerkelijk
remedy	remedie
remission	kwijtschelding
remunerate	vergoeden
renaissance	Renaissance
renewed	vernieuwd
renown	roem
renowned	vermaard
replaceable	vervangbaar
reputable	achtenswaardig
reputation	reputatie
resilient	veerkrachtig
resolute	vastberaden
resound	weerklinken
resounding	doorslaand
resourceful	vindingrijk
resourcefulness	vindingrijkheid
respect	eerbied
respectable	achtenswaardig
respectful	eerbiedig
respectfully	eerbiedig
respite	uitstel
resplendent	luisterrijk
responsibly	verantwoorde
responsive	sympathiek
restful	rustgevend
restored	hersteld
restructure	herstructureren
restructured	geherstructureerd
restructuring	herstructurering
retractable	intrekbare
revel	zwelgen
revelation	openbaring
revere	Revere
reverence	eerbied
reverent	eerbiedig
reverently	eerbiedig
revitalize	revitaliseren
revival	herleving
revive	herleven
revives	herleeft
revolutionary	revolutionair
revolutionize	revolutioneren
revolutionized	revolutie
revolutionizes	Revolutionair
reward	beloning
rewarding	belonen
rich	rijk
richer	rijker
richly	rijk
richness	rijkheid
right	rechts
righteous	rechtvaardig
righteously	rechtvaardig
righteousness	gerechtigheid
rightful	rechtmatig
rightfully	terecht
rightly	terecht
rightness	rechtheid
risk-free	risicovrij
robust	robuust
rock-star	rockster
rock-stars	rocksterren
rockstar	rockster
rockstars	rocksterren
romantic	romantisch
romantically	romantisch
romanticize	romantiseren
roomy	ruim
rosy	rooskleurig
safe	veilig
safely	veilig
sagacity	scherpzinnigheid
saint	heilige
saintliness	heiligheid
saintly	vroom
salutary	heilzaam
salute	groet
sane	verstandig
satisfactorily	bevredigend
satisfactory	bevredigend
satisfied	tevreden
satisfies	voldoet
satisfy	voldoen
satisfying	bevredigend
saver	spaarder
savings	spaargeld
savior	Heiland
scenic	toneel-
seamless	naadloos
seasoned	gekruid
secure	beveiligen
securely	vast
selective	selectief
self-determination	zelfbeschikking
self-respect	zelfrespect
self-satisfaction	zelfvoldaanheid
self-sufficiency	autarkie
self-sufficient	zelfvoorzienend
sensation	gevoel
sensational	sensationeel
sensationally	sensationeel
sensations	sensaties
sensible	verstandig
sensibly	verstandig
sensitive	gevoelig
serene	sereen
serenity	kalmte
sharp	scherp
sharper	scherpere
sharpest	scherpste
shimmering	glinsterende
shine	schijnen
shiny	glimmend
silent	stil
simpler	eenvoudigere
simplest	eenvoudigste
simplified	vereenvoudigd
simplifies	vereenvoudigt
simplifying	vereenvoudigen
sincere	oprecht
sincerely	oprecht
sincerity	oprechtheid
skill	bekwaamheid
skilled	geschoold
skillful	behendig
skillfully	vakkundig
sleek	glad
slick	glad
smart	slim
smarter	slimmer
smartest	slimste
smartly	slim
smile	glimlach
smiles	glimlacht
smiling	glimlachen
smilingly	glimlachend
smitten	getroffen
smooth	glad
smoother	gladder
smoothes	glad
smoothest	soepelste
smoothly	glad
snappy	pittig
snazzy	hippe
sociable	sociaal
soft	zacht
softer	zachtere
solace	troost
solicitous	bezorgd
solicitously	bezorgd
solid	solide
solidarity	solidariteit
soothe	kalmeren
soothingly	verzachtend
sophisticated	geavanceerde
soulful	gevoelvol
soundly	gezond
soundness	soliditeit
spacious	ruim
sparkle	fonkeling
sparkling	mousserend
spectacular	spectaculaire
spectacularly	spectaculair
speedily	snel
speedy	snel
spellbind	betoveren
spellbinding	betoverende
spirited	levendig
spiritual	geestelijk
splendid	geweldig
splendidly	prachtig
splendor	pracht
spontaneous	spontaan
sporty	sportief
spotless	vlekkeloos
sprightly	levendig
stability	stabiliteit
stabilize	stabiliseren
stable	stal
stainless	roestvrij
standout	uitblinken
stately	statig
statuesque	statuesk
staunch	trouw
staunchness	standvastigheid
steadfast	standvastig
steadfastly	standvastig
steadfastness	standvastigheid
steadiness	vastheid
steady	vast
stellar	stellaire
stellarly	stervormige
stimulate	stimuleren
stimulates	stimuleert
stimulating	stimulerende
stimulative	stimulerend
straighten	strekken
straightforward	rechtdoorzee
streamlined	gestroomlijnd
striking	opvallend
strikingly	opvallend
striving	streven
strong	sterk
stronger	sterker
strongest	sterkste
stunned	verbijsterd
stunningly	verbluffend
stupendous	kolossaal
stupendously	wonderbaarlijk
sturdier	steviger
sturdy	robuust
stylish	elegant
stylishly	elegant
stylized	gestileerde
suave	minzaam
suavely	minzaam
sublime	subliem
subsidize	subsidiëren
subsidized	gesubsidieerde
subsidizes	subsidieert
subsidizing	subsidiëren
substantive	substantief
succeed	slagen
succeeded	geslaagd
succeeding	slagen
succeeds	slaagt
success	succes
successes	successen
successful	geslaagd
suffice	voldoen
sufficed	volstond
suffices	volstaat
sufficient	voldoende
sufficiently	voldoende
suitable	geschikt
sumptuous	weelderig
sumptuously	weelderig
sumptuousness	weelde
superb	prachtig
superbly	prachtig
superior	beter
superiority	superioriteit
supple	soepel
support	ondersteuning
supported	ondersteunde
supporting	ondersteunen
supportive	ondersteunende
supports	ondersteuningen
supremacy	suprematie
supreme	opperst
supremely	uiterst
surmount	overwinnen
surpass	voorbijgaan
surreal	surrealistische
survival	overleving
survivor	overlevende
sustainability	duurzaamheid
sustainable	duurzame
swank	opscheppen
swanky	opschepperig
sweeping	vegen
sweet	zoet
sweeten	veraangenamen
sweetheart	geliefde
sweetly	zoet
sweetness	zoetheid
swift	snel
swiftness	snelheid
talented	getalenteerd
talents	talenten
tantalize	kwellen
tantalizing	verleidelijke
tempt	verleid
tempting	aanlokkelijk
temptingly	verleidelijk
tenacious	vasthoudend
tenaciously	vasthoudend
tenacity	vasthoudendheid
tender	inschrijving
tenderly	teder
terrific	verschrikkelijk
thank	bedanken
thankful	dankbaar
thinner	verdunner
thoughtful	nadenkend
thoughtfully	bedachtzaam
thoughtfulness	bedachtzaamheid
thrift	spaarzaamheid
thrifty	zuinig
thrill	sensatie
thrilled	blij
thrilling	opwindend
thrills	sensatie
thrive	tieren
thriving	bloeiende
tickle	kietelen
tidy	ordelijk
time-honored	Aloud
timely	tijdig
tingle	tintelen
titillate	prikkelen
titillating	zinnenprikkelende
togetherness	saamhorigheid
tolerable	draaglijk
toll-free	tolvrij
top-notch	magnifiek
topnotch	magnifiek
tough	taai
tougher	hardere
toughest	zwaarste
traction	tractie
tranquil	rustig
tranquility	kalmte
transparent	transparant
treasure	schat
tremendously	enorm
trendy	modieus
triumph	triomf
triumphal	triomfantelijke
triumphant	triomfantelijk
triumphantly	triomfantelijk
trivially	triviaal
trophy	trofee
trouble-free	probleemloze
trump	troef
trumpet	trompet
trust	vertrouwen
trusted	vertrouwd
trusting	vertrouwend
trustworthiness	betrouwbaarheid
trustworthy	betrouwbaar
trusty	betrouwbaar
truthful	waarheidlievend
truthfully	Eerlijk
truthfulness	waarachtigheid
ultra-crisp	ultra-scherpe
unabashed	onbeschaamd
unabashedly	ongegeneerd
unaffected	onaangetast
unassailable	onaantastbaar
unbeatable	onverslaanbaar
unbiased	onpartijdige
unbound	ongebonden
uncomplicated	ongecompliceerd
unconditional	onvoorwaardelijk
undamaged	onbeschadigd
undaunted	onverschrokken
understandable	begrijpelijk
undisputable	onbetwistbaar
undisputably	onbetwistbaar
undisputed	onbetwist
unencumbered	onbezwaard
unequivocal	ondubbelzinnig
unequivocally	ondubbelzinnig
unfazed	onaangedaan
unfettered	onbelemmerde
unforgettable	onvergetelijk
unity	eenheid
unlimited	onbeperkt
unmatched	ongeëvenaard
unparalleled	ongeëvenaard
unquestionable	onbetwistbaar
unquestionably	onbetwistbaar
unreal	onwerkelijk
unrestricted	onbeperkt
unrivaled	ongeëvenaard
unselfish	onzelfzuchtig
unwavering	onwrikbaar
upgraded	opgewaardeerd
upheld	gehandhaafd
uphold	hooghouden
uplift	verheffen
usable	bruikbaar
useable	bruikbare
useful	nuttig
user-friendly	gebruikersvriendelijk
user-replaceable	vervangbare
valiant	dapper
valiantly	dapper
valor	moed
valuable	waardevol
variety	verscheidenheid
venerate	vereren
veritable	echt
versatile	veelzijdig
versatility	veelzijdigheid
vibrant	trillend
victorious	zegevierend
victory	zege
viewable	zichtbaar
vigilance	waakzaamheid
vigilant	waakzaam
virtue	deugd
virtuous	deugdzaam
virtuously	deugdzaam
visionary	visionaire
vivacious	levendig
vivid	levendig
vouch	getuigen
vouchsafe	gelief
warmhearted	warmhartige
warmly	hartelijk
warmth	warmte
wealthy	rijk
welcome	Welkom
well	goed
well-balanced	evenwichtig
well-behaved	oppassend
well-being	welzijn
well-bred	welopgevoed
well-established	gevestigde
well-intentioned	goedbedoelde
well-mannered	welgemanierd
well-wishers	weldoeners
wellbeing	welzijn
whoa	ho
wholesome	gezond
whooa	Whooa
willing	gewillig
willingly	gaarne
willingness	bereidwilligheid
win	winnen
windfall	meervallertje
winnable	verkiesbare
winner	winnaar
winners	winnaars
winning	winnend
wins	wint
wisdom	wijsheid
wise	wijs
wisely	verstandig
witty	geestig
wonderful	prachtig
wonderfully	wonderlijk
wonderously	wonderlijk
wonders	wonderen
wondrous	verwonderlijk
woo	vrijen
work	werk
workable	verwerkbaar
worked	werkte
works	werken
worth	waard
worth-while	waard-while
worthiness	waardigheid
worthy	waardig
wow	Wauw
youthful	jeugdig
zeal	ijver
zenith	zenit
zest	smaak
2-faces	2-gezichten
abnormal	abnormaal
abolish	afschaffen
abominable	afschuwelijk
abominably	abominabel
abominate	verfoeien
abomination	gruwel
abort	afbreken
aborted	afgebroken
aborts	aborteert
abrade	afschuren
abrasive	schurende
abruptly	abrupt
abscond	drossen
absence	afwezigheid
absent-minded	afwezig
absentee	afwezige
absurdity	absurditeit
absurdly	belachelijk
absurdness	absurde
abuse	misbruik
abused	misbruikt
abuses	misbruiken
abusive	beledigend
abysmal	onpeilbaar
abysmally	geblunderd
abyss	afgrond
accidental	onopzettelijk
accost	aanklampen
accursed	vervloekt
accusation	beschuldiging
accusations	beschuldigingen
accuse	beschuldigen
accuses	beschuldigt
accusing	beschuldigen
accusingly	beschuldigend
acerbate	verzuren
acerbically	wrange
ache	pijn
aches	pijnen
aching	pijnlijke
acrid	bijtend
acrimonious	bitter
acrimoniously	venijnig
acrimony	scherpheid
adamant	onvermurwbaar
adamantly	onvermurwbaar
addict	verslaafde
addicted	verslaafd
addicting	verslavend
addicts	verslaafden
admonish	vermanen
admonisher	vermaner
admonishingly	vermanend
admonishment	vermaning
admonition	vermaning
adulterate	vervalsen
adulterated	vervalste
adulteration	vervalsing
adversary	tegenstander
adverse	nadelige
adversity	tegenslag
afflict	teisteren
affliction	bezoeking
afflictive	kwellende
affront	belediging
afraid	bang
aggravate	verergeren
aggravating	verzwarend
aggravation	verergering
aggression	agressie
aggressive	agressief
aggressiveness	agressiviteit
aggressor	agressor
aggrieve	bedroeven
aggrieved	gekrenkt
aghast	ontzet
agonize	pijnigen
agonizing	pijnlijke
agonizingly	tergend
agony	doodsangst
ailing	ziekelijk
ailment	kwaal
aimless	doelloos
alarmed	gealarmeerd
alarming	zorgwekkend
alarmingly	verontrustend
alienate	vervreemden
alienated	vervreemd
alienation	vervreemding
allegation	bewering
allegations	beschuldigingen
allege	beweren
allergic	allergisch
allergies	allergieën
allergy	allergie
aloof	afzijdig
altercation	woordenwisseling
ambiguity	dubbelzinnigheid
ambiguous	dubbelzinnig
ambivalence	tegenstrijdigheid
ambivalent	tegenstrijdig
ambush	hinderlaag
amiss	verkeerd
amputate	amputeren
anarchism	anarchisme
anarchistic	anarchistische
anarchy	anarchie
anemic	bloedarm
anger	boosheid
angrily	boos
angry	boos
anguish	angst
animosity	vijandigheid
annihilate	vernietigen
annihilation	vernietiging
annoy	ergeren
annoyance	ergernis
annoyances	ergernissen
annoyed	geërgerd
annoying	vervelend
annoyingly	hinderlijk
annoys	ergert
anomalous	abnormaal
anomaly	afwijking
antagonism	antagonisme
antagonistic	vijandig
antagonize	tegenwerken
anti-american	anti-amerikaanse
anti-israeli	anti-Israëlisch
anti-occupation	anti-bezetting
anti-proliferation	anti-proliferatie
anti-semites	antisemieten
anti-social	antisociaal
anti-white	anti-wit
antipathy	antipathie
antiquated	verouderd
antithetical	tegengesteld
anxieties	angsten
anxiety	angst
anxious	angstig
anxiously	angstig
anxiousness	angstgevoelens
apathetic	apathisch
apathetically	apathisch
apathy	apathie
apocalypse	Apocalypse
apocalyptic	apocalyptische
apologist	apologeet
apologists	apologeten
appal	ontstellen
appall	ontstellen
appalled	geschokt
appalling	verschrikkelijk
appallingly	ontzettend
apprehension	vrees
apprehensions	angsten
apprehensive	beducht
arbitrary	arbitrair
arcane	geheim
archaic	verouderd
arduous	zwaar
arduously	moeizaam
argumentative	betogend
arrogance	arrogantie
arrogantly	arrogant
ashamed	beschaamd
asinine	ezelachtig
askance	schuin
asperse	bekladden
aspersion	laster
aspersions	laster
assail	aanranden
assassin	moordenaar
assassinate	vermoorden
assault	aanval
atrocious	afgrijselijk
atrocities	wreedheden
atrocity	gruweldaad
atrophy	atrofie
attack	aanval
attacks	aanvallen
audacious	vermetel
audaciously	onbeschaamd
audaciousness	vermetelheid
audacity	vermetelheid
austere	sober
authoritarian	autoritair
autocrat	autocraat
autocratic	autocratisch
avalanche	lawine
avarice	gierigheid
avaricious	hebzuchtig
avenge	wreken
averse	afkerig
aversion	afkeer
awful	afschuwelijk
awfully	vreselijk
awkward	onhandig
awkwardness	onhandigheid
ax	bijl
babble	gebabbel
back-logged	back-ingelogd
backache	rugpijn
backaches	rugpijn
backbite	belasteren
backbiting	achterklap
backward	achterwaarts
backwardness	achterlijkheid
backwood	Backwood
backwoods	binnenland
bad	slecht
badly	slecht
baffle	scherm
baffled	verbijsterd
bafflement	verbijstering
baffling	verbijsterend
bait	aas
banal	banaal
bane	verderf
banish	verbannen
banishment	verbanning
bankrupt	bankroet
barbarian	barbaar
barbaric	barbaars
barbarically	barbaarse
barbarity	barbaarsheid
barbarous	barbaars
barbarously	barbaarse
barren	dor
baseless	ongegrond
bashed	sloeg
bashful	verlegen
bastard	bastaard-
bastards	klootzakken
battered	gehavend
battering	mishandeling
batty	gek
bearish	nors
beastly	beestachtig
bedlam	gekkenhuis
bedlamite	gek
befoul	bevuilen
beg	bedelen
beggar	bedelaar
beggarly	armoedig
begging	bedelarij
beguile	bedriegen
belabor	afrossen
belated	verlate
beleaguer	belegeren
belie	logenstraffen
belittle	kleineren
belittled	gekleineerd
belittling	kleinerende
bellicose	krijgszuchtig
belligerence	oorlogszucht
belligerent	strijdlustig
belligerently	strijdlustig
bemoan	bejammeren
bemoaning	beklaagt
bemused	onrustig
bent	krom
berate	schelden
bereave	beroven
bereavement	sterfgeval
bereft	beroofd
berserk	gek
beseech	smeken
beset	bestoken
besiege	belegeren
besmirch	besmeuren
bestial	beestachtig
betray	verraden
betrayal	verraad
betrayals	verraad
betrayer	verrader
betraying	verraden
betrays	verraadt
bewail	bejammeren
bewilder	verbijsteren
bewildered	verbijsterd
bewildering	verbijsterend
bewilderingly	verbijsterend
bewilderment	verbijstering
bewitch	betoveren
bias	vooroordeel
biased	vooringenomen
bicker	kibbelen
bickering	gekibbel
bigotries	kwezelarij
bigotry	kwezelarij
bitch	teef
biting	bijtend
bitingly	bijtend
bitterly	bitter
bitterness	bitterheid
bizarre	bizar
blab	kletskous
blabber	roddelaar
blackmail	chantage
blameworthy	afkeurenswaardig
bland	zacht
blandish	vleien
blaspheme	vloeken
blasphemous	godslasterlijk
blasphemy	godslastering
blasted	gestraald
blatant	schreeuwerig
blatantly	schaamteloos
blather	kletsen
bleak	guur
bleakly	somber
bleakness	kilheid
bleed	bloeden
bleeding	bloeden
bleeds	bloedt
blemish	smet
blind	Blind
blinding	verblindende
blindingly	verblindend
blister	blaar
blistering	blaarvorming
bloated	opgeblazen
blockage	verstopping
blockhead	domkop
bloodshed	bloedvergieten
bloodthirsty	bloeddorstig
bloody	bloedig
blotchy	kladderig
blow	blazen
blunder	flater
blundering	foutief
blunt	stomp
blur	vervagen
blurred	wazig
blurring	vervaging
blurry	wazig
blurs	vervaagt
boastful	opschepperig
boggle	morrelen
bogus	vals
boil	koken
boiling	kookpunt
boisterous	onstuimig
bomb	bom
bombard	bombarderen
bombardment	bombardement
bombastic	bombastisch
bondage	slavernij
bonkers	waanzinnig
bore	boorgat
bored	verveeld
boredom	verveling
bores	boringen
boring	saai
botch	beunhazen
bothering	dwars
bothers	stoort
bothersome	vervelend
bowdlerize	kuisen
boycott	boycot
braggart	bluffer
brainless	hersenloos
brainwash	hersensspoelen
brash	breekbaar
brat	kind
bravado	bravade
brazen	bronzen
brazenly	schaamteloos
breach	schending
break	breken
break-up	Uitmaken
breakdown	afbreken
breaking	breken
breakup	Uitmaken
breakups	scheidingen
bribery	omkoperij
brimstone	zwavel
bristle	borstel
brittle	bros
broken	gebroken
brood	broeden
browbeat	overdonderen
bruised	gekneusd
bruises	kneuzingen
brusque	brusk
brutal	brutaal
brutalising	verdierlijkende
brutalities	wreedheden
brutality	beestachtigheid
brutalize	verdierlijken
brutalizing	verdierlijkende
brutally	brutaal
brute	bruut
brutish	dierlijk
buckle	gesp
bug	kever
bugging	afluisteren
bulkier	omvangrijker
bulkiness	lijvige
bulky	omvangrijk
bullies	pestkoppen
bully	bullebak
bullying	pesten
bum	kont
bump	buil
bumped	gestoten
bumping	stoten
bumps	Drempels
bumpy	hobbelig
bungle	afraffelen
bungler	knoeier
bungling	geknoei
bunk	slaapbank
burden	last
burdensome	zwaar
burn	brandwond
burned	verbrand
burning	brandend
burns	brandwonden
bust	buste
busts	bustes
busybody	bemoeial
butcher	slager
butchery	slagerij
buzzing	zoemend
byzantine	Byzantijns
cackle	kakelen
calamities	calamiteiten
calamitous	rampspoedig
calamity	ramp
callous	ongevoelig
calumniate	belasteren
calumniation	lastering
calumnies	laster
calumnious	lasterlijk
calumny	laster
cancer	kanker
cancerous	kankerachtig
cannibal	kannibaal
cannibalize	kannibaliseren
capitulate	capituleren
capricious	grillig
capriciously	grillig
capriciousness	grilligheid
capsize	kapseizen
careless	zorgeloos
carelessness	slordigheid
caricature	karikatuur
carnage	bloedbad
carp	karper
cartoonish	cartooneske
cash-strapped	cash-vastgebonden
castigate	kastijden
castrated	gecastreerd
casualty	ongeval
cataclysm	natuurramp
cataclysmic	cataclysmische
catastrophe	catastrofe
catastrophes	rampen
catastrophic	katastrofisch
catastrophically	catastrofaal
catastrophies	rampen
caustic	bijtend
caustically	sarcastisch
cautionary	waarschuwend
cave	grot
censure	afkeuring
chafe	schaven
chaff	kaf
chagrin	verdriet
challenging	uitdagend
chaotic	chaotisch
chasten	kuisen
chastise	kastijden
chastisement	kastijding
chatter	klapperen
chatterbox	kletskous
cheap	goedkoop
cheapen	afprijzen
cheaply	goedkoop
cheat	bedriegen
cheated	bedrogen
cheating	bedrog
checkered	geruit
cheerless	ongezellig
cheesy	kaasachtig
chide	berispen
childish	kinderachtig
chill	kilte
chilly	koud
choke	stikken
choleric	prikkelbaar
choppy	veranderlijk
chore	karwei
chronic	chronisch
clamor	geschreeuw
clamorous	luidruchtig
clash	botsen
cliche	cliché
clique	kliek
clog	verstoppen
clogged	verstopte
clogs	klompen
cloud	wolk
clouding	vertroebeling
cloudy	bewolkt
clumsy	onhandig
clunky	onhandig
coarse	grof
cocky	eigenwijs
coerce	dwingen
coercion	dwang
coercive	dwang-
cold	koude
coldly	koud
collapse	ineenstorting
collude	samenspannen
combative	strijdlustig
combust	verbranden
comical	komisch
commonplace	alledaags
commotion	commotie
commotions	beroeringen
complacent	zelfvoldaan
complain	klagen
complained	geklaagd
complaining	klagen
complains	klaagt
complaint	klacht
complaints	klachten
complicated	ingewikkeld
complication	complicatie
complicit	medeplichtig
compulsion	dwang
compulsive	gedwongen
concede	toegeven
conceded	toegegeven
conceit	verwaandheid
conceited	verwaand
concen	con
concern	bezorgdheid
concerned	bezorgd
concerns	bedenkingen
concession	concessie
concessions	concessies
condemn	veroordelen
condemnable	verwerpelijk
condemnation	veroordeling
condemned	veroordeeld
condemns	veroordeelt
condescend	afdalen
condescending	minzaam
condescendingly	minzaam
condescension	genadigheid
confess	bekennen
confession	bekentenis
confessions	bekentenissen
confined	beperkt
conflicted	tweestrijd
conflicting	tegenstrijdig
conflicts	conflicten
confound	verwarren
confounded	beschaamd
confounding	verstorende
confront	confronteren
confrontation	confrontatie
confrontational	confronterend
confuse	verwarren
confused	verward
confuses	verwart
confusing	verwarrend
confusion	verwarring
confusions	verwarringen
congested	overvol
congestion	congestie
conservative	conservatief
conspicuous	opvallend
conspicuously	opvallend
conspiracies	samenzweringen
conspiracy	samenzwering
conspirator	samenzweerder
conspiratorial	conspiratief
conspire	samenzweren
consternation	consternatie
contagious	besmettelijk
contaminate	besmetten
contaminated	vervuild
contaminates	verontreinigingen
contaminating	verontreinigende
contamination	besmetting
contempt	minachting
contemptible	verachtelijk
contemptuous	minachtend
contemptuously	minachtend
contend	beweren
contention	bewering
contentious	omstreden
contort	verwringen
contortions	verdraaiingen
contradict	tegenspreken
contradiction	tegenstrijdigheid
contradictory	tegenstrijdig
contrariness	onverenigbaarheid
contravene	overtreden
contrive	verzinnen
contrived	slinks
controversial	controversieel
controversy	controverse
convoluted	ingewikkelde
corrode	corroderen
corrosion	corrosie
corrosive	bijtend
corrupted	bedorven
corrupting	corrumperende
corruption	corruptie
corrupts	corrumpeert
costlier	duurder
costly	duur
counter-productive	contra-productief
counterproductive	averechts
covetous	hebzuchtig
coward	lafaard
cowardly	laf
crabby	prikkelbaar
crack	barst
cracked	gebarsten
cracks	barsten
craftily	listig
crafty	sluw
cramp	kramp
cramped	krap
cramping	kramp
cranky	humeurig
crap	onzin
crash	neerstorten
crashed	crashte
crashing	crashen
crass	lomp
craven	lafhartig
cravenly	lafhartig
craze	rage
crazily	gek
craziness	krankzinnigheid
crazy	gek
creak	kraken
creaking	krakende
creaks	kraakt
credulous	lichtgelovig
creep	kruipen
creeping	serviel
creepy	griezelig
crept	kroop
crime	misdrijf
criminal	crimineel
cringe	ineenkrimpen
cripple	verlamde
crippled	verminkt
cripples	kreupelen
crippling	kreupele
critic	criticus
critical	kritisch
criticism	kritiek
criticisms	kritiek
criticize	bekritiseren
criticized	bekritiseerd
criticizing	bekritiseren
critics	critici
cronyism	vriendjespolitiek
crook	oplichter
crooked	scheef
crooks	oplichters
crowded	druk
crude	ruw
cruel	wreed
crueler	wreder
cruelest	wreedste
cruelly	wreed
cruelties	wreedheden
cruelty	wreedheid
crumble	verbrokkelen
crumbling	afbrokkelende
crummy	mollig
crumple	verkreukelen
crumpled	verfrommeld
crumples	verfrommelt
crush	verpletteren
crushed	verpletterd
crushing	breken
cry	huilen
culpable	schuldig
culprit	dader
cumbersome	hinderlijk
cunt	kut
cunts	kutten
curse	vloek
cursed	vervloekt
curses	vloeken
curt	kortaf
cuss	vloeken
cussed	koppig
cutthroat	moordenaar
cynical	cynisch
cynicism	cynisme
damage	schade
damaged	beschadigde
damages	schadevergoeding
damaging	schadelijk
damn	vloek
damnable	vervloekt
damnably	vervloekt
damnation	verdoemenis
damned	verdoemde
damning	vernietigend
damper	demper
danger	Gevaar
dangerous	gevaarlijk
dangerousness	gevaarlijkheid
dark	donker
darken	verduisteren
darkened	verduisterd
darker	donkerder
darkness	duisternis
dastard	lafaard
dastardly	lafhartig
daunt	ontmoedigen
daunting	ontmoedigend
dawdle	treuzelen
daze	verdoving
dazed	versuft
dead	dood
deadbeat	Deadbeat
deadlock	impasse
deadly	dodelijk
deadweight	draagvermogen
deaf	doof
dearth	gebrek
death	dood
debase	vernederen
debasement	vernedering
debaser	Debaser
debatable	betwistbaar
debauchery	losbandigheid
debilitate	verzwakken
debilitating	slopende
debility	zwakheid
debt	schuld
debts	schulden
decadence	decadentie
decay	verval
decayed	vervald
deceit	bedrog
deceitful	bedrieglijk
deceitfully	bedrieglijk
deceitfulness	bedrieglijkheid
deceive	misleiden
deceiver	bedrieger
deceivers	bedriegers
deceiving	bedriegen
deception	bedrog
deceptive	bedrieglijk
deceptively	bedrieglijk
declaim	declameren
decline	afwijzen
declines	dalingen
declining	afnemende
decrepit	afgeleefd
decrepitude	gebrekkigheid
decry	afkeuren
defamation	laster
defamations	beledigingen
defamatory	lasterlijk
defame	belasteren
defective	defecte
defects	gebrek
defensive	defensief
defiance	tarting
defiant	uitdagend
defiantly	uitdagend
deficiencies	tekortkomingen
deficiency	tekort
deficient	gebrekkig
defile	defilé
defiler	bezoedelaar
deform	vervormen
deformed	misvormd
defrauding	afzetterij
defunct	overledene
defy	trotseren
degenerate	ontaarden
degeneration	ontaarding
degradation	vermindering
degrade	degraderen
degrading	onterende
degradingly	denigrerend
dehumanization	ontmenselijking
dehumanize	dehumaniseren
deject	ontmoedigen
dejected	neerslachtig
dejectedly	terneergeslagen
dejection	neerslachtigheid
delay	vertraging
delayed	vertraagd
delaying	uitstellen
delays	vertragingen
delinquency	delinquentie
delirious	ijlend
delude	misleiden
deluded	misleide
deluge	zondvloed
delusion	waan
delusional	waanvoorstellingen
delusions	wanen
demean	vernederen
demeaning	vernederend
demise	overlijden
demolish	slopen
demonic	demonisch
demonize	demoniseren
demonized	gedemoniseerd
demonizes	demoniseert
demonizing	demonisering
demoralize	demoraliseren
demoralizing	demoraliserende
denial	ontkenning
denied	ontkend
denies	ontkent
denigrate	bekladden
denounce	opzeggen
dense	dicht
dent	deuk
dented	gedeukt
denunciate	opzeggen
denunciation	aanklacht
denunciations	opzeggingen
deny	ontkennen
denying	ontkennen
deplete	uitputten
deplorable	betreurenswaardig
deplore	betreuren
deploring	betreurt
deprave	bederven
depraved	verdorven
deprecate	afkeuren
depress	deprimeren
depressed	terneergeslagen
depressing	deprimerend
depression	depressie
depressions	depressies
deprive	beroven
deprived	beroofd
deride	bespotten
derision	spot
derisive	honend
derisively	spottend
derogatory	denigrerende
desecrate	ontheiligen
desert	woestijn
desertion	desertie
desiccate	uitdrogen
desiccated	gedroogde
desolate	troosteloos
desolation	verwoesting
despair	wanhoop
despairing	wanhopig
despairingly	wanhopig
desperately	wanhopig
desperation	wanhoop
despicable	verachtelijk
despicably	verachtelijk
despise	verachten
despised	verachte
despoil	beroven
despondency	moedeloosheid
despondent	moedeloos
despondently	moedeloos
despot	despoot
despotic	despotisch
despotism	despotisme
destabilisation	destabilisatie
destitute	ontbloot
destitution	armoede
destroy	vernietigen
destroyer	torpedojager
destruction	verwoesting
destructive	vernietigend
desultory	onsamenhangend
deter	afschrikken
deteriorate	achteruitgaan
deteriorating	verslechterende
deterioration	verslechtering
deterrent	afschrikwekkend
detest	verafschuwen
detestable	verfoeilijk
detestably	verfoeilijk
detested	gehate
detesting	verafschuwen
detests	verafschuwt
detraction	kwaadsprekerij
detriment	schade
detrimental	schadelijk
devastate	verwoesten
devastated	verwoest
devastates	verwoest
devastating	verwoestende
devastatingly	vernietigend
devastation	verwoesting
deviate	afwijken
deviation	afwijking
devil	duivel
devilish	duivels
devilishly	duivels
devilment	kattekwaad
devious	omslachtig
deviously	onoprecht
deviousness	kronkelendheid
devoid	verstoken
diabolic	duivels
diabolical	duivels
diametrically	diametraal
diatribe	schimprede
diatribes	tirades
dick	Dick
dictatorial	dictatoriaal
dies	overlijdt
difficult	moeilijk
difficulties	moeilijkheden
difficulty	moeilijkheid
diffidence	schroom
dilapidated	vervallen
dilly-dally	treuzelen
dim	verduisteren
din	geraas
dings	deuken
dinky	snoezig
dire	verschrikkelijk
dirt	vuil
dirty	vuil
disabled	invalide
disaccord	disakkord
disadvantage	nadeel
disadvantaged	kansarme
disadvantageous	nadelig
disadvantages	nadelen
disaffected	ontevreden
disaffirm	ontrennen
disagreeable	onaangenaam
disagreeably	onaangenaam
disagreed	oneens
disagreeing	oneens
disagreement	meningsverschil
disallow	weigeren
disapointed	teleurgesteld
disapointment	teleurstellingen
disappoint	teleurstellen
disappointed	teleurgesteld
disappointing	teleurstellend
disappointingly	teleurstellend
disappointment	teleurstelling
disappointments	teleurstellingen
disapprobation	afkeuring
disapproval	afkeuring
disapprove	afkeuren
disapproving	afkeurend
disarm	ontwapenen
disarray	wanorde
disaster	ramp
disasterous	rampzalig
disastrous	noodlottig
disastrously	noodlottig
disavow	loochenen
disavowal	ontkenning
disbelief	ongeloof
disbeliever	ongelovige
disclaim	afwijzen
discomfit	verijdelen
discomfort	ongemak
disconcerted	ontdaan
disconcerting	verontrustend
disconsolate	troosteloos
disconsolately	troosteloos
discontent	ontevredenheid
discontented	ontevreden
discontentedly	ontevreden
discontinued	Stopgezet
discontinuity	discontinuïteit
discontinuous	onderbreking
discord	onenigheid
discordance	onenigheid
discordant	tegenstrijdig
discourage	ontmoedigen
discouragement	ontmoediging
discouraging	ontmoedigen
discouragingly	ontmoedigend
discourteous	onbeleefd
discourteously	onhoffelijk
discredit	diskrediet
discrepant	tegenstrijdig
discriminate	onderscheiden
discrimination	discriminatie
discriminatory	discriminerende
disdain	minachting
disdained	verachtte
disdainful	minachtend
disdainfully	minachtend
disfavor	ongenade
disgrace	schande
disgraced	schande
disgraceful	schandelijk
disgracefully	schandelijk
disgruntle	vreden
disgruntled	ontevreden
disgust	walg
disgusted	walging
disgustedly	walging
disgustful	afkerig
disgusting	walgelijk
disgustingly	walgelijk
dishearten	ontmoedigen
disheartening	ontmoedigend
dishonest	oneerlijk
dishonestly	oneerlijk
dishonesty	oneerlijkheid
dishonor	onteren
dishonorable	smadelijk
disillusion	desillusie
disillusioned	gedesillusioneerd
disillusionment	ontgoocheling
disillusions	desillusies
disinclination	ongeneigdheid
disinclined	geneigd
disingenuous	onoprecht
disingenuously	huichelend
disintegrated	uiteengevallen
disintegrates	desintegreert
disintegration	ontbinding
disinterest	onverschilligheid
disinterested	belangeloos
dislike	afkeer
disliked	hekel
disliking	afkeer
disloyal	ontrouw
disloyalty	ontrouw
dismal	somber
dismally	jammerlijk
dismay	ontzetting
dismayed	verbijsterd
dismissive	afwijzend
dismissively	afwijzend
disobedience	ongehoorzaamheid
disobedient	ongehoorzaam
disorder	wanorde
disordered	gekrenkt
disorderly	wanordelijk
disorganized	ongeorganiseerd
disorient	disoriënteren
disoriented	gedesoriënteerd
disown	verloochenen
disparage	geringschatten
disparaging	minachtend
disparagingly	geringschattend
dispensable	overbodig
dispirit	ontmoedigen
dispirited	moedeloos
dispiritedly	ontmoedigd
dispiriting	ontmoedigend
displace	verdringen
displaced	verplaatste
displease	mishagen
displeasure	misnoegen
disproportionate	onevenredig
disprove	weerleggen
disputable	betwistbaar
dispute	geschil
disputed	betwist
disquiet	onrust
disquieting	onrustig
disquietude	verkontrusting
disreputable	berucht
disrepute	schande
disrespect	oneerbiedigheid
disrespectful	oneerbiedig
disrespectfully	oneerbiedig
disrupt	ontwrichten
disruption	ontwrichting
disruptive	verstorend
diss	Diss
dissapointed	teleurgesteld
dissappointed	teleurgesteld
dissappointing	teleurstellend
dissatisfaction	ontevredenheid
dissatisfactory	gebevredigend
dissatisfied	ontevreden
dissatisfying	onbevredigend
dissemble	veinzen
dissembler	huichelaar
dissension	tweedracht
dissenter	afgescheidene
disservice	ondienst
dissidence	afscheiding
dissidents	dissidenten
dissocial	eenzelvig
dissolute	losbandig
dissolution	ontbinding
dissonance	dissonant
dissonant	dissonerend
dissuade	afraden
dissuasive	ontradend
distaste	afkeer
distasteful	onsmakelijk
distort	verdraaien
distorted	vervormd
distortion	vervorming
distorts	vervormt
distract	afleiden
distracting	afleidende
distraction	afleiding
distraught	radeloos
distress	nood
distressing	schrijnende
distressingly	bedroevend
distrust	wantrouwen
distrustful	wantrouwend
distrusting	wantrouwen
disturb	storen
disturbance	verstoring
disturbed	verstoord
disturbing	storend
disturbingly	verontrustend
disunity	verdeeldheid
disvalue	onwaarde
divergent	afwijkend
divisive	verdeeldheid
dizzy	duizelig
doddering	strompelend
dogged	vasthoudend
doggedly	hardnekkig
dogmatic	dogmatisch
domineer	overheersen
domineering	heerszuchtig
doom	noodlot
doomed	verdoemde
doubt	twijfel
doubtful	twijfelachtig
doubtfully	twijfelachtig
doubts	twijfels
douchbag	Douchbag
douchebag	sukkel
downcast	neerslachtig
downfall	val
downhill	bergafwaarts
downside	keerzijde
downsides	minpunten
downturn	daling
downturns	teruggang
drab	saai
draconian	draconische
draconic	drakonisch
drag	slepen
dragged	gesleept
dragging	slepen
dragoon	dragonder
drags	sleept
drain	draineren
drained	gedraineerd
draining	aftappen
drastic	drastisch
drastically	drastisch
drawback	nadeel
drawbacks	nadelen
dread	vrezen
dreadful	vreselijk
dreadfully	vreselijk
dreadfulness	verschrikkelijkheid
dreary	somber
dripped	droop
dripping	druipen
drips	druppels
droop	hangen
droops	inzakkingen
drop-out	afvaller
dropout	afvaller
drought	droogte
drowning	verdrinking
drunk	dronken
drunkard	dronkaard
drunken	dronken
dubious	twijfelachtig
dubiously	twijfelachtig
dubitable	twijfelend
dud	prul
dull	dof
dullard	sufferd
dumb	stom
dumbfound	verbluffen
dump	stortplaats
dumped	gedumpt
dumps	stortplaatsen
dunce	domkop
dungeon	kerker
dungeons	kerkers
dust	stof
dusty	stoffig
dwindling	slinkende
dying	stervende
earsplitting	oorverdovend
eccentric	excentriek
eccentricity	excentriciteit
effigy	beeltenis
effrontery	onbeschaamdheid
egocentric	egocentrisch
egomania	eigendunk
egotism	zelfzucht
egotistical	egoïstische
egotistically	egoistisch
egregious	flagrante
election-rigger	verkiezing-rigger
elimination	eliminatie
emaciated	uitgehongerd
emasculate	ontzenuwen
embarrassing	gênant
embarrassingly	beschamend
embarrassment	verlegenheid
embattled	strijdende
embroil	verwikkelen
embroiled	verwikkeld
embroilment	verwikkeling
emergency	noodgeval
emphatic	nadrukkelijk
emphatically	nadrukkelijk
emptiness	leegte
encroach	tasten
encroachment	inbreuk
enemies	vijanden
enemy	vijand
enervate	verzwakken
enfeeble	verzwakken
enflame	ophitsen
engulf	verzwelgen
enjoin	bevelen
enmity	vijandschap
enraged	verwoed
entangle	verstrikken
entanglement	verstrikking
entrap	verstrikken
entrapment	beknelling
envious	jaloers
enviously	afgunstig
enviousness	afgunst
epidemic	epidemie
equivocal	dubbelzinnig
erase	wissen
erode	eroderen
erodes	erodeert
erosion	erosie
err	dwalen
errant	dwalend
erratic	grillige
erratically	onregelmatig
erroneous	foutief
erroneously	foutief
error	fout
errors	fouten
eruptions	uitbarstingen
eschew	schuwen
estranged	vervreemd
evade	ontwijken
evasion	ontduiking
evasive	ontwijkend
evil	onheil
evildoer	boosdoener
evils	kwaden
eviscerate	uithalen
exacerbate	verscherpen
exagerated	overdreven
exaggerate	overdrijven
exaggeration	overdrijving
exasperate	ergeren
exasperated	verbitterd
exasperating	ergerlijk
exasperatingly	tergend
exasperation	ergernis
excessive	buitensporig
excessively	buitensporig
exclusion	uitsluiting
excruciating	ondraaglijk
excuse	excuus
execrate	verwensen
exhaust	uitlaat
exhausted	uitgeput
exhaustion	uitputting
exhausts	uitlaten
exhorbitant	exorbitant
exhort	vermanen
exile	verbanning
exorbitant	buitensporig
exorbitantly	buitensporig
expel	verdrijven
expensive	duur
expire	vervallen
explode	ontploffen
exploit	exploiteren
exploitation	exploitatie
explosive	ontplofbaar
expropriate	onteigenen
expropriation	onteigening
expunge	uitwissen
exterminate	uitroeien
extermination	uitroeiing
extinguish	doven
extort	afpersen
extortion	afpersing
extraneous	vreemd
extravagance	verkwisting
extravagant	buitensporig
extravagantly	buitensporig
extremism	extremisme
extremist	extremistische
extremists	extremisten
eyesore	doorn
fabricate	fabriceren
fabrication	verzinsel
facetious	grappig
fail	mislukken
failed	mislukt
failing	tekortkoming
fails	mislukt
failure	mislukking
failures	mislukkingen
faint	flauw
fainthearted	watjes
faithless	trouweloos
fake	nep
fall	vallen
fallacies	drogredenen
fallacious	misleidend
fallaciously	bedrieglijk
fallaciousness	misleidendheid
fallacy	bedrieglijkheid
fallen	gesneuvelde
falling	vallend
false	vals
falsehood	leugen
falsely	vals
falsify	vervalsen
falter	wankelen
faltered	haperde
famine	hongersnood
famished	uitgehongerd
fanatic	fanaticus
fanatical	fanatiek
fanatically	fanatiek
fanaticism	fanatisme
fanatics	fanatici
fanciful	denkbeeldig
far-fetched	vergezocht
farce	klucht
farcical	kluchtig
farcical-yet-provocative	kluchtige-nog-provocerende
farfetched	vergezocht
fastidious	kieskeurig
fastidiously	kieskeurig
fat	dik
fatal	dodelijk
fatalistic	fatalistische
fatalistically	fatalistisch
fatally	gedoemd
fateful	noodlottig
fathomless	pielloos
fatigue	vermoeidheid
fatigued	vermoeid
fatique	vermoeidheid
fatty	vet
fatuity	dwaasheid
fatuous	dom
fatuously	dwaas
fault	fout
faults	storingen
faulty	defect
fear	angst
fearful	angstig
fearfully	vreselijk
fears	angsten
fearsome	vreselijk
feckless	waardeloos
feeble	zwak
feebleminded	zwakzinnig
feign	veinzen
feint	schijnbeweging
fell	viel
felon	misdadiger
felonious	misdadig
ferociously	woest
ferocity	wildheid
fetid	stinkend
fever	koorts
feverish	koortsig
fevers	koortsen
fib	jokken
fibber	leugenaar
fickle	wispelturig
fiction	fictie
fictional	fictief
fictitious	gefingeerd
fidget	wriemelen
fidgety	ongedurig
fiend	duivel
fiendish	duivels
fierce	woest
figurehead	schegbeeld
filth	vuiligheid
filthy	vies
finagle	beernemen
finicky	kieskeurig
fissures	kloven
fist	vuist
flagging	markeren
flagrant	flagrante
flagrantly	flagrant
flak	luchtdoelgeschut
flake	vlok
flaking	schilferen
flaky	vlokkig
flare	gloed
flaunt	pronken
flaw	fout
flawed	gebrekkig
flaws	gebreken
flee	vluchten
fleed	gevlucht
fleeing	vluchtende
flees	vlucht
fleeting	vluchtig
flicker	flikkeren
flickering	flikkeren
flickers	flikkert
flighty	vluchtig
flimflam	onzin
flimsy	dun
flirty	koket
floored	gevloerd
flounder	bot
floundering	ploeteren
flout	bespotten
foe	vijand
fool	dwaas
foolhardy	roekeloos
foolish	dwaas
foolishly	dwaas
foolishness	dwaasheid
forbid	verbieden
forbidden	verboden
forbidding	afschrikwekkend
forceful	krachtig
foreboding	voorteken
forfeit	verbeuren
forged	nagemaakt
forgetful	vergeetachtig
forgetfulness	vergeetachtigheid
forlorn	verlaten
forsake	verlaten
forsaken	verlaten
forswear	afzweren
foul	vals
foully	walgelijk
fractious	kribbig
fractiously	weerspannig
fracture	breuk
fragile	breekbaar
fragmented	gedeeltelijk
frail	fragiel
frantic	krankzinnig
frantically	woest
fraud	bedrog
fraudulent	frauduleus
fraught	vol
frazzle	vodden
freak	gek
freaking	verdomde
freakish	grillig
freakishly	nukkig
freeze	bevriezen
freezes	bevriest
freezing	ijskoud
frenetic	razend
frenetically	krampachtig
frenzied	waanzinnig
frenzy	razernij
fret	kniezen
fretful	knorrig
friction	wrijving
frictions	fricties
fried	gebakken
frigging	vervloekt
fright	schrik
frighten	verschrikken
frightening	beangstigend
frighteningly	beangstigend
frightful	verschrikkelijk
frightfully	vreselijk
frigid	koud
frost	vorst
frown	frons
froze	bevroor
frozen	bevroren
fruitless	vruchteloos
fruitlessly	vruchteloos
frustrate	frustreren
frustrated	gefrustreerd
frustrates	frustreert
frustrating	frustrerend
frustratingly	frustrerend
frustration	frustratie
frustrations	frustraties
fuck	neuken
fucking	neuken
fudge	onzin
fugitive	vluchteling
full-blown	volslagen
fulminate	fulmineren
fumble	morrelen
fume	damp
fumes	dampen
fundamentalism	fundamentalisme
funny	grappig
furious	woedend
furiously	woedend
furor	furore
fury	woede
fuss	ophef
fussy	kieskeurig
fustigate	ranselen
fusty	muf
futile	vergeefs
futilely	nutteloos
futility	futiliteit
gabble	gekakel
gaff	gaffel
gaffe	blunder
gainsay	tegenspreken
gall	gal
galling	vreten
galls	gallen
gape	gapen
garbage	vuilnis
garish	opzichtig
gasp	snik
gauche	onhandig
gaudy	opzichtig
gawk	gapen
gawky	klungelig
geezer	sujet
ghastly	afgrijselijk
ghetto	getto
gibber	gebrabbel
gibberish	koeterwaals
gibe	hatelijkheid
giddy	duizelig
gimmick	truc
glare	schittering
glaringly	schreeuwend
glib	welbespraakt
glitches	fouten
gloom	somberheid
gloomy	somber
glum	sip
glut	overvoeren
gnawing	knagend
goad	prikkel
god-awful	verschrikkelijk
goof	domkop
gossip	roddel
graceless	lomp
graft	enten
grainy	korrelig
grapple	pakken
grate	rooster
grating	rooster
gravely	somber
greasy	vettig
greed	hebzucht
greedy	gulzig
grief	verdriet
grievance	grief
grievances	grieven
grieve	treuren
grieving	rouwende
grievous	smartelijk
grievously	deerlijk
grim	grimmig
grimace	grimas
grind	malen
gripe	houvast
gripes	kramp
grisly	griezelig
gritty	zanderig
gross	bruto
grossly	grof
grotesque	grotesk
grouch	mopperen
grouchy	knorrig
groundless	ongegrond
grouse	kankeren
growl	grommen
grudge	wrok
grudges	wrok
grudging	vrekkig
grudgingly	onwillig
gruesome	ijzingwekkend
gruesomely	gruwelijk
gruff	nors
grumble	mopperen
grumpy	knorrig
guile	bedrog
guilt	schuld
guilty	schuldig
gullible	lichtgelovig
gutter	goot
hack	houwen
haggard	verwilderd
haggle	marchanderen
hairloss	haaruitval
halfheartedly	halfslachtig
hallucinate	hallucineren
hallucination	hallucinatie
hamper	hinderen
hampered	belemmerd
handicapped	gehandicapte
hang	hangen
hangs	hangt
haphazard	lukraak
hapless	ongelukkige
harangue	toespraak
harass	kwellen
harassed	lastiggevallen
harassment	Intimidatie
harboring	herbergen
harbors	havens
harden	verharden
hardened	gehard
hardheaded	koppig
hardship	ontbering
hardships	ontberingen
harm	kwaad
harmed	geschaad
harmful	schadelijk
harms	Harms
harpy	harpij
harried	gekwelde
harrow	eg
harsh	hard
harshly	hard
hassle	gedoe
hassled	lastiggevallen
hassles	gedoe
haste	haast
hastily	haastig
hasty	haastig
hated	gehaat
hateful	hatelijk
hatefully	hatelijk
hatefulness	afstotelijkheid
hates	haat
hating	haten
hatred	haat
haughtily	hooghartig
haughty	hooghartig
haunt	spoken
haunting	rondspoken
havoc	verwoesting
haywire	verstoord
hazard	risico
hazardous	gevaarlijk
haze	nevel
hazy	vaag
head-aches	kop-pijn
headache	hoofdpijn
headaches	hoofdpijn
heartbreaker	hartenbreker
heartbreaking	hartverscheurend
heartless	harteloos
heathen	heidenen
heavy-handed	onhandig
heck	deurklink
heckle	hekel
hectic	hectische
hedge	haag
hedonistic	hedonistische
heedless	achteloos
hefty	zwaar
hegemonism	hegemonisme
hegemonistic	hegemonistische
hegemony	hegemonie
heinous	gruwelijk
hell	hel
hell-bent	vastbesloten
hellion	brutaaltje
helpless	hulpeloos
helplessly	hulpeloos
helplessness	hulpeloosheid
heresy	ketterij
heretic	ketter
heretical	ketters
hesitant	aarzelend
hideous	afschuwelijk
hideously	afzichtelijk
hideousness	afzichtelijkheid
hinder	hinderen
hindrance	hinder
hiss	fluiten
hissed	siste
hissing	sissend
hoard	schat
hobble	hinken
hollow	hol
hoodwink	verschalken
hopeless	hopeloos
hopelessly	hopeloos
hopelessness	hopeloosheid
horrendous	vreselijk
horrendously	vreselijk
horrible	verschrikkelijk
horrid	afschuwelijk
horrific	gruwelijk
horrified	geschokt
horrifies	schrikt
horrifying	gruwelijke
hostage	gijzelaar
hostile	vijandig
hostilities	vijandelijkheden
hostility	vijandigheid
hotbeds	brandhaarden
hothead	vaaghals
hotheaded	heethoofdig
hothouse	broeikas
huckster	venter
hum	brommen
humid	vochtig
humiliate	vernederen
humiliating	vernederend
humiliation	vernedering
humming	zoemend
hurtful	schadelijk
hurting	kwetsen
hustler	energinemens
hypocricy	schijnheiligheid
hypocrisy	huichelarij
hypocrite	huichelaar
hypocrites	huichelaars
hypocritical	schijnheilig
hypocritically	schijnheilig
hysteria	hysterie
hysteric	hysterisch
hysterical	hysterisch
hysterically	hysterisch
hysterics	zenuwaanval
idiocies	dwaasheden
idiocy	idiotie
idiot	idioot
idiotic	idioot
idiotically	idioot
idiots	idioten
idle	nutteloos
ignoble	verachtelijk
ignominious	schandelijk
ignominy	schande
ignorance	onwetendheid
ignorant	onwetend
ignore	negeren
ill-advised	onbezonnen
ill-conceived	ondoordachte
ill-fated	noodlottig
ill-favored	lelijk
ill-mannered	ongemanierd
ill-natured	kwaadaardig
ill-tempered	kwaadgeluimd
ill-treated	mishandeld
ill-treatment	mishandeling
ill-usage	mishandelingen
illegal	onwettig
illegally	wederrechtelijk
illegitimate	onwettig
illicit	ongeoorloofd
illiterate	analfabeet
illness	ziekte
illogic	onlogische
illogical	onlogisch
illogically	onlogisch
illusion	illusie
illusions	illusies
illusory	illusoir
imaginary	denkbeeldig
imbalance	onbalans
imbecile	imbeciel
imbroglio	verwikkeling
immaterial	onbelangrijk
immature	onvolwassen
imminence	dreiging
immobilized	geïmmobiliseerd
immoderate	mateloos
immoderately	mateloos
immodest	onbescheiden
immoral	onzedelijk
immorality	onzedelijkheid
immorally	immoreel
immovable	onroerend
impair	aantasten
impaired	verzwakt
impatience	ongeduld
impatient	ongeduldig
impatiently	ongeduldig
impeach	beschuldigen
impedance	impedantie
impede	belemmeren
impediment	belemmering
impending	dreigend
impenitent	verstokt
imperfect	onvolmaakt
imperfection	onvolmaaktheid
imperfections	onvolkomenheden
imperfectly	onvolkomen
imperious	heerszuchtig
imperiously	heerszuchtig
impermissible	ontoelaatbaar
impersonal	onpersoonlijk
impertinent	onbeschaamd
impetuous	onstuimig
impetuously	onstuimig
impiety	goddeloosheid
impinge	botsen
impious	goddeloos
implacable	onverzoenlijk
implausible	onaannemelijk
implicate	betrekken
implication	implicatie
implode	imploderen
impolite	onbeleefd
impolitic	onverstandig
importunate	opdringerig
impose	opleggen
imposing	indrukwekkend
imposition	oplegging
impossible	onmogelijk
impossibly	onmogelijk
impotent	onmachtig
impoverish	verarmen
impoverished	verarmde
impractical	onuitvoerbaar
imprecate	verwensen
imprecise	onnauwkeurig
imprecisely	onnauwkeurig
imprecision	onnauwkeurigheid
imprison	opsluiten
imprisonment	gevangenisstraf
improbability	onwaarschijnlijkheid
improbable	onwaarschijnlijk
improbably	onwaarschijnlijk
improper	onjuist
improperly	onjuist
impropriety	ongepastheid
imprudence	onvoorzichtigheid
imprudent	onvoorzichtig
impudence	onbeschaamdheid
impudent	onbeschaamd
impudently	onbeschaamd
impugn	betwisten
impulsive	impulsief
impulsively	impulsief
impunity	straffeloosheid
impure	onzuiver
impurity	onzuiverheid
inability	onvermogen
inaccuracies	onjuistheden
inaccuracy	onnauwkeurigheid
inaccurate	onnauwkeurig
inaccurately	onnauwkeurig
inaction	werkeloosheid
inactive	inactief
inadequacy	ontoereikendheid
inadequate	ontoereikend
inadequately	onvoldoende
inadvisable	afgeraden
inane	zinloos
inappropriate	ongepast
inappropriately	ongepaste
inapt	ongeschikt
inaptitude	onbekwaamheid
inarticulate	ongeleed
inattentive	onoplettend
inaudible	onhoorbaar
incapable	onbekwaam
incautious	onvoorzichtig
incendiary	brandstichter
incense	wierook
incessant	onophoudelijk
incessantly	onophoudelijk
incite	aansporen
incitement	aansporing
incivility	onbeleefdheid
inclement	guur
incoherence	onsamenhangendheid
incoherent	onsamenhangend
incoherently	onsamenhangend
incommensurate	ongeëvenredigd
incomparable	onvergelijkelijk
incomparably	onvergelijkbaar
incompatibility	onverenigbaarheid
incompatible	onverenigbaar
incompetence	onbekwaamheid
incompetent	onbekwaam
incomplete	incompleet
incomprehensible	onbegrijpelijk
incomprehension	onbegrip
inconceivable	onbegrijpelijk
inconceivably	onbegrijpelijk
incongruous	ongerijmd
inconsequent	onlogisch
inconsequential	inconsequent
inconsequently	inconsequent
inconsiderate	onbezonnen
inconsistence	inconsistentie
inconsistencies	inconsistenties
inconsistency	tegenstrijdigheid
inconsistent	inconsequent
inconsolable	ontroostbaar
inconstant	wispelturig
inconvenience	ongemak
incorrectly	onjuist
incorrigible	onverbeterlijk
incredulous	ongelovig
incredulously	ongelooflijk
inculcate	inprenten
indecency	onfatsoenlijkheid
indecent	onfatsoenlijk
indecently	onwelvoeglijk
indecision	besluiteloosheid
indecisive	besluiteloos
indefensible	onverdedigbaar
indelicate	onkies
indeterminable	onbepaalbaar
indeterminate	onbepaald
indifference	onverschilligheid
indifferent	onverschillig
indigent	behoeftig
indignant	verontwaardigd
indignantly	verontwaardigd
indignation	verontwaardiging
indignity	vernedering
indiscreetly	indiscreet
indiscretion	indiscretie
indiscriminate	onoordeelkundig
indiscriminately	klakkeloos
indoctrinate	suggereren
indoctrination	indoctrinatie
indulge	verwennen
ineffectively	ondoelmatig
ineffectiveness	ineffectiviteit
ineffectual	vruchteloos
ineffectually	vruchteloos
inefficacious	ondoeltreffend
inefficacy	onefectiefheid
inefficiency	ondoeltreffendheid
inefficient	inefficiënt
inefficiently	inefficiënt
inelegance	onbevalligheid
inelegant	onbevallig
inept	onzinnig
ineptitude	onzinnigheid
ineptly	pakt
inequalities	ongelijkheid
inequality	ongelijkheid
inequitable	onbillijk
inequitably	ongelijk
inequities	ongelijkheid
inescapable	onontkoombaar
inescapably	onontsnapbaar
inessential	bijkomstig
inevitable	onvermijdelijk
inevitably	onvermijdelijk
inexcusable	onvergeeflijk
inexorable	onverbiddelijk
inexorably	onverbiddelijk
inexperience	onervarenheid
inexperienced	onervaren
inexpert	ondeskundig
inexpertly	ondeskundig
inextricably	onlosmakelijk
infamous	berucht
infamy	schanddaad
infected	besmet
infection	infectie
infections	infecties
inferior	inferieur
inferiority	minderwaardigheid
infernal	hels
infested	geteisterd
infidel	ongelovige
infidels	ongelovigen
infiltrator	infiltrant
infiltrators	infiltranten
infirm	zwak
inflame	ontvlammen
inflammation	ontsteking
inflammatory	opruiend
inflated	opgeblazen
inflationary	inflatoire
inflexible	onbuigzaam
inflict	toebrengen
infraction	inbreuk
infringement	inbreuk
infringements	inbreuken
infuriate	woeden
infuriated	woedend
infuriating	razend
inglorious	roemloos
ingratitude	ondankbaarheid
inhibit	verhinderen
inhibition	remming
inhospitable	onherbergzaam
inhospitality	ongastvrijheid
inhuman	onmenselijk
inhumane	onmenselijk
inhumanity	onmenselijkheid
inimical	vijandig
inimically	vijandig
iniquitous	onbillijk
iniquity	ongerechtigheid
injudicious	onoordeelkundig
injure	verwonden
injurious	schadelijk
injury	letsel
injustice	onrecht
injustices	onrecht
inoperable	inoperabele
inopportune	ongelegen
inordinate	buitensporig
inordinately	buitensporig
insane	krankzinnig
insanely	gek
insanity	krankzinnigheid
insatiable	onverzadelijk
insecure	onzeker
insecurity	onzekerheid
insensible	ongevoelig
insensitive	ongevoelig
insensitively	ongevoelig
insensitivity	ongevoeligheid
insidious	verraderlijk
insidiously	verraderlijk
insignificance	onbeduidendheid
insignificant	onbelangrijk
insignificantly	onbetekenend
insincere	onoprecht
insincerely	onoprecht
insincerity	onoprechtheid
insinuate	insinueren
insinuating	insinuerende
insinuation	insinuatie
insolence	onbeschaamdheid
insolent	onbeschaamd
insolently	onbeschaamd
insouciance	onverschilligheid
instability	onbestendigheid
instable	instabiele
instigate	aansporen
instigator	aanstichter
instigators	aanstichters
insubordinate	opstandig
insufferable	onduldbaar
insufficiency	ontoereikendheid
insufficiently	onvoldoende
insular	bekrompen
insult	belediging
insulted	beledigend
insulting	beledigend
insultingly	beledigend
insults	beledigingen
insupportable	ondraaglijk
insupportably	onuitstaanbaar
insurmountable	onoverkomelijk
insurmountably	onoverkomelijk
insurrection	opstand
intense	intens
interfere	interfereren
interference	inmenging
interferes	interfereert
intermittent	periodieke
interrupt	onderbreken
interruption	onderbreking
interruptions	onderbrekingen
intimidate	intimideren
intimidating	intimiderend
intimidation	intimidatie
intolerable	ondraaglijk
intolerance	onverdraagzaamheid
intoxicate	bedwelmen
intractable	onhandelbaar
intransigence	onverzettelijkheid
intrude	opdringen
intrusion	indringing
intrusive	opdringerig
inundate	overstelpen
inundated	overspoeld
invader	binnendringer
invalid	ongeldig
invalidate	ontzenuwen
invalidity	invaliditeit
invasive	invasieve
invective	scheldwoorden
inveigle	verleiden
invidious	hachelijk
invisible	onzichtbaar
involuntarily	onvrijwillig
involuntary	onwillekeurig
irascible	opvliegend
irate	verbolgen
ire	toorn
irk	ergeren
irked	geërgerd
ironic	ironisch
ironical	ironische
ironically	ironisch
irony	ironie
irrational	irrationeel
irrationalities	irrationaliteiten
irrationality	onredelijkheid
irreconcilable	onverzoenlijk
irrecoverable	oninbaar
irrecoverably	reddeloos
irredeemable	onherstelbaar
irredeemably	onverbeterlijk
irregular	onregelmatig
irregularity	onregelmatigheid
irrelevance	irrelevantie
irreparable	onherstelbaar
irrepressible	ononderdrukbaar
irresolute	besluiteloos
irresolvable	onoplosbaar
irresponsible	onverantwoordelijk
irresponsibly	onverantwoordelijk
irretrievable	onherstelbaar
irreversible	onomkeerbare
irritable	prikkelbaar
irritably	geërgerd
irritant	prikkelend
irritate	irriteren
irritated	geërgerd
irritating	irritant
irritation	ergernis
irritations	irritaties
isolate	isoleren
isolated	geïsoleerd
isolation	isolatie
issue	kwestie
issues	kwesties
itch	jeuk
itching	jeuk
itchy	jeukend
jabber	wauwelen
jaded	afgemat
jagged	getand
jarring	woordenstrijd
jaundiced	pessimistisch
jealous	jaloers
jealously	angstvallig
jealousy	jaloezie
jeer	spotten
jeering	beschimping
jeeringly	honend
jeopardy	gevaar
jerk	ruk
jittery	gejaagd
job-killing	job-doden
jobless	werkloos
joke	grap
joker	grappenmaker
jolt	schok
juddering	trillende
jumpy	zenuwachtig
junk	rommel
junkyard	autokerkhof
jutter	Jutter
jutters	Jutters
kill	doden
killed	gedood
killer	moordenaar
killing	doden
knave	boer
knife	mes
knock	klop
knotted	geknoopt
kooky	geschift
lack	gebrek
lackadaisical	lusteloos
lacked	ontbrak
lackey	lakei
lackeys	lakeien
lacking	ontbrekend
lackluster	dof
lacks	mist
laconic	lakoniek
lag	vertraging
lagged	achtergebleven
lagging	achterblijvende
lags	vertragingen
laid-off	ontslagen
lambaste	aftuigen
lame	kreupel
lament	weeklacht
lamentable	betreurenswaardig
languid	loom
languish	wegkwijnen
languor	loomheid
languorous	zwoel
languorously	smachtend
lanky	slungelachtig
lapse	verloop
lapsed	verlopen
lapses	vervalt
lascivious	wulps
last-ditch	waaghalzig
laughable	lachwekkend
laughably	belachelijk
lawbreaker	wetsovertreder
lawless	wetteloos
lawlessness	wetteloosheid
layoff	ontslag
layoff-happy	ontslag-happy
lazy	lui
leak	lek
leakage	lekkage
leakages	lekkages
leaking	lekkende
leaks	lekken
leaky	lek
lecher	geilaard
lecherous	wellustig
lechery	ontucht
leech	bloedzuiger
leer	koeloven
leery	sluw
left-leaning	linkse
lemon	citroen
lengthy	langdurig
lethal	dodelijk
lethargic	slaperig
lethargy	loomheid
lewd	ontuchtig
lewdness	wulpsheid
liability	aansprakelijkheid
liable	aansprakelijk
liar	leugenaar
liars	leugenaars
licentious	losbandig
licentiously	ongebreideld
licentiousness	losbandigheid
lie	liggen
lied	gelogen
lies	leugens
life-threatening	levensbedreigend
lifeless	levenloos
limit	begrenzing
limitation	beperking
limitations	beperkingen
limited	beperkt
limits	limieten
limp	slap
listless	lusteloos
litigious	betwistbaar
livid	razend
loath	afkerig
loathe	verafschuwen
loathing	walging
loathsome	walgelijk
lone	eenzaam
loneliness	eenzaamheid
lonely	eenzaam
loner	eenzame
lonesome	eenzaam
long-winded	langdradig
longing	verlangen
longingly	verlangend
loophole	uitvlucht
loopholes	mazen
loose	los
loot	buit
lorn	Lorn
lose	verliezen
loser	verliezer
losers	verliezers
loses	verliest
losing	verliezen
loss	verlies
losses	verliezen
lost	verloren
loud	luid
louder	luider
lousy	beroerd
loveless	liefdeloos
lowly	nederig
ludicrous	belachelijk
ludicrously	belachelijk
lugubrious	luguber
lukewarm	lauw
lull	wiegen
lumpy	klonterige
lunatic	gek
lurch	slingeren
lure	lokken
lurid	luguber
lurking	loer
mad	boos
madder	meekrap
madly	gek
madman	gek
madness	krankzinnigheid
malady	ziekte
malcontent	ontevreden
maledict	Maledict
malevolence	kwaadwilligheid
malevolent	kwaadwillig
malevolently	kwaadaardig
malice	kwaadaardigheid
malicious	kwaadaardig
maliciously	kwaadwillig
malign	kwaadaardig
malignant	kwaadaardig
malodorous	onwelriekende
maltreatment	mishandeling
mangle	mangel
mangled	verminkte
mangles	mangels
mangling	mangelen
mania	manie
maniacal	waanzinnig
manic	manisch
manipulate	manipuleren
manipulation	manipulatie
manipulative	manipulatieve
mar	bederven
marginal	marginaal
marginally	marginaal
martyrdom	marteldood
martyrdom-seeking	martelaarschap-seeking
mashed	gestampt
massacre	bloedbad
massacres	moordpartijen
mawkish	sentimenteel
mawkishly	sentimenteel
mawkishness	zoetheid
meager	mager
meaningless	zinloos
meanness	gemeenheid
measly	miezerig
meddlesome	bemoeiziek
mediocre	middelmatig
mediocrity	middelmatigheid
melancholy	weemoed
melodramatic	melodramatisch
melodramatically	melodramatisch
meltdown	kernsmelting
menace	bedreiging
menacing	dreigend
mendacious	leugenachtig
mendacity	leugenachtigheid
menial	huurling
merciless	meedogenloos
mercilessly	Genadeloos
mess	knoeien
messes	knoeit
messing	knoeien
messy	rommelig
midget	miniatuur
militancy	strijdlust
mindless	dwaas
mindlessly	gedachteloos
mirage	luchtspiegeling
mire	slijk
misaligned	uitgelijnd
misapprehend	misverstaan
misbecome	mispassen
misbegotten	onecht
misbehavior	wangedrag
miscalculate	misrekenen
miscalculation	misrekening
miscellaneous	Diversen
mischief	kattenkwaad
mischievous	ondeugend
mischievously	ondeugend
misconception	misvatting
misconceptions	misvattingen
miscreant	onverlaat
miscreants	onverlaten
misdirection	misleiding
miser	vrek
miserable	ellendig
miserably	jammerlijk
miseries	ellende
miserly	gierig
misery	ellende
misfit	buitenbeentje
misfortune	tegenslag
misgiving	wantrouwen
misgivings	twijfels
misguidance	misleiding
misguide	misleiden
misguided	misleid
mishap	ongeluk
misjudgment	miskenning
mislead	misleiden
misleading	misleidend
misleadingly	misleidend
miss	missen
missed	gemiste
misstatement	afwijking
mistake	vergissing
mistaken	verkeerd
mistakenly	verkeerdelijk
mistakes	fouten
mistress	minnares
mistrust	wantrouwen
mistrustful	wantrouwend
mistrustfully	wantrouwig
mists	nevels
misunderstanding	misverstand
misunderstandings	misverstanden
misuse	misbruik
moan	kreunen
mobster	gangster
mock	bespotten
mocked	bespotten
mockeries	spotternijen
mockery	spot
mocking	spotachtig
mockingly	spottend
mocks	bespot
molestation	molestering
monotonous	eentonig
monotony	eentonigheid
monstrosities	monstrositeiten
monstrosity	wangedrocht
monstrous	monsterlijk
monstrously	monsterachtig
moody	humeurig
moot	betwistbaar
mope	kniezen
morbid	morbide
morbidly	morbide
mordant	bijtmiddel
moribund	stervende
moronic	debiele
morons	idioten
mortification	versterving
mortified	gekrenkt
mortify	kastijden
mortifying	vernederend
motionless	roerloos
motley	bont
mourn	rouwen
mourner	rouwdrager
mournful	treurig
mournfully	bedroefd
muddle	warboel
muddy	modderig
mudslinging	laster
mulish	weerspannig
multi-polarization	multi-polarisatie
mundane	mondain
murder	moord
murderer	moordenaar
murderous	moorddadig
murderously	moorddadig
murky	duister
muscle-flexing	spier-buigen
mushy	papperig
musty	muf
mysterious	mysterieus
mysteriously	mysterieus
mystery	mysterie
mystify	mystificeren
myth	mythe
nag	zeuren
nagging	zeurende
naive	naief
naively	naief
narrower	smaller
nastily	onprettig
nasty	smerig
naughty	stout
nauseate	walgen
nauseating	misselijkmakende
naïve	naief
nebulous	vaag
needless	onnodig
needlessly	nodeloos
needy	behoeftig
nefarious	schandelijk
negate	ontkennen
negation	negatie
negative	negatief
negatives	negatieven
negativity	negativiteit
neglect	verwaarlozing
neglected	verwaarloosd
negligence	nalatigheid
negligent	nalatig
nemesis	Nemesis
nepotism	nepotisme
nervous	nerveus
nervously	nerveus
nervousness	nervositeit
nettle	brandnetel
neurotic	neurotisch
neurotically	neurotisch
niggle	peuteren
niggles	probleempjes
nightmare	nachtmerrie
nightmarish	nachtmerrieachtig
nitpick	muggenziften
nitpicking	muggenziften
noise	lawaai
noises	geluiden
noisier	luidruchtiger
noisy	luidruchtig
non-confidence	non-vertrouwen
nonsense	onzin
nosey	nieuwsgierig
notoriety	bekendheid
notorious	berucht
notoriously	notoir
noxious	schadelijk
nuisance	overlast
numb	verdoven
obese	zwaarlijvig
object	voorwerp
objection	bezwaar
objectionable	verwerpelijk
objections	bezwaren
oblique	schuin
obliterate	uitwissen
obliterated	uitgewist
oblivious	vergeetachtig
obnoxious	onaangenaam
obnoxiously	hinderlijk
obscene	obsceen
obscenely	obsceen
obscenity	obsceniteit
obscure	obscuur
obscured	verduisterd
obscures	verduistert
obscurity	duisternis
obsess	obsederen
obsessive	obsessieve
obsessively	obsessief
obsolete	verouderd
obstacle	hindernis
obstinate	koppig
obstinately	hardnekkig
obstruct	belemmeren
obstructed	belemmerd
obstructing	belemmerend
obstruction	obstructie
obstructs	belemmert
obtrusive	opdringerig
obtuse	stomp
occlude	insluiten
occluded	afgesloten
occludes	afsluit
occluding	afsluitende
odd	vreemd
oddest	vreemdste
oddities	eigenaardigheden
oddity	vreemdheid
oddly	vreemd
odor	geur
offence	overtreding
offend	beledigen
offender	overtreder
offending	overtredende
offenses	misdrijven
offensive	aanvallend
offensively	aanvallend
offensiveness	aanstootgevendheid
officious	officieus
ominous	onheilspellend
ominously	onheilspellend
omission	verzuim
omit	weglaten
one-sided	eenzijdig
onerous	bezwaarlijk
onerously	bezwaarlijk
opinionated	eigenzinnig
opponent	tegenstander
opportunistic	opportunistisch
opposition	oppositie
oppositions	opposities
oppress	onderdrukken
oppression	onderdrukking
oppressive	onderdrukkend
oppressiveness	verdrukheid
oppressors	onderdrukkers
ordeal	beproeving
orphan	wees-
ostracize	verbannen
outburst	uitbarsting
outbursts	uitbarstingen
outcast	verschoppeling
outcry	geschreeuw
outlaw	balling
outmoded	verouderd
outrage	verontwaardiging
outrageous	schandelijk
outrageously	schreeuwend
outrages	wandaden
outsider	buitenstaander
over-acted	over-gehandeld
over-awe	imponeren
over-balanced	over-evenwicht
over-priced	overprijsd
over-valuation	overwaardering
overact	overdrijven
overawe	imponeren
overbalance	overwicht
overbearing	aanmatigend
overblown	uitgebloeid
overdo	overdrijven
overdone	overdreven
overdue	achterstallig
overheat	oververhitten
overloaded	overladen
overlook	overzien
overpower	overweldigen
overrated	overschat
overreach	aanslaan
overrun	overspoeld
overshadow	overschaduwen
oversight	toezicht
oversights	vergissingen
oversimplification	oversimplificatie
oversimplify	simplificeren
overstate	overdrijven
overstated	overschat
overstatement	overdrijving
overstatements	overwaardering
overstates	overdrijft
overtaxed	overbelast
overthrow	omverwerping
overthrows	omverwerpingen
overturn	omvallen
overwhelm	overweldigen
overwhelmed	overweldigd
overwhelming	overweldigend
overwhelmingly	overweldigend
overwhelms	overdondert
overzealous	overijverige
pain	pijn
painful	pijnlijk
painfull	pijnlijke
painfully	pijnlijk
pains	pijnen
pale	verbleken
pales	verbleekt
paltry	armzalig
pander	handlanger
panders	Panders
panic	paniek
panicked	paniek
panicking	paniek
panicky	paniekerig
paradoxical	paradoxaal
paradoxically	paradoxaal
paralyzed	verlamd
paranoid	paranoïde
parasite	parasiet
pariah	paria
parody	parodie
partiality	voorliefde
partisan	partijdig
partisans	partizanen
passive	passief
passiveness	passiviteit
pathetic	zielig
patronize	begunstigen
paucity	gebrek
pauper	armlastige
payback	terugverdientijd
peculiar	eigenaardig
peculiarly	eigenaardig
pedantic	pedant
peeled	geschild
peeve	ergernis
peevish	kregel
peevishly	knorrig
penalize	bestraffen
penalty	boete
perfidious	verraderlijk
perfunctory	oppervlakkig
peril	gevaar
perilous	gevaarlijk
perish	vergaan
pernicious	verderfelijk
perplex	verwarren
perplexed	verward
perplexing	verwarrend
perplexity	verwarring
persecute	vervolgen
persecution	vervolging
pertinacious	vasthoudend
pertinaciously	hardnekkig
pertinacity	hardnekkigheid
perturb	verstoren
perturbed	verstoord
pervasive	doordringend
perverse	pervers
perversely	pervers
perversion	verdraaiing
perversity	perversiteit
pervert	verdraaien
perverted	pervers
perverts	perverselingen
pessimism	pessimisme
pessimistic	pessimistisch
pessimistically	pessimistisch
pest	plaag
pestilent	verderfelijk
petrified	versteend
petrify	verstenen
pettifog	muggeziften
petty	kleinzielig
phobia	fobie
phobic	fobisch
phony	onecht
picket	piket
picketing	picket
pickets	piketten
picky	kieskeurig
pig	varken
pigs	varkens
pillage	plundering
pillory	schandpaal
pimple	puistje
pinch	snuifje
pique	wrok
pitiable	beklagenswaardig
pitiful	erbarmelijk
pitifully	jammerlijk
pitiless	onbarmhartig
pitilessly	meedogenloos
pittance	schijntje
pity	jammer
plagiarize	plagiëren
plague	pest
plaything	speelbal
plea	pleiten
pleas	middelen
plebeian	plebejer
plight	toestand
plunder	plunderen
plunderer	plunderaar
pointless	stomp
pointlessly	onnodig
poison	vergiftigen
poisonous	giftig
poky	benepen
polarisation	polarisatie
pollute	verontreinigen
polluter	vervuiler
polluters	vervuilers
pompous	hoogdravend
poor	arm
poorer	armere
poorest	armste
poorly	slecht
posturing	aanstellerig
pout	steenbolk
poverty	armoede
powerless	machteloos
prate	gewauwel
prattle	babbelen
precarious	precair
precariously	precair
precipitate	neerslag
precipitous	steil
predatory	roofzuchtig
prejudice	vooroordeel
prejudices	vooroordelen
prejudicial	schadelijk
preposterous	ongerijmd
preposterously	belachelijk
presumptuous	aanmatigend
presumptuously	aanmatigend
pretence	schijn
pretense	schijn
pretentious	pretentieus
pretentiously	pretentieus
prevaricate	liegen
pricey	prijzig
pricier	duurdere
prick	prik
prickle	stekel
prickles	stekels
prideful	trots
primitive	primitief
prison	gevangenis
prisoner	gevangene
problem	probleem
problematic	problematisch
problems	problemen
procrastinate	talmen
procrastinates	treuzelt
procrastination	uitstelgedrag
profane	ontheiligen
profanity	heiligschennis
prohibit	verbieden
prohibitive	belemmerend
prohibitively	onbetaalbaar
propagandize	propageren
proprietary	gepatenteerd
prosecute	vervolgen
protested	protesteerde
protesting	protesteren
protests	protesten
protracted	langdurig
provocation	provocatie
provocative	provocerend
provoke	uitlokken
pry	wrikken
pugnacious	vechtlustig
pugnaciously	strijdlustig
pugnacity	vechtlust
punch	stempel
punish	straffen
punishable	strafbaar
punitive	straffend
punk	punk-
puny	nietig
puppet	marionet
puppets	marionetten
puzzlement	verwarring
puzzling	raadselachtig
quack	kwakzalvers-
qualm	walging
qualms	scrupules
quandary	verlegenheid
quarrel	ruzie
quarrels	ruzies
quarrelsome	twistziek
quash	vernietigen
queer	zonderling
questionable	twijfelachtig
quibble	spitsvondigheid
quibbles	haarkloverijen
quitter	lafaard
rabid	dol
racism	racisme
racists	racisten
racy	pittig
radical	radicaal
radicalization	radicalisering
radically	radicaal
radicals	radicalen
rage	woede
ragged	haveloos
raging	woedend
raked	geharkt
rampant	ongebreidelde
ramshackle	bouwvallig
rancor	wrok
randomly	willekeurig
rankle	knagen
rant	uitvaren
rape	verkrachting
raped	verkracht
raping	verkrachten
rascal	deugniet
rascals	boefjes
rash	uitslag
rattle	rammelaar
rattled	rammelde
rattles	rammelaars
ravage	teisteren
raving	ijlend
reactionary	reactionair
rebellious	opstandig
rebuff	afwijzing
rebuke	berisping
recalcitrant	weerspannige
recant	herroepen
recession	recessie
recessionary	recessie
reckless	roekeloos
recklessly	roekeloos
recklessness	roekeloosheid
recoil	terugslag
redundancy	overtolligheid
redundant	overtollig
refusal	weigering
refuse	weigeren
refused	geweigerd
refuses	weigert
refusing	weigeren
refutation	weerlegging
refute	weerleggen
refuted	weerlegd
refutes	weerlegt
refuting	weerleggen
regress	regressie
regression	regressie
regressive	regressieve
regret	betreuren
regretfully	spijtig
regrets	betreurt
regrettable	betreurenswaardig
regrettably	helaas
regretted	betreurde
reject	afwijzen
rejected	verworpen
rejection	afwijzing
rejects	verwerpt
relapse	instorting
relentless	meedogenloos
relentlessly	meedogenloos
reluctance	tegenzin
reluctant	onwillig
remorse	spijt
remorseful	berouwvol
remorsefully	berouwvol
remorseless	meedogenloos
remorselessly	meedogenloos
renunciation	verzaking
repel	afstoten
repetitive	herhalende
reprehensible	verwerpelijk
reprehensibly	laakbaar
reprehension	berisping
reprehensive	laakbaar
repress	onderdrukken
repression	repressie
repressive	onderdrukkend
reprimand	berisping
reproach	verwijt
reproachful	verwijtend
reprove	terechtwijzen
reprovingly	verwijtend
repudiate	verwerpen
repudiation	verstoting
repugnance	afkeer
repugnant	weerzinwekkend
repugnantly	weerzin
repulse	afwijzen
repulsed	afgeslagen
repulsive	weerzinwekkend
resentful	haatdragend
resentment	wrok
resignation	ontslag
resistance	weerstand
restless	rusteloos
restlessness	rusteloosheid
restrict	beperken
restricted	beperkt
restriction	beperking
restrictive	beperkend
resurgent	herlevend
retaliate	vergelden
retaliatory	vergeldings-
retard	vertragen
retarded	achterlijk
reticent	terughoudend
retract	terugtrekken
retreat	terugtrekken
retreated	teruggetrokken
revenge	wraak
revengeful	wraakzuchtig
revert	terugkeren
revile	beschimpen
reviled	verguisd
revoke	intrekken
revolt	opstand
revolting	weerzinwekkend
revoltingly	weerzinwekkend
revulsion	afkeer
revulsive	afleidend
rhetoric	retoriek
rhetorical	retorisch
ridicules	belachelijk
ridiculous	belachelijk
ridiculously	belachelijk
rift	scheur
rifts	kloven
rigid	stijf
rigidity	stijfheid
rigidness	starheid
rile	irriteren
rip-off	afzetten
ripoff	afzetten
ripped	geript
risk	risico
risks	risico's
risky	riskant
rival	concurrent
rivalry	rivaliteit
roadblocks	wegversperringen
rocky	rotsachtig
rogue	schurk
rollercoaster	achtbaan
rotten	verrot
rough	ruw
rubbish	onzin
rude	onbeleefd
ruffian	schurk
ruffle	rimpeling
ruin	ruïneren
ruined	geruïneerd
ruining	ruïneren
ruinous	verderfelijk
ruins	ruïnes
rumbling	gerommel
rumor	gerucht
rumors	geruchten
rumours	geruchten
rumple	vervrommelen
run-down	oververmoeid
runaway	Weglopen
rupture	scheuren
rust	Roest
rusts	roest
rusty	roestig
rut	sleur
ruthless	meedogenloos
ruthlessly	meedogenloos
ruthlessness	meedogenloosheid
ruts	karrensporen
sack	zak
sacrificed	opgeofferd
sad	verdrietig
sadden	bedroeven
sadly	droevig
sadness	droefheid
sag	doorzakken
sagged	doorgezakt
sagging	verzakking
saggy	uitgezakt
sags	zakkers
salacious	wulps
sanctimonious	schijnheilig
sarcasm	sarcasme
sarcastic	sarcastisch
sarcastically	sarcastisch
sardonic	sardonisch
satirical	satirisch
satirize	hekelen
savage	wilde
savagery	wreedheid
savages	wilden
scaly	geschubd
scam	oplichterij
scams	oplichting
scandal	schandaal
scandalized	aanstoot
scandalous	schandalig
scandalously	schandalig
scandals	schandalen
scant	karig
scapegoat	zondebok
scar	litteken
scarce	schaars
scarcely	nauwelijks
scarcity	schaarste
scared	bang
scarier	enger
scariest	engste
scarred	littekens
scars	littekens
scary	eng
scathing	vernietigend
scathingly	vernietigend
sceptical	sceptisch
scoff	spotten
scoffingly	spottend
scold	schelden
scolded	schold
scolding	uitbrander
scorching	gloeiend
scorn	hoon
scornful	minachtend
scornfully	verachtend
scoundrel	schurk
scourge	geselen
scramble	klauteren
scrambling	klauteren
scrap	vodje
scratch	krassen
scratched	gekrast
scratches	krassen
scratchy	krassend
scream	schreeuw
screech	krijsen
screw-up	schroef-up
screwed	geschroefd
screwed-up	verknipte
screwy	krenterig
scuff	geschuifel
scuffs	schaaft
scum	uitschot
scummy	schuimachtig
secretive	geheimzinnig
sedentary	zittend
seedy	sjofel
seethe	zieden
seething	ziedend
self-criticism	zelfkritiek
self-defeating	zelfvernietigend
self-destructive	zelfdestructieve
self-humiliation	zelfvernedering
self-interest	eigenbelang
self-serving	zelfbediening
selfish	egoïstisch
selfishly	egoïstisch
selfishness	egoïsme
senile	seniel
senseless	zinloos
senselessly	gevoelloos
seriousness	ernst
sermonize	preken
servitude	dienstbaarheid
set-up	opstelling
setback	tegenslag
setbacks	tegenslagen
sever	verbreken
severity	strengheid
shabby	haveloos
shadowy	schaduwrijk
shady	schaduwrijk
shake	schudden
shaky	wankel
shallow	Ondiep
sham	schijn
shambles	janboel
shame	schaamte
shameful	schandelijk
shamefully	schandelijk
shamefulness	schandelijkheid
shameless	schaamteloos
shamelessly	schaamteloos
shamelessness	schaamteloosheid
shark	haai
sharply	scherp
shatter	breken
shimmer	flikkering
shimmy	hemdje
shipwreck	schipbreuk
shirker	lijntrekker
shit	stront
shiver	rilling
shock	schok
shocked	geschokt
shocking	schokkend
shockingly	schokkend
shoddy	kitsch
shortage	tekort
shortchange	bedriegen
shortcoming	Tekortkoming
shortcomings	tekortkomingen
shortness	kortheid
shortsighted	kortzichtig
shortsightedness	kortzichtigheid
showdown	confrontatie
shrew	spitsmuis
shriek	schreeuw
shrill	schel
shrilly	schril
shrivel	verschrompelen
shroud	sluier
shrouded	gehuld
shun	vlieden
shunned	gemeden
sick	ziek
sickening	misselijk
sickeningly	ziekmakend
sickly	ziekelijk
sickness	ziekte
sidetrack	zijspoor
sidetracked	zijspoor
siege	belegering
silly	dwaas
simplistic	simplistisch
simplistically	simplistisch
sin	zonde
sinful	zondig
sinfully	zondig
sink	wastafel
sinking	zinkend
skeletons	skeletten
skeptic	scepticus
skeptical	sceptisch
skeptically	sceptisch
skepticism	scepticisme
sketchy	oppervlakkig
skimpy	mager
skinny	broodmager
skittish	schichtig
skulk	sluipen
slack	speling
slander	laster
slanderer	lasteraar
slanderous	lasterlijk
slanderously	gelasterd
slanders	laster
slap	klap
slashing	hakken
slaughter	slachten
slaughtered	geslacht
slave	slaaf
slaves	slaven
sleazy	dun
slime	slijm
slog	ploeteren
slogging	ploeteren
slooow	traaag
sloppily	slonzig
sloppy	slordig
sloth	luiaard
slothful	traag
slow	langzaam
slowed	vertraagd
slower	tragere
slowest	langzaamste
slowly	langzaam
slug	naaktslak
sluggish	traag
slump	malaise
slur	smet
slut	slet
sluts	sletten
sly	sluw
smack	slaan
smash	intrappen
smear	smeren
smell	geur
smelled	rook
smelling	ruikend
smells	geuren
smelly	stinkend
smelt	spiering
smoke	rook
smokescreen	rookgordijn
smolder	smeulen
smoldering	smeulende
smother	smoren
smoulder	smeulen
smouldering	smeulende
smudge	vlekken
smudged	vlekken
smudges	vlekken
smudging	vlekken
smug	zelfgenoegzaam
smugly	zelfvoldaan
smut	roetvlek
smutty	smerig
snag	moeilijkheid
snagging	vastlopen
snappish	prikkelbaar
snappishly	snibbig
snare	strik
snarl	grauwen
sneak	sluipen
sneaky	stiekem
sneer	grijns
sneering	spottend
sneeringly	Honend
snobbish	snobistisch
snub	afsnauwen
so-cal	zo-cal
soapy	zeepachtig
sob	snik
sober	nuchter
sobering	ontnuchterende
solemn	plechtig
solicitude	bekommernis
sore	zeer
soreness	pijnlijkheid
sorrow	leed
sorrowful	treurig
sorrowfully	jammerlijk
sorry	Sorry
sour	zuur
sourly	zuur
spank	afranselen
spew	spuwen
spewed	uitgespuwd
spewing	spuwen
spews	spuwt
spilling	morsen
spiritless	terneergeslagen
spite	wrok
spiteful	hatelijk
spitefulness	hatelijkheid
splatter	geklater
split	spleet
splitting	splitsing
spoil	Bederven
spoilage	bederf
spoiled	verwend
spoils	buit
spooky	spookachtig
sporadic	sporadisch
spotty	gevlekt
spurious	onecht
spurn	versmaden
sputter	sputteren
squabble	kibbelen
squabbling	gekibbel
squander	verkwisten
squeak	piepen
squeaks	piept
squeaky	pieperig
squeal	piepen
squealing	gejank
squirm	kronkelen
stab	steken
stagnant	stilstaand
stagnate	stagneren
stagnation	stagnatie
staid	sober
stain	vlek
stains	vlekken
stale	muf
stalemate	patstelling
stall	kraam
stalls	stallen
stammer	stamelen
stark	strak
starkly	schril
startling	ontstellend
starvation	uithongering
starve	verhongeren
static	statisch
steal	stelen
stealing	diefstal
steep	steil
steeply	steil
stench	stank
stereotype	stereotiep
stereotypical	stereotiep
stern	achtersteven
stew	stoven
sticky	kleverig
stiff	stijf
stiffness	stijfheid
stifle	verstikken
stifling	verstikkend
stigmatize	stigmatiseren
sting	steek
stinging	prikkelend
stingy	gierig
stink	stinken
stinks	stinkt
stole	stal
stolen	gestolen
stooge	assistent
stormy	stormachtig
straggler	achterblijver
strain	spanning
strained	gespannen
straining	inspanning
strange	vreemd
strangely	vreemd
stranger	vreemdeling
strangest	vreemdste
strangle	wurgen
streaky	doorregen
strenuous	inspannend
stress	spanning
stresses	spanningen
stressful	stressvolle
stressfully	stressvol
stricken	getroffen
strict	streng
strictly	strikt
strident	schel
stridently	schel
strife	strijd
strike	staking
stringent	streng
stringently	streng
struck	geslagen
struggle	worstelen
struggled	worstelde
struggles	strijd
struggling	worstelen
strut	stut
stubborn	eigenwijs
stubbornly	koppig
stubbornness	koppigheid
stuffy	benauwd
stumble	struikelen
stumbled	struikelde
stumbles	struikelt
stump	stomp
stumps	stompen
stun	verdoven
stunted	onvolgroeide
stupid	dom
stupidest	domste
stupidity	domheid
stupidly	dom
stupify	Stupify
stupor	verdoving
stutter	stotteren
stuttered	stotterde
stuttering	stotteren
stutters	stottert
sty	strontje
stymied	gedwarsboomd
sub-par	super
subdued	ingetogen
subjected	onderworpen
subjection	onderwerping
subjugate	onderwerpen
subjugation	onderwerping
submissive	onderdanig
subordinate	ondergeschikt
subpoena	dagvaarden
subpoenas	dagvaardingen
subservience	onderdanigheid
subservient	ondergeschikt
subtract	aftrekken
subversion	omverwerping
subversive	subversief
subversively	subversief
subvert	ondermijnen
succumb	bezwijken
suck	zuigen
sucked	zoog
sucker	zuignap
sucks	zuigt
sue	vervolgen
sued	aangeklaagd
sues	Sues
suffer	lijden
suffered	leed
sufferer	lijder
sufferers	lijders
suffering	lijden
suffers	lijdt
suffocate	stik
sugar-coat	suikeren
suicidal	suïcidaal
suicide	zelfmoord
sulk	pruilen
sullen	nors
sully	bezoedelen
sunder	splijten
sunk	gezonken
sunken	gezonken
superficial	oppervlakkig
superficiality	oppervlakkigheid
superficially	oppervlakkig
superfluous	overbodig
superstition	bijgeloof
superstitious	bijgelovig
suppress	onderdrukken
suppression	onderdrukking
surrender	overgave
susceptible	vatbaar
suspect	verdachte
suspicion	achterdocht
suspicions	verdenkingen
suspicious	verdacht
suspiciously	verdacht
swagger	branie
swamped	overspoeld
sweaty	zweterig
swelled	zwol
swelling	zwelling
swindle	oplichterij
swipe	wip
swollen	gezwollen
symptom	symptoom
symptoms	symptomen
syndrome	syndroom
taboo	taboe
tacky	smakeloos
taint	smet
tainted	bedorven
tamper	knoeien
tangle	wirwar
tangled	verwarde
tangles	klitten
tanked	dronken
tantrum	woedeaanval
tardy	traag
tarnish	aanslag
tarnished	aangetast
tarnishes	dof
tarnishing	aanslag
tattered	gehavend
taunt	beschimpen
taunting	treiteren
tauntingly	honend
taut	strak
tawdry	opzichtig
tease	plagen
teasingly	plagend
tedious	vervelend
temerity	vermetelheid
temper	temperen
tempest	storm
temptation	verleiding
tenderness	tederheid
tense	gespannen
tension	spanning
tentative	voorlopig
tentatively	voorlopig
tenuous	vaag
tenuously	onbeduidend
tepid	lauw
terrible	verschrikkelijk
terribleness	verschrikking
terribly	vreselijk
terror	terreur
terrorism	terrorisme
terrorize	terroriseren
testily	driftig
testy	prikkelbaar
tetchy	prikkelbaar
thankless	ondankbaar
thicker	dikker
thirst	dorst
thorny	netelig
thoughtless	gedachteloos
thoughtlessly	gedachteloos
thoughtlessness	onnadenkendheid
thrash	slaan
threat	bedreiging
threaten	dreigen
threatening	dreigend
threats	gevaren
threesome	drietal
throb	kloppen
throbbing	kloppende
throbs	bonst
throttle	smoorklep
thug	gangster
thwart	dwarsbomen
time-consuming	tijdrovend
timid	timide
timidity	schroom
timidly	verlegen
tingled	tintelde
tingling	tintelingen
tired	moe
tiresome	vermoeiend
tiring	vermoeid
toil	zwoegen
toll	tol
top-heavy	topzwaar
topple	omvallen
torment	kwelling
tormented	gekweld
torrent	stortvloed
tortuous	bochtig
torture	martelen
tortured	gemarteld
tortures	martelingen
torturing	martelen
torturous	martelende
totalitarian	totalitair
touchy	gevoelig
toughness	taaiheid
touted	aangeprezen
touts	sjacheraars
toxic	giftig
traduce	belasteren
tragedy	tragedie
tragic	tragisch
tragically	tragisch
traitor	verrader
traitorous	verraderlijk
traitorously	verraderlijk
tramp	landloper
trample	vertrappen
transgress	overtreden
transgression	overtreding
trap	val
traped	Traped
trapped	gevangen
trash	uitschot
trashed	vernield
trashy	prullerig
traumatic	traumatisch
traumatically	traumatisch
traumatized	getraumatiseerd
travesty	travestie
treacherous	verraderlijk
treacherously	verraderlijk
treachery	verraad
treason	verraad
treasonous	verraderlijk
trick	truc
tricked	bedrogen
trickery	bedriegerij
trivial	triviaal
trivialize	bagatelliseren
trouble	moeite
troubled	verontrust
troublemaker	lastpost
troubles	problemen
troublesome	lastig
troubling	verontrustend
truant	spijbelaar
tumble	tuimelen
tumbled	tuimelde
tumbles	Tumbles
tumultuous	onstuimig
turbulent	wild
turmoil	beroering
twisted	gedraaid
twists	wendingen
two-faced	dubbelhartig
tyrannical	tiranniek
tyrannically	tiranniek
tyranny	tirannie
tyrant	tiran
uglier	lelijker
ugliest	lelijkste
ugliness	lelijkheid
ugly	lelijk
ulterior	verborgen
ultra-hardline	ultra-hardliners
un-viewable	un-zichtbare
unacceptably	onaanvaardbaar
unaccessible	ontoegankelijk
unaccustomed	ongewoon
unachievable	onuitvoerbaar
unaffordable	onbetaalbaar
unappealing	onaantrekkelijk
unattractive	onaantrekkelijk
unavoidably	onvermijdelijk
unbearable	ondraaglijk
unbelievable	ongelooflijk
unbelievably	ongelooflijk
uncaring	onverschillig
uncertain	onzeker
uncivil	onbeleefd
uncivilized	onbeschaafd
unclean	onrein
uncollectible	oninbare
uncomfortable	ongemakkelijk
uncomfortably	ongemakkelijk
uncompetitive	niet-concurrerende
uncompromising	onbuigzaam
uncompromisingly	compromisloos
unconstitutional	ongrondwettig
uncontrolled	ongecontroleerde
unconvincingly	overtuigend
uncooperative	weigerachtig
uncouth	lomp
uncreative	oncreatieve
undecided	onbeslist
undefined	onbepaald
undercut	onderkruipen
undercuts	ondersnijdingen
undercutting	prijsonderbieding
underestimate	onderschatten
underlings	ondergeschikten
undermine	ondermijnen
undermined	ondermijnd
undermines	ondermijnt
undermining	ondermijnen
undersized	ondermaatse
undesirable	ongewenst
undetermined	onbepaald
undocumented	ongedocumenteerde
undue	overdreven
unease	onbehagen
uneasily	onbehaaglijk
uneasiness	onbehaaglijkheid
uneasy	ongemakkelijk
uneconomical	oneconomisch
unemployed	werkloos
unequal	ongelijk
unethical	onethisch
uneven	ongelijk
uneventful	rustig
unexpectedly	onverwacht
unexplained	onverklaard
unfairly	oneerlijk
unfaithful	ontrouw
unfaithfully	ontrouw
unfamiliar	onbekend
unfavorable	ongunstig
unfeeling	gevoelloos
unfinished	onafgewerkt
unfit	ongeschikt
unforeseen	onvoorzien
unforgiving	onverzoenlijk
unfortunate	ongelukkige
unfortunately	helaas
unfounded	ongegrond
unfriendly	onvriendelijk
unfunded	ongedekte
ungovernable	onhandelbaar
ungrateful	ondankbaar
unhappily	ongelukkig
unhappiness	ongelukkigheid
unhappy	ongelukkig
unhealthy	ongezond
unhelpful	onbehulpzaam
unilateralism	unilateralisme
unimaginable	ondenkbaar
unimaginably	onvoorstelbaar
unimportant	onbelangrijk
uninformed	onwetend
uninsured	onverzekerd
unintelligible	onbegrijpelijk
unipolar	unipolaire
unjust	onrechtvaardig
unjustifiably	ongerechtvaardigd
unjustified	ongerechtvaardigd
unjustly	onrechtvaardig
unkind	onaardig
unkindly	onvriendelijk
unknown	onbekend
unlawful	onwettig
unlawfully	onrechtmatig
unlawfulness	onrechtmatigheid
unleash	ontketenen
unlikely	onwaarschijnlijk
unlucky	ongelukkig
unmoved	onbewogen
unnatural	onnatuurlijk
unnaturally	onnatuurlijk
unnecessary	onnodig
unneeded	onnodige
unnerve	ontzenuwen
unnerved	zenuwachtig
unnerving	zenuwslopend
unnoticed	onopgemerkt
unobserved	onopgemerkt
unorthodox	onorthodoxe
unpleasant	onplezierig
unpopular	onpopulair
unpredictable	onvoorspelbaar
unprepared	onvoorbereid
unproductive	onproductieve
unprofitable	onvoordelig
unproved	onbewezen
unproven	onbewezen
unqualified	onvoorwaardelijk
unravel	ontwarren
unraveled	ontrafeld
unreachable	onbereikbaar
unreadable	onleesbaar
unrealistic	onrealistische
unreasonable	onredelijk
unreasonably	onredelijk
unrelenting	onverbiddelijk
unrelentingly	onverbiddelijk
unreliability	onbetrouwbaarheid
unreliable	onbetrouwbaar
unresolved	onopgelost
unresponsive	onverschillig
unrest	onrust
unruly	onhandelbaar
unsafe	onveilig
unsatisfactory	onbevredigend
unsavory	onverkwikkelijk
unscrupulous	gewetenloos
unscrupulously	gewetenloos
unsecure	onveilige
unseemly	onbetamelijk
unsettled	onbestendig
unsettling	verontrustende
unskilled	ongeschoold
unsophisticated	onbedorven
unsound	ondeugdelijk
unspeakable	onuitsprekelijk
unstable	wankel
unsteadily	onvast
unsteadiness	wankel
unsteady	onvast
unsuccessful	mislukt
unsuccessfully	tevergeefs
unsure	onzeker
unsuspecting	argeloos
unsustainable	onhoudbaar
untenable	onhoudbaar
untested	ongeteste
unthinkable	ondenkbaar
unthinkably	ondenkbaar
untimely	ontijdig
untouched	onaangeroerd
untrue	onwaar
untrustworthy	onbetrouwbaar
untruthful	onjuist
unusable	onbruikbaar
unusably	onbruikbaar
unusual	ongebruikelijk
unusually	ongewoon
unwanted	ongewenste
unwarranted	ongerechtvaardigd
unwelcome	onwelkom
unwell	onwel
unwieldy	onhandelbaar
unwilling	onwillig
unwillingly	onwillig
unwillingness	onwil
unwise	onverstandig
unwisely	onverstandig
unworkable	onwerkbare
unworthy	onwaardig
unyielding	onverzettelijk
upbraid	verwijten
upheaval	omwenteling
uprising	opstand
uproar	lawaai
uproarious	stormachtig
uproariously	uitbundig
uproot	ontwortelen
upset	boos
upsets	verstoort
upsetting	bedroevend
urgent	dringend
useless	nutteloos
usurp	usurperen
usurper	usurpator
utterly	volkomen
vagrant	zwerver
vague	vaag
vagueness	vaagheid
vain	ijdel
vainly	vergeefs
vanity	ijdelheid
vehement	heftig
vehemently	hartstochtelijk
vengeance	wraak
vengeful	wraakgierig
vengefully	wraakzuchtig
vengefulness	wraakzucht
venom	venijn
venomous	giftig
venomously	giftig
vent	luchten
vestiges	overblijfselen
vex	ergeren
vexation	ergernis
vexing	vervelend
vexingly	ergerlijk
vibrate	trillen
vibrated	getrild
vibrates	trilt
vibrating	trillende
vibration	vibratie
vice	ondeugd
vicious	verdorven
viciously	kwaadaardig
viciousness	zondigheid
victimize	duperen
vile	verachtelijk
vileness	slechtheid
vilify	belasteren
villainous	schurkachtig
villainously	schurkachtig
villains	schurken
villian	schurk
vindictive	wraakzuchtig
vindictively	wraakzuchtig
vindictiveness	wraakzucht
violate	schenden
violation	schending
violator	schender
violators	overtreders
violent	gewelddadig
viper	adder
virulence	kwaadaardigheid
virulent	kwaadaardig
virulently	kwaadaardig
vociferous	luidruchtig
volatile	vluchtig
volatility	volatiliteit
vomit	braken
vomited	braakte
vomiting	braken
vomits	braakt
vulgar	grof
vulnerable	kwetsbaar
wail	weeklacht
wallow	wentelen
wane	afnemen
waning	tanende
wanton	baldadig
warily	behoedzaam
wariness	behoedzaamheid
warlike	oorlogszuchtig
warned	gewaarschuwd
warning	waarschuwing
warp	schering
warped	scheefgetrokken
wary	omzichtig
washed-out	uitgewassen
waste	verspilling
wasted	verspild
wasteful	verkwistend
wastefulness	verkwisting
wasting	verspilling
water-down	verdunnen
watered-down	afgezwakte
wayward	eigenzinnig
weak	zwak
weaken	verzwakken
weakening	verzwakking
weaker	zwakkere
weakness	zwakheid
weaknesses	zwakheden
weariness	vermoeidheid
wearisome	vermoeiend
weary	vermoeid
wedge	wig
weed	onkruid
weep	huilen
weird	vreemd
weirdly	raar
wheedle	flikflooien
whimper	janken
whine	zeuren
whiny	zeurderige
whips	zwepen
whore	hoer
whores	hoeren
wicked	slecht
wickedly	goddeloos
wickedness	slechtheid
wildly	wild
wiles	listen
wilt	verwelken
wily	sluw
wince	huiveren
wobble	wiebelen
wobbled	wankelde
wobbles	wiebelt
woe	wee
woebegone	smartelijk
woeful	jammerlijk
woefully	jammerlijk
womanizer	rokkenjager
womanizing	rokkenjager
worn	versleten
worried	bezorgd
worriedly	zorgelijk
worries	zorgen
worrisome	zorgelijk
worrying	zorgwekkend
worryingly	zorgwekkend
worse	erger
worsen	verergeren
worsening	verergering
worst	slechtst
worthless	waardeloos
worthlessness	waardeloosheid
wound	wond
wounds	wonden
wrangle	ruzie
wrath	toorn
wreak	aanrichten
wreaked	aangericht
wreck	wrak
wrest	verdraaien
wrestle	worstelen
wretch	ellendeling
wretched	ellendig
wretchedly	ellendig
wretchedness	ellende
wrinkle	rimpel
wrinkled	gerimpeld
wrinkles	rimpels
writhe	spartelen
wrong	fout
wrongful	onrechtmatig
wrought	gesmeed
yawn	geeuw
zapped	gezapt
zealot	ijveraar
zealous	ijverig
zealously	ijverig
