abound	florerer
abounds	overflod
abundance	overflod
abundant	rikelig
accessable	tilgjengeleg
accessible	tilgjengelig
acclaim	anerkjennelse
acclaimed	roste
acclamation	akklamasjon
accolade	utmerkelse
accolades	utmerkelser
accomplish	utrette
accomplished	oppnås
accomplishment	gjennomføring
accomplishments	prestasjoner
accurate	korrekt
accurately	nøyaktig
achievable	oppnåelig
achievement	oppnåelse
achievements	prestasjoner
acumen	sans
adaptable	tilpasningsdyktig
adequate	tilstrekkelig
adjustable	regulerbar
admirable	beundringsverdig
admirably	beundringsverdig
admiration	beundring
admire	beundre
admirer	beundrer
admiring	beundrer
admiringly	beundrende
adorable	bedårende
adore	elsker
adored	beundret
adroit	behendig
adulation	smiger
advanced	avansert
advantage	fordel
advantageous	fordelaktige
advantages	fordeler
adventuresome	adventure
adventurous	eventyrlig
advocate	advokat
advocates	talsmenn
affable	omgjengelige
affectation	jåleri
affection	kjærlighet
affectionate	kjærlig
affinity	affinitet
affirm	bekrefte
affirmation	bekreftelse
affirmative	bekreftende
affluence	velstand
affluent	velstående
affordable	rimelig
affordably	rimelig
agile	smidig
agility	smidighet
agreeable	behagelig
alluring	forlokkende
altruistic	altruistiske
altruistically	altruistisk
amaze	forbause
amazed	overrasket
amazement	undring
amazes	forundrer
amazing	fantastisk
amazingly	utrolig
ambitious	ambisiøs
ambitiously	ambisiøst
ameliorate	bøte
amenable	mottagelig
amiability	elskverdighet
amiable	elskverdig
amicable	minnelig
amicably	minnelighet
ample	rikelig
amply	rikelig
amuse	underholde
amusing	morsomt
angel	engel
angelic	engleaktig
apotheosis	apoteose
appeal	anke
appealing	tiltrekkende
applaud	klappe
appreciable	nevne
appreciated	verdsatt
appreciates	verds
appreciative	takknemlig
appreciatively	anerkjenn
appropriate	passende
approval	godkjenning
approve	vedta
ardent	ildfull
ardently	inderlig
ardor	iver
articulate	artikulere
aspiration	aspirasjon
aspirations	ambisjoner
aspire	strebe
assurance	forsikring
assurances	forsikringer
assure	forsikrer
assuredly	Sannelig
assuring	sikre
astonish	forbause
astonished	forbauset
astonishing	forbausende
astonishingly	forbausende
astonishment	forbauselse
astound	forbløffe
astounded	forbløffet
astounding	forbløffende
astoundingly	forbløffende
attentive	oppmerksomme
attraction	tiltrekning
attractive	attraktiv
attractively	attraktivt
audible	hørbar
audibly	hørbart
authentic	autentisk
authoritative	autoritær
autonomous	autonom
available	tilgjengelig
avidly	ivrig
award	tildele
awarded	tildelt
awards	utmerkelser
awe	ærefrykt
awesome	Rått
backbone	ryggrad
balanced	balanserte
bargain	handel
beauteous	skjønne
beautiful	vakker
beautifully	vakkert
beautify	forskjønne
beauty	skjønnhet
beckon	lokker
beckoned	vinket
beckoning	vinket
beckons	lokker
believable	troverdig
beloved	elskede
benefactor	velgjører
beneficent	velgjørende
beneficial	gunstig
beneficially	rettmessig
beneficiary	mottaker
benefit	fordel
benefits	fordeler
benevolence	velvilje
benevolent	velvillig
benifits	Fordeler
best	beste
best-selling	bestselger
better	bedre
blameless	ulastelige
bless	velsigne
blessing	velsignelse
bliss	lykksalighet
blissful	lykkelig
blissfully	salig
bloom	blomst
blossom	blomstre
bolster	styrke
bonuses	bonuser
boost	øke
boundless	grenseløs
brainiest	smarteste
brave	modig
bravery	tapperhet
breakthrough	gjennombrudd
breakthroughs	gjennombrudd
breathlessness	tungpustethet
breathtaking	fantastisk
breathtakingly	forbløffende
breeze	bris
bright	lys
brighten	lysne
brighter	lysere
brightest	este
brilliance	glans
brilliant	strålende
brilliantly	briljant
brisk	rask
brotherly	broderlig
buoyant	oppdrifts
cajole	tale
calm	rolig
calming	beroligende
calmness	ro
capability	evne
captivate	fange
captivating	fengslende
carefree	bekymringsløs
catchy	fengende
celebrate	feire
celebrated	feiret
celebration	feiring
celebratory	feirende
charisma	karisma
charismatic	karismatisk
charitable	veldedig
charm	sjarm
charming	sjarmerende
charmingly	sjarmerende
chaste	kyske
cheaper	billigere
cheapest	billigste
cheer	oppmuntre
cheerful	munter
cheery	muntre
cherish	verne
cherished	elsket
cherub	kjerub
chivalrous	ridderlig
chivalry	ridderlighet
civility	høflighet
civilize	sivilisere
clarity	klarhet
classic	klassiker
classy	stilig
clean	ren
cleaner	renere
cleanest	reneste
cleanliness	renslighet
cleanly	renslig
clear	klar
clear-cut	entydig
cleared	ryddet
clearer	klarere
clears	lakker
clever	flink
cleverly	smart
cohere	Cohere
coherence	sammenheng
coherent	sammenhengende
cohesive	sammenhengende
colorful	fargerik
comfort	komfort
comfortable	komfortabel
comfortably	komfortabelt
comforting	trøst
commend	anbefale
commendable	verdig
commitment	forpliktelse
commodious	romme
compact	kompakt
compactly	kompakt
compassion	medfølelse
compassionate	medfølende
compatible	kompatibel
competitive	konkurranse
complement	komplement
complementary	utfyllende
complemented	supplert
complements	utfyller
compliant	kompatibel
compliment	kompliment
complimentary	gratis
comprehensive	omfattende
conciliate	forsone
conciliatory	forsonlig
concise	konsis
confidence	selvtillit
confident	Selvsikker
congratulate	gratulere
congratulation	Gratulerer
congratulations	Gratulerer
congratulatory	gratulasjons
conscientious	pliktoppfyllende
considerate	hensyns
consistent	konsistent
consistently	konsekvent
constructive	konstruktiv
contentment	tilfredshet
continuity	kontinuitet
contribution	bidrag
convenience	bekvemmelighet
convenient	beleilig
conveniently	beleilig
convienient	excellent
convincing	overbevisende
convincingly	overbevisende
cool	kul
coolest	kuleste
cooperative	kooperativ
cooperatively	samvirkende
cornerstone	hjørnestein
correct	riktig
correctly	riktig
cost-effective	kostnadseffektiv
cost-saving	kostnadsbesparende
counter-attack	motangrep
counter-attacks	motangrep
courage	mot
courageous	modig
courageously	modig
courteous	høflig
covenant	pakt
cozy	koselig
creative	kreativ
credence	troverdighet
credible	troverdig
crisp	sprø
crisper	skarpere
cure	kurere
cure-all	kur-alle
cute	søt
daring	dristig
darling	elskling
dawn	soloppgang
dazzled	blendet
dazzling	blendende
dead-cheap	dead-billig
decency	anstendighet
decent	skikkelig
decisive	avgjørende
decisiveness	besluttsomhet
dedicated	dedikerte
defeat	nederlag
defeated	nedkjempet
defeating	ødeleggende
defeats	nederlag
defender	forsvarer
deference	aktelse
deft	behendig
delicacy	delikatesse
delicate	delikat
delicious	nydelig
delight	glede
delighted	glad
delightful	herlig
delightfully	herlig
dependable	pålitelig
dependably	installasjonene
deservedly	fortjent
deserving	fortjenstfull
desirable	ønskelig
desiring	ønsker
desirous	begjærlig
destiny	skjebne
detachable	avtagbar
devout	troende
dexterous	fingernem
dignified	ærverdig
dignify	verdighet
dignity	verdighet
diligence	aktsomhet
diligent	flittig
diligently	flittig
diplomatic	diplomatisk
dirt-cheap	skitt-billig
distinction	forskjell
distinctive	karakteristiske
distinguished	fornem
diversified	diversifisert
divine	guddommelig
divinely	guddommelig
dominate	dominere
dominated	dominert
dominates	dominerer
doubtless	utvilsomt
dreamland	drømmeland
dumbfounded	målløs
dumbfounding	hoderystende
durable	varig
dynamic	dynamisk
eager	ivrig
eagerly	ivrig
eagerness	iver
earnest	alvor
earnestly	alvorlig
earnestness	alvor
ease	letthet
eased	lettet
eases	letter
easier	lettere
easiest	enkleste
easing	lettelser
easy	lett
easygoing	omgjengelig
economical	økonomisk
ecstasies	ekstaser
ecstatic	ekstatisk
edify	oppbygge
educated	utdannet
effective	effektiv
effectively	effektivt
effectiveness	effektivitet
effectual	effektive
efficacious	effektive
efficient	effektiv
efficiently	effektivt
effortless	uanstrengt
effortlessly	uanstrengt
effusion	effusjon
effusive	strømmende
elated	opprømt
elatedly	opprømt
elation	spenstighet
electrify	elektrifisere
elegance	eleganse
elegantly	elegant
elevate	heve
eloquence	veltalenhet
eloquent	veltalende
eloquently	velformulert
eminence	eminense
empathize	innlevelse
empathy	empati
empower	myndiggjøre
empowerment	myndiggjøring
enchant	fortrylle
enchanted	fortryllet
enchanting	fortryllende
encourage	oppmuntre
encouragement	oppmuntring
encouraging	oppmuntrende
endearing	inntagende
endorse	påtegne
endorsed	godkjent
endorsement	påtegning
endorsing	godkjenne
energetic	energisk
energize	energi
energy-efficient	energieffektiv
energy-saving	energisparing
engaging	engasjerende
engrossing	fengslende
enhance	forbedre
enhanced	forbedret
enhancement	Forbedring
enhances	Forbedrer
enjoy	Nyt
enjoyable	hyggelig
enjoyably	morsommere
enjoyed	nøt
enjoying	Nyter
enjoyment	fornøyelse
enjoys	nyter
enlighten	opplyse
enlightenment	opplysning
ennoble	foredle
enough	nok
enrapture	henrykke
enraptured	henrykt
enrich	berike
enrichment	berikelse
enterprising	driftige
entertain	underholde
entertaining	underhold
enthral	enthrall
enthralled	fengslet
enthuse	begeistre
enthusiasm	entusiasme
enthusiast	entusiast
enthusiastic	entusiastisk
enthusiastically	entusiastisk
entice	lokke
enticed	forledet
enticing	fristende
entranced	betatt
entrancing	fengende
entrust	betro
enviable	misunnelsesverdig
enviably	misunnelsesverdig
envious	misunnelig
enviously	misunnelig
envy	misunne
equitable	rettferdig
ergonomical	ergonomisk
err-free	feile-fri
erudite	lærd
ethical	etisk
euphoria	eufori
euphoric	euforisk
evaluative	evaluerende
evenly	jevnt
eventful	begivenhetsrik
everlasting	evig
evocative	stemningsfull
exalt	opphøye
exaltation	opphøyelse
exalted	opphøyet
exalting	opphøye
examplary	eksempel
exceed	overskride
exceeded	skredet
exceeding	stiger
exceedingly	umåtelig
exceeds	stiger
excel	utmerke
excellant	fortreffelig
excellence	fortreffelighet
excellency	eksellense
excellent	utmerket
excellently	utmerket
excels	utmerker
exceptional	eksepsjonell
exceptionally	eksepsjonelt
excite	opphisse
excited	spent
excitedly	spent
excitement	begeistring
excites	begeistrer
exciting	spennende
excitingly	betrakte
exemplar	eksemplar
exemplary	eksemplarisk
exhilarate	forfriske
exhilarating	spennende
expansive	ekspansiv
expeditiously	massedrap
expertly	fagmessig
exquisite	utsøkt
exquisitely	utsøkt
extol	Extol
extraordinarily	used
extraordinary	ekstraordinær
exuberance	begeistring
exuberant	strømmende
exult	juble
exultant	jublende
exultation	jubel
exultingly	jublende
eye-catch	eye-fangst
eye-catching	iøynefallende
fabulous	fabelaktig
fair	rettferdig
fairly	ganske
fairness	rettferdighet
faith	tro
faithful	trofast
faithfully	trofast
faithfulness	trofasthet
fame	berømmelse
famed	berømt
famous	berømt
fancier	avansert
fantastic	Fantastisk
fantastically	fantastisk
fascinate	fasinere
fascinating	fascinerende
fascination	fascinasjon
fashionable	fasjonable
fast	fort
fast-paced	Fartsfylt
faster	raskere
fastest	raskeste
faultless	feilfri
favor	favorisere
favorable	gunstige
favored	favoriserte
favorite	favoritt
favorited	SykoticWolf
favour	favorisere
fearless	fryktløs
fearlessly	frykt
feasible	gjennomførbart
feat	bragd
feature-rich	funksjonsrik
feisty	sprelsk
felicitate	lykkønske
felicity	lykke
fertile	fruktbar
fervent	glødende
fervently	inderlig
fervor	inderlighet
festive	festlig
fidelity	gjengivelse
fiery	flammende
fine	fint
finely	fint
finer	finere
finest	fineste
firmer	fastere
first-class	førsteklasses
first-rate	førsteklasses
flashy	prangende
flatter	smigre
flattering	flatte
flatteringly	smigrende
flawless	feilfri
flawlessly	prikkfritt
flexibility	fleksibilitet
flexible	fleksibel
flourish	blomstre
flourishing	blomstrende
fluent	flytende
flutter	flagre
fondness	forkjærlighet
foolproof	Idiot-sikker
foremost	fremst
foresight	framsyn
fortitude	heltemot
fortuitous	tilfeldig
fortunate	heldig
fortunately	heldigvis
fortune	formue
fragrant	duftende
free	gratis
freed	frigjort
freedom	frihet
freedoms	friheter
fresh	fersk
fresher	friskere
freshest	ferskeste
friendliness	vennlighet
friendly	vennlig
frolic	munterhet
frugal	nøysom
fruitful	fruktbar
fulfillment	oppfyllelse
fun	moro
futuristic	futuristiske
gaiety	lystighet
gain	gevinst
gained	fikk
gainful	lønnet
gainfully	inntektsgivende
gaining	få
gains	gevinster
gallant	galant
gallantly	galant
galore	fleng
geeky	nerdete
gem	perle
gems	edelstener
generosity	gavmildhet
generous	sjenerøs
generously	sjenerøst
genius	geni
gentle	skånsom
gentlest	mild
genuine	ekte
gifted	begavet
gladden	Gladden
gladly	gjerne
gladness	glede
glamorous	glamorøs
glee	glede
gleefully	frydefullt
glimmering	glitrende
glisten	glinse
glistening	glinsende
glitz	glitter
glorify	lovprise
glorious	strålende
gloriously	herlig
glory	herlighet
glow	gløde
glowing	glødende
god-given	gudegitt
god-send	Gud-sender
godlike	guddommelig
godsend	gudegave
gold	gull
golden	gylden
good	flink
goodly	frukt
goodness	godhet
goodwill	velvilje
gorgeous	nydelig
grace	nåde
graceful	grasiøs
gracefully	grasiøst
gracious	nådig
graciously	nådigst
grandeur	storhet
grateful	takknemlig
gratefully	takknemlig
gratification	tilfredstillelse
gratified	gleder
gratify	glede
gratifying	gledelig
gratitude	takknemlighet
great	flott
greatest	størst
greatness	storhet
grin	glise
groundbreaking	banebrytende
guarantee	garanti
guidance	veiledning
guiltless	uskyldig
gush	utbrudd
gusto	velbehag
hail	hagl
halcyon	Halcyon
hallmark	kjennetegn
hallmarks	kjennetegnene
hallowed	helliget
handier	smidigere
handsome	kjekk
handsomely	vakkert
handy	praktisk
happier	lykkeligere
happily	gjerne
happiness	lykke
happy	lykkelig
hard-working	hardtarbeidende
hardier	hardføre
hardy	hardfør
harmless	harmløs
harmonious	harmonisk
harmoniously	harmonisk
harmonize	harmon
harmony	harmoni
headway	framskritt
heal	helbrede
healthful	sunn
healthy	sunn
hearten	oppmuntre
heartening	oppmuntrende
heartfelt	hjertefølt
heartily	hjertelig
heartwarming	hjertevarmende
heaven	himmel
heavenly	himmelsk
helped	hjulpet
helpful	hjelpsom
helping	hjelpe
hero	helt
heroic	heroisk
heroically	heroisk
heroine	heltinne
high-spirited	høy-energisk
hilarious	morsom
holy	hellig
homage	hyllest
honest	ærlig
honesty	ærlighet
honor	ære
honorable	hederlig
honored	hedret
honoring	ære
hooray	hurra
hopeful	håpe
hospitable	gjestfri
hot	varmt
hottest	hotteste
hug	Klem
humane	human
humble	ydmyk
humility	ydmykhet
humorous	humoristisk
humorously	humoristisk
humour	humor
ideal	ideell
idealize	idealisere
idolize	forgude
idolized	forgudet
idyllic	idylliske
illuminate	belyse
illuminating	Illuminerende
illumine	opplyse
illustrious	strålende
imaginative	Fantasifull
immaculate	plettfri
immense	enorme
impartial	upartisk
impartiality	habilitet
impartially	upartisk
impassioned	lidenskapelig
impeccable	upåklagelig
impeccably	ulastelig
important	viktig
impress	imponere
impressed	imponert
impresses	imponerer
impressive	imponerende
impressively	imponerende
improve	forbedre
improved	forbedret
improvement	forbedring
improvements	forbedringer
improves	forbedrer
improving	forbedring
incredible	utrolig
incredibly	utrolig
indebted	gjeld
individualized	individualisert
indulgence	overbærenhet
indulgent	bærende
industrious	industriell
inestimable	uvurderlig
inexpensive	rimelig
infallibility	ufeilbarlighet
infallible	ufeilbarlig
influential	innflytelsesrik
ingenious	genial
ingeniously	genialt
ingenuity	oppfinnsomhet
ingenuous	troskyldig
innocuous	ufarlige
innovation	innovasjon
innovative	nyskapende
inpressed	Inpressed
insightful	innsiktsfull
inspiration	inspirasjon
inspirational	inspirerende
inspire	inspirere
inspiring	inspirerende
instantly	øyeblikkelig
instructive	rikt
integral	integrert
integrated	integrert
intelligence	intelligens
intelligible	forståelig
interesting	interessant
interests	interesser
intimacy	fortrolighet
intimate	intime
intricate	innviklet
intrigue	intrige
intriguing	fascinerende
intriguingly	intrigere
intuitive	intuitiv
invaluable	uvurderlig
inventive	oppfinneriske
invigorate	styrke
invigorating	styrkende
invincibility	uovervinnelighet
invincible	uovervinnelig
inviolable	ukrenkelig
inviolate	ukrenkelig
invulnerable	usårbar
irreplaceable	uerstattelig
irreproachable	upåklagelig
irresistible	uimotståelig
irresistibly	uimotståelig
jaw-droping	kjeve-droping
jaw-dropping	Hakeslepp
joy	glede
joyful	gledelig
joyfully	glede
joyous	glad
joyously	gledesfylt
jubilate	Jubilate
jubilation	jubel
judicious	klok
justly	rettferdig
keen	ivrig
keenly	intenst
keenness	iver
kid-friendly	barnevennlig
kindliness	vennlighet
kindly	Vennligst
kindness	vennlighet
knowledgeable	kunnskapsrik
kudos	Kudos
laudable	rosverdig
lavish	overdådig
lavishly	overdådig
law-abiding	lovlydige
lawful	lovlig
lawfully	lovlig
lead	lede
leading	ledende
led	ledet
legendary	legendarisk
leverage	innflytelse
levity	lettsinn
liberate	frigjøre
liberation	frigjøring
liberty	frihet
lifesaver	livsredder
light-hearted	Letthjertet
like	som
liked	likte
likes	liker
liking	smak
lively	livlig
logical	logisk
long-lasting	langvarig
lovable	elskelig
love	kjærlighet
loved	elsket
loveliness	skjønnhet
lovely	herlig
loves	elsker
loving	kjærlig
loyal	lojal
loyalty	lojalitet
luck	flaks
luckier	heldigere
luckiest	heldigste
lucky	heldig
lucrative	lukrative
luminous	lysende
lush	frodige
luster	glans
lustrous	skinnende
luxuriant	frodig
luxuriate	nyt
luxurious	luksuriøs
luxuriously	luksuriøst
luxury	luksus
lyrical	lyrisk
magic	magi
magical	magisk
magnanimous	sinnet
magnificence	storhet
magnificent	storslått
magnificently	prakt
majestic	majestetiske
majesty	majestet
manageable	overkommelig
maneuverable	manøvrer
marvel	vidunder
marveled	undret
marvelled	undret
marvellous	strålende
marvelous	strålende
marvelously	marvellously
master	herre
masterful	mesterlig
masterfully	mesterlig
masterpiece	mesterverk
masterpieces	mesterverk
masters	mestere
mastery	mestring
matchless	makeløs
mature	moden
maturity	modenhet
memorable	minneverdig
merciful	barmhjertig
mercifully	barmhjertig
mercy	nåde
merit	bragd
meritorious	meritter
merrily	lystig
merriment	munterhet
merry	god
mesmerized	hypnotisert
mesmerizing	fortryllende
meticulous	nitid
meticulously	omhyggelig
mightily	mektig
mighty	mektig
mind-blowing	halsbrekk
miracle	mirakel
miracles	mirakler
miraculous	mirakuløs
miraculously	mirakuløst
modern	moderne
modest	beskjeden
modesty	beskjedenhet
momentous	betydnings
morality	moral
motivated	motivert
navigable	farbare
neat	ryddig
neatest	flotteste
neatly	pent
nice	hyggelig
nicely	pent
nicer	bedre
nicest	hyggeligste
nifty	kjekk
nimble	kvikk
noble	edel
noiseless	lydløs
non-violence	ikke-vold
notably	spesielt
noteworthy	bemerkelsesverdig
nourish	ernære
nourishing	næringsrik
nourishment	næring
novelty	nyhet
nurturing	pleie
oasis	oase
obsession	besettelse
obsessions	besettelser
obtainable	oppnåelig
openly	åpent
openness	åpenhet
optimism	optimisme
optimistic	optimistisk
opulent	overdådige
orderly	velordnet
originality	originalitet
outdo	overgå
outdone	gått
outperform	utkonkurrere
outperformed	utkonkurrerte
outperforms	utkonkurrerer
outsmart	liste
outstanding	fremragende
outstandingly	used
outstrip	outs
outwit	liste
ovation	applaus
overjoyed	lykkelig
overtake	overta
overtaken	taken
overtakes	overgår
overtaking	forbikjøring
overtook	overtok
overture	overtyre
pain-free	smertefri
painless	smertefri
painlessly	smertefritt
palatial	stase
pamper	skjemme
pampered	bortskjemt
pampers	Pampers
panoramic	panorama
paradise	paradis
paramount	overordnet
pardon	tilgi
passion	lidenskap
passionate	lidenskapelig
passionately	lidenskapelig
patience	tålmodighet
patient	pasient
patiently	tålmodig
patriotic	patriotisk
peace	fred
peaceable	fredsommelig
peaceful	fredelig
peacefully	fredelig
peach	fersken
peerless	Peerless
perfect	perfekt
perfection	fullkommenhet
perfectly	perfekt
permissible	tillatelig
perseverance	utholdenhet
personages	personligheter
personalized	personlig
phenomenal	fenomenale
phenomenally	fenomenalt
picturesque	pittoreske
piety	fromhet
pinnacle	høydepunkt
playful	leken
playfully	lekent
pleasant	hyggelig
pleasantly	positivt
pleased	fornøyd
pleases	gleder
pleasing	hyggelig
pleasurable	behage
pleasure	glede
plentiful	rikelig
pluses	plusser
plush	plysj
poetic	poetisk
poignant	gripende
poise	kroppsholdning
poised	klar
polished	polert
polite	høflig
politeness	høflighet
popular	populær
portable	bærbar
posh	snobbete
positive	positiv
positively	positivt
positives	positiver
powerful	kraftig
powerfully	kraft
praise	ros
praiseworthy	verdig
praising	priste
pre-eminent	fremtredende
precious	dyrebar
precise	nøyaktig
precisely	presist
preeminent	fremragende
prefer	foretrekker
preferable	foret
preferably	helst
prefered	foretrukket
preferring	foretrakk
prefers	foretrekker
prestige	prestisje
prestigious	prestisjetunge
prettily	vakkert
pretty	ganske
priceless	uvurderlig
pride	stolthet
principled	prinsipiell
privilege	privilegium
privileged	privilegert
prize	premie
proactive	proaktiv
problem-free	problemfritt
problem-solver	problemløser
prodigious	uhyre
prodigy	vidunderbarn
productive	produktivt
productively	produktivt
proficient	dyktig
proficiently	kyndig
profound	dyp
profoundly	dypt
profuse	rikelig
profusion	vell
progress	framgang
prolific	produktive
prominence	fremtredende
prominent	fremtredende
promise	love
promised	lovet
promises	løfter
promising	lovende
promptly	omgå
proper	ordentlig
properly	riktig
propitious	gunstig
pros	proffene
prosper	blomstre
prosperity	velstand
prosperous	velstående
protect	beskytte
protection	beskyttelse
protective	beskyttende
proud	stolt
proven	bevist
proves	beviser
providence	forsyn
proving	beviser
prudence	klokskap
prudent	forsvarlig
prudently	klokt
punctual	punktlig
pure	ren
purify	rense
purposeful	målbevisst
quaint	eiendommelig
qualified	utdannet
qualify	kvalifisere
quicker	raskere
quiet	stille
quieter	roligere
radiance	utstråling
radiant	strålende
rapid	rask
rapt	henført
rapture	henrykkelse
rapturous	begeistrede
rational	rasjonell
razor-sharp	sylskarp
reachable	nås
readable	leselig
readily	lett
ready	klar
reaffirm	stadfester
realistic	realistisk
realizable	realiserbar
reasonable	rimelig
reasonably	rimelig
reasoned	begrunnet
reassurance	beroligelse
reassure	Forsikre
receptive	mottakelig
reclaim	gjenvinne
recomend	tilrå
recommend	anbefale
recommendation	anbefaling
recommendations	anbefalinger
recommended	anbefales
reconcile	forsone
reconciliation	forsoning
recover	gjenopprette
recovery	gjenoppretting
rectification	retting
rectify	utbedre
rectifying	likeretter
redeem	innløse
redeeming	forløsende
redemption	forløsning
refine	raffinere
refined	raffinert
refinement	avgrensning
reformed	reformert
reforming	reformere
reforms	reformer
refresh	forfriske
refreshed	uthvilt
refreshing	forfriskende
refund	refusjon
refunded	refundert
regal	kongelig
rejoice	fryde
rejoicingly	jublet
rejuvenate	forynge
rejuvenated	forynget
rejuvenating	Fornyelse
relaxed	avslappet
relent	formilde
reliable	pålitelig
reliably	pålitelig
relief	lettelse
remarkable	bemerkelsesverdig
remarkably	bemerkelsesverdig
remedy	middel
remission	remisjon
remunerate	godt
renaissance	renessanse
renewed	fornyet
renown	kjent
renowned	kjente
replaceable	utskiftbare
reputable	aner
reputation	rykte
resilient	elastisk
resolute	resolutt
resound	runge
resounding	rungende
resourceful	ressurs
resourcefulness	oppfinnsomhet
respect	respekt
respectable	respekt
respectful	respekt
respectfully	respektfult
respite	pusterom
resplendent	strålende
responsibly	ansvarlig
responsive	mottakelig
restful	avslappende
restored	restaurert
restructure	omstrukturere
restructured	omstrukturert
restructuring	restrukturering
retractable	uttrekkbar
revel	kalas
revelation	åpenbaring
reverence	ærbødighet
reverent	ærbødig
reverently	ærbødig
revitalize	revitalisere
revival	vekkelse
revive	gjenopplive
revives	gjenoppliver
revolutionary	revolusjonerende
revolutionize	revolusjonere
revolutionized	revolusjon
revolutionizes	revolusjonerer
reward	belønning
rewarding	givende
rich	rik
richer	rikere
richly	rikt
richness	rikdom
righteous	rettferdige
righteously	rettferdig
righteousness	rettferdighet
rightful	rettmessige
rightfully	rettmessig
rightly	rette
rightness	riktighet
risk-free	risikofritt
rock-star	rockestjerne
rock-stars	rockestjerner
rockstar	rockestjerne
rockstars	rockestjerner
romantic	romantisk
romantically	kjærester
romanticize	romantisere
roomy	romslig
rosy	rosenrød
safe	sikker
safely	trygt
sagacity	klokskap
saint	helgen
saintly	hellig
salutary	sunn
salute	honnør
sane	tilregnelig
satisfactorily	tilfredsstillende
satisfactory	tilfredsstillende
satisfied	fornøyd
satisfies	tilfredsstiller
satisfy	tilfredsstille
satisfying	tilfredsstillende
savings	sparing
savior	frelser
savvy	erfarne
scenic	scenisk
seamless	sømløs
seasoned	erfaren
secure	sikre
securely	sikkert
selective	selektiv
self-determination	selv-bestemmelse
self-respect	selvrespekt
self-satisfaction	selv-tilfredshet
self-sufficiency	selvforsyning
self-sufficient	selvforsynt
sensation	følelse
sensational	oppsiktsvekkende
sensationally	sensasjonelt
sensations	sensasjoner
sensible	fornuftig
sensibly	fornuftig
sensitive	følsom
serene	fredelig
serenity	sinnsro
sharp	skarp
sharper	skarpere
sharpest	skarpeste
shimmering	skimrende
shine	skinne
shiny	skinnende
significant	betydelige
silent	stille
simpler	enklere
simplest	enkleste
simplified	forenklet
simplifies	forenkler
simplify	forenkle
simplifying	forenkle
sincere	oppriktig
sincerity	oppriktighet
skill	ferdighet
skilled	dyktig
skillful	dyktig
skillfully	dyktig
sleek	slank
slick	glatt
smarter	smartere
smartest	smarteste
smartly	smart
smile	smil
smiles	smiler
smiling	smilende
smilingly	smilende
smitten	smittet
smooth	glatt
smoother	jevnere
smoothes	jevner
smoothest	glatt
smoothly	problemfritt
snappy	irritabel
sociable	sosial
soft	myk
softer	mykere
solace	trøst
solicitous	omsorgs
solid	fast
solidarity	solidaritet
soothe	bero
soothingly	beroligende
sophisticated	sofistikert
soundness	soliditet
spacious	romslig
sparkle	gnisten
sparkling	musserende
spectacular	spektakulære
spectacularly	spektakulært
speedily	raskt
spellbind	trollbinde
spellbinding	trollbindende
spellbindingly	medrivende
spellbound	fjetret
spiritual	åndelig
splendid	fantastisk
splendidly	prakt
splendor	prakt
spontaneous	spontan
sporty	sportslig
spotless	plettfrie
sprightly	struttende
stability	stabilitet
stabilize	stabilisere
stable	stabil
stainless	rustfritt
stately	stase
staunch	trofast
staunchly	standhaftig
steadfast	standhaftig
steadfastly	standhaftig
steadfastness	standhaftighet
steadiest	stødigste
steadiness	stødighet
steady	stødig
stimulate	stimulere
stimulates	stimulerer
stimulating	stimulerende
stimulative	stimulerende
straighten	rette
streamlined	strømlinjeformet
striking	slående
strikingly	slående
strong	sterk
stronger	sterkere
strongest	sterkeste
stunning	slående
stunningly	utrolig
stupendous	overveldende
sturdier	kraftigere
sturdy	solid
stylish	stilig
stylishly	stil
stylized	stilisert
suave	beleven
subsidize	subsidiere
subsidized	subsidiert
subsidizes	subsidierer
subsidizing	subsidiere
substantive	materielle
succeed	lykkes
succeeded	lyktes
succeeding	lykkes
succeeds	lykkes
success	suksess
successes	suksesser
successful	vellykket
successfully	vellykket
suffice	nok
suffices	tilstrekkelig
sufficient	tilstrekkelig
sufficiently	tilstrekkelig
suitable	passende
sumptuous	overdådig
sumptuously	overdådig
sumptuousness	overdådighet
superb	suveren
superior	overlegen
superiority	overlegenhet
supple	smidig
support	Brukerstøtte
supported	støttet
supporting	bære
supportive	støttende
supports	støtter
supremacy	overlegenhet
supremely	super
surmount	vinne
surpass	overgå
surreal	surrealistisk
survival	overlevelse
survivor	overlevende
sustainability	bærekraft
sustainable	bærekraftig
sweeping	feiing
sweet	søt
sweeten	blid
sweetheart	kjæreste
sweetly	søtt
sweetness	søthet
swift	fort
swiftness	hurtighet
talented	talent
talents	talenter
tantalize	erte
tantalizing	frist
tantalizingly	tantalisingly
tempt	friste
tempting	fristende
tenacious	utholdende
tenacity	fasthet
tender	mør
tenderly	ømt
terrifically	forferdelig
thank	takke
thankful	takknemlig
thinner	tynnere
thoughtful	omtenksom
thoughtfully	tanke
thoughtfulness	omtanke
thrift	sparsommelighet
thrifty	sparsommelig
thrill	spenningen
thrilled	begeistret
thrilling	spennende
thrills	spenning
thrive	blomstre
thriving	blomstrende
tickle	kile
tidy	ryddig
time-honored	hevdvunne
timely	betimelig
tingle	prikke
titillate	pirre
titillating	pirrende
togetherness	samvær
tolerable	utholdelig
toll-free	tollfri
top	topp
tops	topper
tough	vanskelig
tougher	tøffere
toughest	tøffeste
traction	trekkraft
tranquil	rolig
tranquility	ro
transparent	gjennomsiktig
treasure	skatt
tremendously	enormt
triumph	triumf
triumphal	triumftog
triumphant	triumferende
triumphantly	triumfer
trivially	trivielt
trophy	trofé
trouble-free	problemfri
trump	trumf
trumpet	trompet
trust	tillit
trusted	klarert
trusting	tillits
trustworthiness	troverdighet
trustworthy	troverdig
trusty	trofaste
truthful	sannferdig
truthfully	sannferdig
truthfulness	sannferdighet
ultra-crisp	ultra-skarp
unabashed	uforbeholden
unaffected	upåvirket
unassailable	uangripelig
unbeatable	uslåelig
unbiased	objektivt
unbound	ubundet
uncomplicated	ukomplisert
unconditional	betingelsesløs
undamaged	uskadet
undaunted	uforferdet
understandable	forståelig
undisputable	udiskutabel
undisputed	udiskutert
unencumbered	uhemmet
unequivocal	utvetydig
unequivocally	utvetydig
unfazed	uberørt
unfettered	ubundet
unforgettable	uforglemmelig
unity	enhet
unlimited	ubegrenset
unmatched	uovertruffen
unparalleled	enestående
unquestionable	udiskutable
unquestionably	utvilsomt
unreal	uvirkelig
unrestricted	ubegrenset
unrivaled	uovertruffen
unselfish	uselvisk
unwavering	urokkelig
upgradable	oppgraderbar
upgradeable	oppgraderes
upgraded	oppgradert
upheld	oppholdt
uphold	opprett
uplift	friinntekt
uplifting	oppløftende
upscale	oppskalere
usable	bruk
useable	brukbar
useful	nyttig
user-friendly	Brukervennlig
valiant	tapper
valiantly	tappert
valor	tapperhet
valuable	verdifull
variety	variasjon
venerate	ære
verifiable	verifiserbar
veritable	veritabel
versatile	allsidig
versatility	allsidighet
vibrant	levende
victorious	seirende
victory	seier
viewable	synlig
vigilance	årvåkenhet
vigilant	årvåken
virtue	dyd
virtuous	dydig
visionary	visjonær
vivacious	livlig
vivid	levende
vouch	innestå
vouchsafe	verdiget
warm	varm
warmer	varmere
warmhearted	varmhjertet
warmly	hjertelig
warmth	varme
wealthy	rik
welcome	Velkommen
well-balanced	velbalansert
well-being	trivsel
well-bred	veloppdragen
well-connected	brønn-tilkoblet
well-established	veletablerte
well-informed	velinformert
well-intentioned	velmenende
well-known	Velkjente
well-managed	veldrevne
well-positioned	Plassert
well-run	veldrevet
wellbeing	velvære
wholeheartedly	helhjertet
wholesome	sunn
willing	villig
willingly	villig
willingness	villighet
win	vinne
windfall	nedfallsfrukt
winner	vinner
winners	vinnere
winning	vinne
wins	vinner
wisdom	visdom
wise	klok
wisely	klokt
witty	vittig
won	Vant
wonderful	herlig
wonderfully	fantastisk
wonders	verk
work	arbeid
workable	brukbar
worked	arbeidet
works	virker
world-famous	verdensberømte
worth	verdi
worthiness	verdighet
worthwhile	verdt
worthy	verdig
wowed	imponert
wowing	imponere
yay	Jippi
youthful	ungdommelig
zeal	iver
2-faced	2-møtt
2-faces	2-ansikter
abnormal	unormal
abolish	avskaffe
abominable	avskyelig
abominate	avsky
abomination	styggedom
abort	avbryte
aborted	abortert
aborts	avbryter
abrade	slip
abrasive	slip
abrupt	brå
abruptly	brått
absence	fravær
absent-minded	fraværende
absentee	fraværende
absurdity	absurditet
absurdly	absurd
absurdness	absurd
abuse	misbruke
abused	misbrukt
abuses	overgrep
abusive	fornærmende
abyss	avgrunnen
accidental	utilsiktet
accost	resepsjonist
accursed	forbannet
accusation	anklage
accusations	beskyldninger
accuse	beskylde
accuses	beskylder
accusing	anklagende
accusingly	anklagende
acerbic	bitter
ache	smerte
ached	verket
aches	smerter
aching	verk
acrid	etsende
acrimony	bitterhet
adamant	ubøyelig
addict	stoffmisbruker
addicted	avhengige
addicts	narkomane
admonish	formane
admonition	formaning
adulterate	forfalske
adulteration	utblanding
adversarial	motstandere
adversary	motpart
adverse	uheldig
adversity	motgang
afflict	plage
affliction	lidelse
affront	krenkelse
afraid	redd
aggravate	forverre
aggravating	irriterende
aggravation	forverring
aggression	aggresjon
aggressive	aggressiv
aggressiveness	aggressivitet
aggressor	angriper
aggrieve	såre
aggrieved	fornærmede
aghast	forferdet
agonize	pines
agonizing	pinefull
agonizingly	agonisingly
agony	smerte
aground	grunnstøting
ailing	skrantende
ailment	sykdom
aimless	formålsløs
alarmed	skremt
alarming	foruroligende
alarmingly	alarmerende
alienate	fremmedgjøre
alienated	fremmedgjort
alienation	fremmedgjøring
allegation	påstand
allegations	påstander
allege	påstår
allergic	allergisk
allergies	allergi
allergy	allergi
aloof	reservert
altercation	krangel
ambiguity	tvetydighet
ambiguous	tvetydig
ambivalence	ambivalens
ambush	bakhold
amiss	galt
amputate	amputere
anarchism	anarkisme
anarchist	anarkist
anarchistic	anarkistisk
anarchy	anarki
anemic	anemisk
anger	sinne
angrily	sint
angry	sint
anguish	kval
animosity	fiendtlighet
annihilate	utslette
annihilation	utslettelse
annoy	irritere
annoyance	irritasjon
annoyances	irritasjonsmomenter
annoyed	irritert
annoying	irriterende
annoyingly	grammatikken
annoys	irriterer
anomalous	uregelrett
anomaly	anomali
antagonism	antagonisme
antagonist	motstander
antagonistic	antagonistisk
antagonize	motvirke
anti-american	anti-amerikansk
anti-israeli	anti-israelske
anti-occupation	anti-okkupasjon
anti-proliferation	anti-spredning
anti-semites	antisemitter
anti-social	anti-sosial
anti-us	anti-oss
anti-white	anti-hvitt
antipathy	antipati
antiquated	antikvert
antithetical	antitetisk
anxieties	angst
anxiety	angst
anxious	engstelig
anxiously	Nervøst
anxiousness	engstelighet
apathetic	apatisk
apathy	apati
apocalyptic	apokalyptisk
apologist	apologet
apologists	apologeter
appal	forskrekke
appalled	forferdet
appalling	forferdelig
appallingly	forferdelig
apprehension	engstelse
apprehensions	forståelsen
apprehensive	engstelig
arbitrary	vilkårlig
arcane	uforståelige
archaic	arkaisk
arduous	krevende
arrogance	arroganse
arrogantly	arrogant
ashamed	skamfull
askance	skjeve
assail	angripe
assassin	snikmorder
assassinate	myrde
assault	overfall
asunder	stykker
atrocious	fryktelig
atrocities	grusomheter
atrocity	grusomhet
atrophy	atrofi
attack	angrep
attacks	angrep
audacious	dumdristig
audacity	frekkhet
austere	strenge
authoritarian	autoritær
autocrat	autokraten
autocratic	autokratiske
avalanche	snøskred
avarice	gjerrighet
avaricious	gjerrige
avenge	hevne
averse	uvillig
aversion	aversjon
awful	fryktelig
awfully	forferdelig
awkward	pinlig
ax	øks
back-logged	back-logges
back-woods	back-skogen
backache	ryggsmerter
backaches	ryggsmerter
backbite	baktal
backbiting	baksnakking
backward	bakover
backwardness	tilbakeligg
bad	dårlig
badly	dårlig
baffle	baffel
baffling	uforståelig
bait	agn
banish	forvise
banishment	forvisning
bankrupt	konkurs
barbarian	barbar
barbaric	barbariske
barbarity	barbari
barbarous	barbariske
barren	ufruktbar
baseless	grunnløs
bashful	blyg
bastard	drittsekk
battered	ramponert
battering	batte
beastly	dyrisk
beg	tigge
beggar	tigger
begging	ber
beguile	snik
belated	forsinket
belittle	bagatelliserer
belittled	fornedret
belittling	nedsettende
belligerent	Fiendtlig
bemoan	beklage
bemoaning	jamret
bemused	forundret
bent	bøyd
berate	skjelle
bereavement	sorg
bereft	berøvet
berserk	Berserk
beseech	bønnfaller
besiege	beleire
bestial	bestialsk
betray	forråde
betrayal	forræderi
betrayals	svik
betraying	røve
betrays	forråder
bewail	jamre
beware	pass
bewilder	forvirre
bewildered	forvirret
bewildering	forvirrende
bewilderment	forvirring
bewitch	forhekse
bias	partiskhet
biased	forutinntatt
biases	skjevheter
bicker	krangler
bickering	krangling
bid-rigging	anbudssamarbeid
bigotry	fordommer
bitch	tispe
bitterly	bittert
bitterness	bitterhet
bizarre	bisarr
blab	sladrer
blackmail	utpressing
blameworthy	klanderverdig
bland	kjedelig
blaspheme	spotte
blasphemous	blasfemisk
blasphemy	blasfemi
blasted	sprengt
blatantly	åpenlyst
bleak	bleik
bleed	blø
bleeding	blør
bleeds	blør
blemish	lyte
blindingly	blend
blister	blemme
blistering	blemmer
bloated	oppsvulmet
blockage	blokkering
bloodshed	blodsutgytelse
bloodthirsty	blodtørstig
bloody	blodig
blotchy	flekkete
blow	blåse
blunder	bommert
blundering	blunde
blunders	tabber
blunt	sløv
blur	uklarhet
blurred	uskarp
blurring	uskarphet
blurry	utydelig
blurs	uklarheter
boastful	braut
boggle	Boggle
bogus	tull
boiling	koke
boisterous	støy
bomb	bombe
bombard	bombardere
bombardment	bombardement
bombastic	bombastisk
bore	kjede
bored	lei
boredom	kjedsomhet
bores	boringer
boring	kjedelig
bother	bry
bothered	plaget
bothering	plager
bothers	plager
bothersome	brysom
boycott	boikott
bragger	Brøgger
brainwash	hjernevask
brash	issørpe
brat	drittunge
bravado	Bravado
brazen	skamløs
brazenly	skamløst
brazenness	Frekk
breach	brudd
breakdown	sammenbrudd
breaks	pauser
breakups	samlivsbrudd
bribery	bestikkelser
brimstone	svovel
bristle	bust
brittle	skjør
broke	blakk
broken-hearted	hjerteknust
brood	stamfisk
bruise	blåmerke
bruised	forslått
bruises	blåmerker
bruising	blåmerker
brusque	brysk
brutalising	brutaliser
brutalities	brutalitet
brutality	brutalitet
brutalizing	brutaliser
brutally	brutalt
buckle	spenne
bugging	avlytting
bulkier	digre
bulky	klumpete
bull****	okse****
bull----	okse----
bullies	bøller
bullshit	tull
bully	bølle
bullying	mobbing
bum	boms
bump	dunke
bumps	støt
bumpy	humpete
bungle	Bungle
bungler	klossmajor
burden	byrde
burdensome	tyngende
burn	brenne
burned	brent
burning	brenning
burns	brannsår
bust	Bryst
busts	byster
butcher	slakter
butchery	slakteri
buzzing	summende
byzantine	bysantinsk
cackle	kakle
calamities	ulykker
calamity	ulykke
callous	ufølsom
calumnies	bakvaskelser
calumny	bakvaskelse
cancer	kreft
cancerous	kreft
cannibal	kannibal
capitulate	kapitulere
capricious	lune
capsize	kantre
careless	uforsiktig
carelessness	uforsiktighet
caricature	karikatur
carnage	blodbad
carp	karpe
castrated	kastrert
casualty	havari
cataclysm	katastrofen
cataclysmic	kataklysmisk
catastrophe	katastrofe
catastrophes	katastrofer
catastrophic	katastrofal
catastrophically	katastrofalt
caustic	kaustisk
caustically	sarkastisk
cautionary	advarende
cave	hule
censure	sensurere
chafe	gnage
chaff	agner
chagrin	ergrelse
challenging	utfordrende
chaos	kaos
chaotic	kaotisk
chasten	tukte
chastise	tukte
chastisement	straff
chatter	skravling
chatterbox	skravlebøtte
cheap	billig
cheapen	billigere
cheaply	billig
cheat	jukse
cheated	jukset
cheater	juksemaker
cheating	juks
cheats	bedrager
checkered	rutete
childish	barnslig
chill	kulden
chilly	kjølig
choke	kvele
choleric	koleriske
choppy	krapp
chore	ork
chronic	kronisk
clamorous	larm
cliche	klisje
cliched	klisjéaktige
clique	Klikk
clog	tresko
clogged	tett
clogs	tresko
cloud	Sky
cloudy	skyet
clueless	uvitende
clumsy	klønete
coarse	grov
coerce	tvinge
coercion	tvang
coercive	tvungen
cold	kald
coldly	kaldt
collapse	kollapse
collude	konspirere
collusion	sammensvergelser
combative	stridslystne
combust	forbrenne
comical	komisk
commiserate	uttrykke
commonplace	vanlig
commotion	oppstyr
complacent	tilfreds
complain	klage
complained	klaget
complaining	klag
complains	klager
complaint	klage
complaints	klager
complex	komplekse
complicated	komplisert
complication	komplikasjon
complicit	medvirker
compulsion	tvang
compulsive	tvangsmessig
concede	medgir
conceded	innrømmet
conceit	innbilskhet
conceited	innbilsk
concen	konsen
concern	bekymring
concerned	bekymret
concerns	bekymringer
concession	konsesjon
concessions	konsesjoner
condemn	fordømme
condemnation	fordømmelse
condemned	fordømt
condemns	fordømmer
condescend	nedlate
condescending	nedlatende
condescendingly	nedlatende
condescension	nedlatenhet
confess	tilstå
confession	tilståelse
confessions	bekjennelser
confined	begrenset
conflict	konflikt
conflicted	konflikt
conflicting	motstrid
conflicts	konflikter
confound	skamme
confounded	forvirret
confounding	forvirrende
confront	konfrontere
confrontation	konfrontasjon
confrontational	konfronterende
confuse	forvirre
confused	forvirret
confuses	forvirrer
confusing	forvirrende
confusion	forvirring
confusions	uklarheter
congested	trafikk
congestion	opphopning
cons	ulemper
conservative	konservative
conspicuous	iøynefallende
conspicuously	påfallende
conspiracies	konspirasjoner
conspiracy	sammensvergelse
conspiratorial	konspiratorisk
conspire	konspirerer
consternation	bestyrtelse
contagious	smittsom
contaminate	forurense
contaminated	forurenset
contaminates	forurenser
contaminating	forurensende
contamination	forurensning
contempt	forakt
contemptible	foraktelig
contemptuous	foraktelig
contemptuously	foraktelig
contend	stri
contention	påstand
contentious	omstridte
contort	anstrenge
contradict	motsi
contradiction	motsigelse
contradictory	motstrid
contravene	strid
contrive	pønsker
controversial	kontroversielt
controversy	Kontrovers
corrode	korrodere
corrosion	korrosjon
corrosive	etsende
corrupt	korrupt
corrupted	ødelagt
corrupting	ødelegge
corruption	korrupsjon
corrupts	korrumperer
costlier	dyrere
costly	kostbar
counter-productive	kontraproduktivt
covetous	begjærlig
coward	feiging
cowardly	feigt
crabby	sur
crack	sprekk
cracked	sprakk
cracks	sprekker
crafty	listig
cramp	krampe
cramped	trangt
cramping	kramper
cranky	gretten
crap	dritt
crash	brak
crashed	krasjet
crashes	krasjer
crashing	krasje
crass	krasse
cravenly	feigt
craze	mani
crazily	vannvittig
craziness	galskap
crazy	gal
creak	knirke
creaking	knirk
creaks	knirker
credulous	godtroende
creeping	snik
creeps	kryper
creepy	skummel
crept	krøp
crime	forbrytelse
criminal	forbryter
cringe	kleint
cringed	krøp
cripple	krøpling
crippled	forkrøplet
cripples	krøplinger
crippling	krøplende
crisis	krise
critic	kritisk
critical	kritisk
criticism	kritikk
criticisms	kritikk
criticize	kritisere
criticized	kritisert
criticizing	kritisere
critics	kritikere
cronyism	kameraderi
crook	kjeltring
crooked	krokete
crowded	fylt
crowdedness	crowded
crude	grov
cruel	grusom
cruelest	grusomste
cruelly	grusomt
cruelties	grusomheter
cruelty	grusomhet
crumble	smuldre
crumbling	smuldrer
crumple	krølle
crumpled	krøllet
crumples	krøller
crushed	knust
crushing	knusing
cry	gråte
culpable	klanderverdig
culprit	skyldige
cumbersome	tungvint
cunt	fitte
curse	forbannelse
cursed	forbannet
curses	forbannelser
curt	brysk
cuss	drøfte
cynical	kynisk
cynicism	kynisme
damage	skader
damaged	skadet
damages	skader
damaging	ødeleggende
damn	jævla
damnable	forbannet
damnably	forbannet
damnation	fortapelse
damned	forbannet
damning	forbasket
damper	spjeldet
danger	fare
dangerous	farlig
dark	mørk
darken	mørkere
darkened	mørknet
darker	mørkere
darkness	mørke
dastardly	feige
daunt	Daunt
daunting	skremmende
dawdle	somle
dazed	omtumlet
dead	død
deadbeat	Deadbeat
deadlock	vranglås
deadly	dødelig
deadweight	dødvekt
deaf	døv
dearth	mangel
death	død
debacle	fiaskoen
debase	fornedre
debaser	Debaser
debatable	diskutabel
debauchery	utskeielser
debilitate	svekke
debilitating	ødeleggende
debility	svakhet
debt	gjeld
debts	gjeld
decadence	dekadanse
decadent	dekadent
decay	forfall
decayed	forfalt
deceit	bedrageri
deceitful	bedragersk
deceitfulness	bedrag
deceive	lure
deceiver	bedrager
deceivers	forførere
deceiving	bedra
deception	bedrag
deceptive	villedende
deceptively	utrolig
decline	avslå
declines	avtar
declining	synkende
decrement	minsk
decrepit	avfeldig
decry	fordømme
defamation	ærekrenkelse
defamatory	ærekrenkende
defame	ærekrenke
defect	defekt
defective	defekt
defects	defekter
defensive	defensiv
defiance	trass
defiant	trassig
defiantly	trassig
deficiencies	mangler
deficiency	mangel
deficient	mangelfull
defile	besudle
defiler	Defiler
deform	deformeres
deformed	deformert
defrauding	bedrageri
defunct	nedlagte
defy	trosse
degenerate	degenerert
degeneration	degenerasjon
degradation	degradering
degrade	degradere
degrading	nedverdigende
dehumanize	umenneskelig
deign	nedlate
dejected	nedslått
dejection	motløshet
delay	utsette
delayed	forsinket
delaying	forsinkende
delays	forsinkelser
delinquency	lovovertredelse
delinquent	betalingsudyktig
delirious	delirisk
delude	narre
deluded	villedet
deluge	oversvømmelse
delusion	vrangforestilling
delusional	vrangforestillinger
delusions	vrangforestillinger
demean	nedverdige
demeaning	nedverdigende
demise	død
demolish	rive
demonic	demoniske
demonize	demoniserer
demonized	demonisert
demonizes	demoniserer
demonizing	demonisering
demoralize	demoralisere
demoralizing	demoraliserende
denial	benektelse
denied	benektet
denies	benekter
denounce	fordømme
dense	tett
dent	bulk
dented	bulket
dents	bulker
denunciation	Oppsigelsen
denunciations	oppsigelser
deny	benekte
denying	benektes
deplete	tømme
deplorable	beklagelig
deplore	beklage
deploring	beklaget
depraved	fordervet
depress	trykke
depressed	deprimert
depressing	deprimerende
depressingly	deprimerende
depression	depresjon
depressions	depresjoner
deprive	frarøve
deprived	fratatt
deride	spotter
derision	hån
derisive	hånlig
derogatory	nedsettende
desecrate	skjende
desert	ørken
desertion	deserte
desolate	øde
desolation	ødeleggelse
despair	fortvilelse
despairing	fortvilet
despairingly	fortvilet
desperate	desperat
desperately	desperat
desperation	desperasjon
despicable	avskyelig
despise	forakte
despised	foraktet
despoil	plyndre
despoiler	herjeren
despondency	motløshet
despondent	motløs
despondently	mistrøstig
despotic	despotiske
despotism	despotisme
destabilisation	destabilisering
destitute	nødlidende
destitution	nød
destroy	ødelegge
destroyer	ødelegger
destruction	ødeleggelse
destructive	destruktiv
deter	avskrekke
deteriorate	forringes
deteriorating	forverret
deterioration	forverring
deterrent	avskrekkende
detest	avsky
detestable	avskyelig
detestably	avskyelig
detested	hatet
detesting	detes
detests	avskyr
detract	døve
detracted	svekket
detracting	avvike
detriment	skade
detrimental	skadelig
devastate	ødelegge
devastated	knust
devastates	ødelegger
devastating	ødeleggende
devastatingly	knusende
devastation	ødeleggelse
deviate	avvike
deviation	avvik
devil	djevel
devilish	djevelsk
devilishly	djevelsk
devious	utspekulert
devoid	fri
diabolic	diabolsk
diabolical	djevelske
diabolically	djevelsk
diametrically	diametralt
diatribes	avhandlinger
dick	pikk
dictator	diktator
dictatorial	diktatorisk
die	dø
died	døde
dies	dør
difficult	vanskelig
difficulties	vanskeligheter
difficulty	vanskelighet
dilapidated	falleferdig
dilly-dally	Dilly-dall
dimmer	mørkere
din	larm
dinky	Eagle
dirt	skitt
dirtbag	drittsekk
dirts	smuss
dirty	skitne
disable	deaktivere
disabled	funksjonshemmet
disadvantage	ulempe
disadvantaged	vanskeligstilte
disadvantageous	ufordelaktig
disadvantages	ulemper
disaffected	misfornøyde
disagreeable	ubehagelig
disagreed	uenige
disagreeing	uenige
disagreement	uenighet
disagrees	uenig
disallow	forby
disapointment	skuffelse
disappoint	skuffe
disappointed	skuffet
disappointing	skuff
disappointingly	skuff
disappointment	skuffelse
disappointments	skuffelser
disappoints	skuffer
disapprobation	misbilligelse
disapproval	misbilligelse
disapprove	mislike
disapproving	misbilligende
disarm	avvæpne
disarray	uorden
disaster	katastrofe
disastrous	katastrofal
disastrously	katastrofalt
disbelief	vantro
disbelieve	vantro
disbeliever	tvil
disclaim	fraskriver
discomfort	ubehag
disconcerted	forvirret
disconcerting	urovekkende
disconsolate	utrøstelig
discontent	misnøye
discontented	misfornøyde
discontinued	avviklet
discontinuity	diskontinuitet
discontinuous	usammenhengende
discord	splid
discordance	uoverensstemmelse
discordant	uharmoniske
discourage	fraråde
discouragement	motløshet
discouraging	nedslående
discourteous	uhøflig
discredit	diskreditere
discrepant	avvikende
discriminate	diskriminere
discrimination	diskriminering
discriminatory	diskriminerende
disdain	forakt
disdained	foraktes
disdainfully	foraktelig
disfavor	disfavør
disgrace	vanære
disgraced	vanæret
disgraceful	skammelig
disgruntled	misfornøyd
disgust	avsky
disgusted	forferdet
disgusting	motbydelig
disheartening	nedslående
dishonest	uærlig
dishonestly	uærlig
dishonesty	uærlighet
dishonor	vanære
dishonorable	æreløs
disillusioned	desillusjonert
disillusionment	desillusjon
disinclination	avsky
disintegrate	desintegrerer
disintegrated	oppløst
disintegrates	desintegrerer
disintegration	oppløsning
disinterested	uinteressert
dislike	motvilje
disliked	mislikte
dislikes	misliker
disliking	mislike
dislocated	forstuet
disloyal	illojale
disloyalty	illojalitet
dismal	sturen
dismay	forferdelse
dismayed	forferdet
dismissive	avvisende
dismissively	avvisende
disobedience	ulydighet
disobedient	ulydig
disobey	ulydig
disorder	lidelse
disordered	uordnede
disorderly	uordentlig
disorganized	uorganisert
disorient	desorientere
disoriented	desorientert
disown	fornekte
disparage	nedvurdere
disparaging	nedsettende
disparagingly	nedsettende
dispensable	unnværlig
displace	forflytte
displaced	fortrenges
displease	mishage
displeased	misfornøyd
displeasing	skjemmende
displeasure	misnøye
disproportionate	uforholdsmessig
disprove	motbevise
disputable	diskutabel
dispute	tvist
disputed	omstridt
disquiet	uro
disquieting	foruroligende
disquietingly	uhyggelig
disquietude	uro
disreputable	useriøse
disrepute	vanry
disrespectful	respektløs
disrespectfully	respektløst
disrupt	forstyrre
disruption	avbrudd
disruptive	forstyrrende
diss	disse
dissapointed	skuffet
dissappointed	skuffet
dissatisfaction	utilfredshet
dissatisfied	misfornøyd
dissemble	Demonter
dissension	uenighet
dissent	dissens
disservice	bjørnetjeneste
disses	Disses
dissidence	systemkritikk
dissidents	dissidenter
dissocial	dyssosial
dissolute	utsvevende
dissolution	oppløsning
dissonance	dissonans
dissonant	dissonerende
dissuade	fraråde
dissuasive	avskrekkende
distaste	avsmak
distasteful	usmakelig
distort	forvrenge
distorted	forvrengt
distortion	forvrengning
distorts	forvrenger
distract	distrahere
distracting	distraherende
distraction	distraksjon
distraught	fortvilet
distress	nød
distressing	plagsom
distrust	mistro
distrustful	mistenksom
disturb	forstyrre
disturbance	forstyrrelse
disturbed	forstyrret
disturbing	urovekkende
disturbingly	urovekkende
disunity	splittelse
divergent	avvikende
divisive	splittende
divisiveness	splid
dizzy	svimmel
dogged	seig
doggedly	innbitt
dogmatic	dogmatisk
domineering	dominerende
doom	undergang
doomed	dømt
doomsday	dommedag
dope	kult
doubt	tvil
doubtful	tvilsom
doubtfully	tvil
doubts	tvil
downcast	nedslått
downfall	fall
downgrade	nedgradere
downhill	utforbakke
downside	ulempen
downsides	ulempene
downturn	nedgangen
downturns	nedgangstider
drab	trist
draconic	Draconic
drag	dra
dragged	dro
dragging	dra
drags	drar
drain	avløp
drained	drenert
draining	drenering
drains	avløp
drastic	drastisk
drastically	drastisk
drawback	ulempen
drawbacks	ulemper
dreadfully	fryktelig
dreary	kjedelig
dripped	dryppet
dripping	dryppende
drippy	dryppende
drips	drypper
drones	droner
droop	henge
drop-outs	slipp-outs
drought	tørke
drowning	drukning
drunk	full
drunkard	drukkenbolt
dubious	tvilsomme
dubiously	tvil
dull	kjedelig
dumb	dum
dumped	dumpet
dumps	dumper
dungeon	fangehull
dungeons	fangehull
dupe	lure
dust	støv
dusty	støvete
dwindling	minskende
dying	døende
eccentric	eksentriske
eccentricity	eksentrisitet
effigy	dukke
egocentric	egosentriske
egotism	egoisme
egotistical	selvopptatt
egregious	skjerpende
election-rigger	Valg-rigger
elimination	eliminering
emaciated	avmagret
emasculate	kastrere
embarrass	flau
embarrassing	pinlig
embarrassingly	pinlig
embarrassment	flause
embattled	krigsherjede
embroiled	involvert
emergency	nødsituasjon
emphatic	empatisk
emphatically	ettertrykkelig
emptiness	tomhet
encroach	gripe
encroachment	inngrep
enemies	fiender
enemy	fiende
engulf	oppsluke
enjoin	pålegge
enmity	fiendskap
enrage	rasende
enraged	rasende
enslave	slavebinde
entangle	komplisere
entanglement	forviklinger
envious	misunnelig
enviously	misunnelig
epidemic	epidemi
equivocal	tvetydig
erode	erodere
erodes	eroderes
erosion	erosjon
errant	villfaren
erratic	uberegnelig
erratically	uberegnelig
erroneous	feilaktig
erroneously	feilaktig
error	feil
errors	feil
eruptions	utbrudd
escapade	sprang
estranged	fraseparerte
evade	unngå
evasion	unnvikelse
evasive	unnvikende
evil	ond
evildoer	ugjernings
evils	onder
exacerbate	forverre
exagerated	overdrevne
exaggerate	overdrive
exaggeration	overdrivelse
exasperate	ergre
exasperated	irritert
exasperation	forbitrelse
excessive	overflødig
excessively	overdrevent
exclusion	utelukkelse
excruciating	uutholdelig
excruciatingly	ulidelig
excuse	unnskyldning
excuses	unnskyldninger
execrate	forbanne
exhaust	eksos
exhausted	utslitt
exhaustion	utmattelse
exhausts	eksos
exhort	formane
exile	eksil
exorbitant	ublu
expel	utvise
expensive	dyrt
expire	utløpe
expired	utløpt
explode	eksplodere
exploit	utnytte
exploitation	utnyttelse
explosive	eksplosiv
expropriate	ekspropriere
expropriation	ekspropriasjon
exterminate	utrydde
extermination	utryddelse
extinguish	slukke
extort	presse
extortion	utpressing
extraneous	overflødig
extravagance	ekstravaganse
extravagant	ekstravagant
extravagantly	flust
extremism	ekstremisme
extremist	ekstremistisk
extremists	ekstremister
fabricate	dikte
fabrication	fabrikasjon
facetious	spøkefull
fail	mislykkes
failed	mislyktes
failing	sviktende
fails	mislykkes
failure	svikt
failures	feil
faithless	troløse
fake	forfalskning
fall	falle
fallacious	uholdbar
fallacy	feilslutning
falling	faller
falls	faller
false	falsk
falsehood	løgn
falsely	feilaktig
falsify	forfalske
falter	svikte
faltered	vaklet
famine	hungersnød
famished	sulten
fanatic	fanatiker
fanatical	fanatisk
fanatically	fanatisk
fanaticism	fanatisme
fanatics	fanatikere
fanciful	fantasifull
far-fetched	usannsynlig
farce	farse
farfetched	usannsynlig
fascism	fascisme
fastidious	kresen
fat	fett
fat-cats	fett-katter
fatalistic	fatalistisk
fatally	skjebnesvangert
fateful	skjebnesvangre
fatefully	skjebnesvangert
fatigue	utmattelse
fatigued	trøtt
fatique	tretthet
fatty	fet
fatuous	tåpelig
fault	feil
faults	feil
faulty	defekt
fear	frykt
fearful	engstelig
fearfully	skremmende
fears	frykter
fearsome	skremmende
feeble	svak
feint	finte
fell	falt
felon	forbryter
ferociously	rasende
ferocity	grusomhet
fetid	illeluktende
fever	feber
feverish	febrilsk
fevers	feber
fickle	fikle
fiction	skjønnlitteratur
fictional	fiktiv
fictitious	fiktiv
fidgety	urolig
fiend	djevel
fiendish	djevelske
fierce	voldsom
figurehead	gallionsfigur
filth	skitt
filthy	skitten
finagle	Finagle
finicky	pirkete
fissures	sprekker
fist	neve
flabbergast	forbløffende
flagrant	åpenbar
flair	teft
flake	flak
flaking	flassing
flaky	flass
flare	fakkel
flaw	feil
flawed	feilaktig
flaws	feil
flee	flykte
fleeing	flykter
flees	flykter
fleeting	flyktig
flicker	flimmer
flickering	flimring
flickers	flimrer
flighty	sindige
flimsy	spinkel
flirty	Flørtete
flounder	flyndre
flout	blaffen
foe	fiende
fool	lure
fooled	lurt
foolhardy	dumdristig
foolish	tullete
foolishly	tåpelig
foolishness	tåpelighet
forbid	forby
forbidden	forbudt
forbidding	avskrekkende
forceful	kraftig
foreboding	illevarslende
forged	smidd
forgetful	glemsom
forgetfully	forget
forgetfulness	glemsomhet
forlorn	laus
forsake	svikte
forsaken	forlatt
fractious	splittende
fracture	brudd
fragile	skjør
fragmented	fragmentert
frail	skrøpelig
frantic	panisk
frantically	febrilsk
fraud	bedrageri
fraudulent	uredelig
fraught	nervøs
frazzled	uryddig
freakishly	latterlig
freeze	fryse
freezes	fryser
freezing	frysing
frenetic	frenetisk
frenetically	frenetisk
frenzied	vanvittige
frenzy	raseri
fret	gnage
fretful	gretten
friction	friksjon
frictions	friksjoner
fried	stekt
fright	frykt
frighten	skremme
frightening	skremmende
frighteningly	skremmende
frightful	skrekkelig
frown	rynke
froze	frøs
frozen	frossen
fruitless	nytteløs
frustrate	frustrere
frustrated	frustrert
frustrates	frustrerer
frustrating	frustrerende
frustratingly	frustrerende
frustration	frustrasjon
frustrations	frustrasjoner
fuck	faen
fucking	jævla
fugitive	rømling
full-blown	fullverdig
fumble	rote
fume	ryke
fumes	røyk
fundamentalism	fundamentalisme
funnily	pussig
funny	morsom
furious	rasende
furiously	rasende
fury	raseri
fuss	oppstyr
fussy	masete
futile	nytteløs
futility	nytteløse
gaff	klepp
gainsay	motsi
gall	galle
galling	riving
garbage	søppel
garish	glorete
gasp	gispe
gaudy	glorete
gawk	glaner
genocide	folkemord
ghastly	uhyggelig
gibberish	tøv
gibe	spott
giddy	svimmel
glare	blending
glitch	svikt
gloom	tungsinn
gloomy	dystert
gnawing	nagende
goad	egge
god-awful	forferdelig
goof	tabbe
goon	Fortsett
gossip	sladder
graft	pode
grainy	kornete
grapple	gripe
grate	rist
gravely	alvorlig
greasy	fettete
greed	grådighet
greedy	grådig
grief	sorg
grievance	klagemål
grievances	klager
grieve	sørge
grieving	sørg
grievous	alvorlig
grim	uhyggelig
grimace	grimase
grind	slipe
gripes	irritasjonen
grisly	uhyggelig
gritty	sandete
gross	ekkelt
grossly	grovt
grotesque	grotesk
grouch	grinebiter
grouchy	gretten
groundless	grunn
grouse	rype
growl	knurre
grudge	nag
grudges	nag
grudging	motvillig
grudgingly	motvillig
gruesome	gyselig
gruesomely	grusomt
gruff	barsk
grumble	beklage
grumpily	grettent
grumpy	grinete
guile	svik
guilt	skyld
guilty	skyldig
gullible	godtroende
gutter	grøft
haggard	Haggard
haggle	prute
hairloss	hårtap
halfhearted	halvhjertede
halfheartedly	halvhjertet
hallucinate	hallusinere
hallucination	hallusinasjon
hamper	hemme
hampered	hemmet
handicapped	funksjonshemmet
hang	henge
hangs	henger
haphazard	tilfeldig
hapless	uheldige
harass	trakassere
harassed	trakassert
harasses	trakasserer
harassment	trakassering
harboring	husing
harbors	havner
hardball	Hardball
harden	Harden
hardened	herdet
hardhearted	hardhjertet
hardliners	uforsonlige
hardship	motgang
hardships	vanskeligheter
harm	skade
harmed	skadet
harmful	skadelig
harms	skader
harrow	harve
harsh	harde
harshly	strengt
hasseling	hasse
hassle	bryderi
hassles	problemer
haste	hastverk
hastily	raskt
hasty	forhastet
hate	hat
hated	hatet
hateful	hatsk
hatefully	hatefullt
hatefulness	hatefullhet
hates	Hates
hatred	hat
haughty	hovmodig
haunt	hjemsøke
havoc	ødeleggelse
hazard	fare
hazardous	farlig
haze	tåke
hazy	disig
head-aches	hodesmerter
headache	hodepine
headaches	hodepine
heartbreaker	hjerteknuser
heartbreaking	hjerteknusende
heartless	hjerteløs
heathen	hedning
heavy-handed	hardhendte
heck	pokker
heckle	hekle
hectic	hektisk
hedge	hekk
hedonistic	hedonistiske
heedless	likegyldige
hefty	heftig
hegemony	hegemoni
heinous	grufulle
hell	helvete
hellion	Hellion
helpless	hjelpeløs
helplessly	hjelpeløst
helplessness	hjelpeløshet
heresy	kjetteri
heretic	kjetter
heretical	kjettersk
hesitant	nølende
hideous	skrekkelig
hinder	hindre
hindrance	hindring
hiss	susing
hissed	hveste
hissing	hvesende
hoard	flokk
hoax	bløff
hobble	hinke
hogs	svin
hollow	hul
hopeless	håpløs
hopelessly	håpløst
hopelessness	håpløshet
horrendous	forferdelig
horrible	fryktelig
horrid	vemmelig
horrific	forferdelig
horrified	forskrekket
horrify	forferde
horrifying	forferdelig
hostage	gissel
hostile	fiendtlig
hostilities	fiendtlighetene
hostility	fiendtlighet
hotbeds	veksthus
hothouse	drivhus
hubris	hybris
huckster	høker
hum	nynne
humid	fuktig
humiliate	ydmyke
humiliating	ydmyk
humiliation	ydmykelse
humming	nynning
hurt	skade
hurtful	sårende
hurting	sårer
hypocrisy	Hykleri
hypocrite	hykler
hypocrites	hyklere
hypocritical	hyklersk
hypocritically	hyklersk
hysteria	hysteri
hysterical	hysterisk
hysterically	hysterisk
hysterics	hysteri
idiocy	idioti
idiotic	idiotisk
idiotically	fjollet
idiots	idioter
idle	tomgang
ignoble	gemen
ignominious	forsmedelig
ignorance	uvitenhet
ignorant	uvitende
ignore	overse
ill-fated	skjebnesvangre
ill-favored	stygge
ill-formed	ill-formet
ill-mannered	uoppdragne
ill-natured	ondskapsfull
ill-tempered	Temperaments
ill-treated	mishandlet
ill-treatment	mishandling
ill-usage	mishandling
illegal	ulovlig
illegally	ulovlig
illegitimate	uekte
illicit	ulovlig
illiterate	analfabet
illness	sykdom
illogical	ulogisk
illusion	illusjon
illusions	illusjoner
illusory	illusorisk
imaginary	innbilt
imbalance	ubalanse
immaterial	uvesentlig
immature	umoden
imminence	umiddelbarhet
imminently	hengende
immobilized	immobilisert
immoderate	umåtelig
immodest	ubeskjedne
immoral	umoralsk
immorality	umoral
immovable	ubevegelig
impair	svekke
impaired	hemmet
impasse	uføret
impatience	utålmodighet
impatient	utålmodig
impatiently	utålmodig
impedance	impedans
impede	hindre
impediment	hinder
impending	forestående
impenitent	ubotferdig
imperfect	ufullkommen
imperfection	ufullkommenhet
imperfections	ufullkommenhet
imperfectly	ufullkomment
imperialist	imperialistiske
imperious	bydende
imperiously	bydende
impermissible	utillatelig
impersonal	upersonlig
impertinent	uforskammet
impetuous	fremfusende
impiety	ugudelighet
impinge	hemmende
impious	ugudelig
implacable	uforsonlig
implausible	usannsynlig
implicate	implisere
implication	Implikasjonen
implode	implodere
impolite	uhøflig
importunate	påtrengende
impose	pålegge
imposing	pålegge
imposition	ileggelse
impossible	umulig
impossibly	håpløst
impoverish	fattigere
impoverished	fattig
impractical	upraktisk
imprecise	upresise
imprecisely	upresist
imprecision	unøyaktighet
imprison	fengsle
imprisonment	fengsling
improbability	usannsynlighet
improbable	usannsynlig
improper	upassende
improperly	feil
imprudence	ubetenksomhet
imprudent	uklok
impudence	uforskammethet
impudent	uforskammet
impudently	uforskammet
impulsive	impulsiv
impulsively	impulsivt
impunity	straffrihet
impure	uren
impurity	urenhet
inaccuracies	unøyaktigheter
inaccuracy	unøyaktighet
inaccurate	unøyaktig
inaccurately	unøyaktig
inaction	passivitet
inactive	inaktiv
inadequacy	utilstrekkelighet
inadequate	utilstrekkelig
inadequately	tilside
inadvisable	utilrådelig
inane	tåpelig
inappropriate	upassende
inappropriately	feilaktig
inarticulate	uartikulert
inattentive	uoppmerksom
inaudible	uhørlig
incautious	uforsiktig
incendiary	brannstifter
incense	røkelse
incessant	uopphørlig
incessantly	ustanselig
incite	egge
incitement	tilskyndelse
inclement	dårlig
incoherent	usammenhengende
incoherently	usammenhengende
incomparable	uforlignelige
incomparably	uforlignelig
incompatability	uforlikeligheten
incompatibility	uforlikelighet
incompatible	uforenlig
incompetence	inkompetanse
incompetent	inkompetent
incomplete	ufullstendig
incomprehensible	ubegripelig
inconceivable	utenkelig
inconceivably	ufattelig
incongruous	urimelig
inconsequential	uviktig
inconsiderate	hensynsløs
inconsistencies	uoverensstemmelser
inconsistency	inkonsekvens
inconsistent	inkonsekvent
inconsolable	utrøstelig
inconsolably	utrøstelig
inconvenience	ulempe
inconveniently	ubeleilig
incorrectly	feil
incorrigible	uforbederlig
incorrigibly	uforbederlig
incredulous	tvil
incredulously	vantro
inculcate	innprente
indecency	uanstendighet
indecent	uanstendig
indecision	ubesluttsomhet
indecisive	ubesluttsom
indefensible	uholdbar
indeterminable	ubestemmelig
indeterminate	ubestemt
indifference	likegyldighet
indifferent	likegyldig
indignant	indignert
indignantly	indignert
indignation	indignasjon
indiscreet	ubetenksom
indiscretion	indiskresjon
indiscriminate	kritikkløs
indiscriminately	ukritisk
indistinguishable	utvisket
indoctrinate	indoktrinere
indoctrination	indoktrinering
indolent	lat
indulge	hengi
ineffective	ineffektiv
ineffectively	ineffektivt
ineffectiveness	ineffektivitet
ineffectual	ørkesløshet
inefficiency	ineffektivitet
inefficient	ineffektiv
inefficiently	ineffektivt
inelegant	uelegant
inept	udugelig
inequalities	ulikheter
inequality	ulikhet
inequitable	urettferdig
inequities	ulikheter
inescapable	uunngåelig
inessential	uvesentlig
inevitable	uunngåelig
inevitably	uunngåelig
inexcusable	utilgivelig
inexorable	ubønnhørlige
inexorably	ubønnhørlig
inexperience	uerfarenhet
inexperienced	uerfaren
inexpert	ukyndig
inextricable	uløselig
inextricably	uløselig
infamous	beryktet
infamously	beryktet
infamy	skjensel
infected	infisert
infection	infeksjon
infections	infeksjoner
inferior	mindreverdig
inferiority	underlegenhet
infernal	infernalske
infest	søke
infidel	vantro
infidels	vantro
infiltrator	infiltratør
infiltrators	infiltratører
infirm	uføre
inflammation	betennelse
inflammatory	inflammatorisk
inflated	oppblåst
inflationary	inflasjons
inflexible	ubøyelig
inflict	påføre
infraction	brudd
infringe	overtre
infringement	overtredelse
infringements	overtredelser
infuriated	rasende
infuriating	rasende
inglorious	Inglorious
ingratitude	utakknemlighet
inhibit	hemme
inhibition	hemning
inhospitable	ugjestmilde
inhuman	umenneskelig
inhumanity	umenneskelighet
inimical	fiendtlig
inimically	ugunstig
iniquitous	skammelig
iniquity	urett
injure	skade
injurious	skadelig
injury	skade
injustice	urettferdighet
injustices	urettferdig
innuendo	insinuasjon
inoperable	ubrukelig
inordinate	dreven
insane	sinnsyk
insanely	sinnsykt
insanity	galskap
insatiable	umettelig
insecure	utrygg
insecurity	usikkerhet
insensible	følelsesløs
insensitive	ufølsom
insensitivity	ufølsomhet
insidious	snik
insidiously	snikende
insignificance	ubetydelighet
insignificant	ubetydelig
insignificantly	ubetydelig
insincere	uoppriktig
insincerity	oppriktighet
insinuate	insinuere
insinuating	insinuerer
insinuation	insinuasjon
insolence	frekkhet
insolent	uforskammet
insolently	uforskammet
instability	ustabilitet
instable	ustabil
instigate	iverksette
insubordinate	ulydig
insufferable	utålelig
insufficiency	insuffisiens
insufficient	utilstrekkelig
insufficiently	utilstrekkelig
insular	insulære
insult	fornærmelse
insulted	fornærmet
insulting	fornærmende
insults	fornærmelser
insurmountable	uoverstigelig
insurrection	opprør
intense	intens
interfere	forstyrre
interference	innblanding
interferes	forstyrrer
intermittent	periodisk
interrupt	avbryte
interruption	avbrudd
interruptions	avbrytelser
intimidate	skremme
intimidating	skremmende
intimidation	trusler
intolerable	uutholdelig
intolerance	intoleranse
intoxicate	beruse
intractable	intraktabel
intransigence	uforsonlighet
intrude	trenge
intrusion	inntrenging
intrusive	påtrengende
inundate	svømme
inundated	oversvømt
invader	inntrenger
invalid	ugyldig
invalidate	ugyldig
invalidity	ugyldighet
invasive	invasiv
invective	skjellsord
invisible	usynlig
involuntarily	uvilkårlig
involuntary	ufrivillig
irascible	hissige
irate	rasende
irksome	kjedsommelig
ironic	ironisk
ironically	ironisk
ironies	ironier
irony	ironi
irrational	irrasjonell
irrationality	irrasjonalitet
irrationally	irrasjonelt
irreconcilable	uforsonlig
irrecoverably	ugjenkallelig
irregular	uregelmessig
irregularity	uregelmessighet
irrelevance	irrelevans
irreparable	uopprettelig
irrepressible	ukuelig
irresolute	ubesluttsom
irresponsible	uansvarlig
irresponsibly	uansvarlig
irretrievable	uopprettelig
irritable	irritabel
irritably	irritert
irritant	irritasjons
irritate	irritere
irritated	irritert
irritating	irriterende
irritation	irritasjon
irritations	irritasjoner
isolate	isolere
isolated	isolert
isolation	isolasjon
issue	utgave
issues	problemer
itch	klø
itching	kløe
itchy	kløe
jaded	sløvet
jagged	taggete
jam	syltetøy
jarring	rystende
jaundiced	gulsott
jealous	sjalu
jealously	nidkjært
jealousy	sjalusi
jeer	håne
jeering	spott
jeopardy	fare
jerk	dust
jerky	dustete
jittery	nervøs
job-killing	jobb-drapet
jobless	arbeidsløs
joke	vits
jolt	støt
judder	hakking
juddering	flimmer
jumpy	skvetten
junk	skrot
junky	elendige
junkyard	søppelplass
jutter	Jutter
kill	drepe
killed	drept
killer	morder
killing	drap
kills	dreper
knave	knekt
knife	kniv
knock	slå
knotted	knyttede
kook	Kook
kooky	skrullete
lacked	manglet
lackey	lakei
lackeys	lakeier
lacking	mangler
lackluster	laber
lacks	mangler
laconic	lakonisk
lags	etterslep
laid-off	permitterte
lament	beklage
lamentable	beklagelig
languid	sløv
languish	vansmekte
languor	sløvhetstilstand
languorously	dovent
lanky	hengslete
lapsed	bortfalt
lapses	blundere
lascivious	vellystig
latency	ventetid
laughable	latterlig
laughably	latterlig
laughingstock	vits
lawbreaker	lovbryter
lawbreaking	lovbrudd
lawless	lovløs
lawlessness	lovløshet
layoff	Permittering
layoff-happy	Permittering-happy
lazy	lat
leak	lekke
leakage	lekkasje
leakages	lekkasjer
leaking	lekker
leaks	lekkasjer
leaky	lekk
lech	Lech
lecherous	lidderlig
leech	igle
left-leaning	venstreorienterte
lemon	sitron
lengthy	lengre
lethal	dødelig
lethargic	sløv
lethargy	apati
lewd	utuktig
lewdness	utskeielser
liability	ansvar
liable	ansvarlig
liar	løgner
liars	løgnere
licentious	utsvevende
licentiousness	tøylesløshet
lied	løy
lies	ligger
life-threatening	livstruende
lifeless	livløs
limit	grense
limitation	begrensning
limitations	begrensninger
limited	begrenset
limits	grenser
limp	halte
listless	giddeløs
litigious	saksøkende
livid	Bleik
loath	nødig
loathe	avsky
loathing	avsky
loathsome	motbydelig
loneliness	ensomhet
lonely	ensom
lonesome	ensom
longing	lengsel
longingly	lengsels
loophole	smutthull
loopholes	Smutthull
loose	løs
loot	tyvegods
lorn	Lorn
loser	taper
losers	tapere
loses	taper
loss	tap
losses	tap
lost	tapt
loud	høyt
louder	høyere
lousy	elendig
lovelorn	forlatte
lowly	ydmyk
ludicrous	latterlig
ludicrously	latterlig
lukewarm	lunken
lumpy	klumpete
lunatic	galning
lurch	stikken
lure	lokke
lurid	uhyggelig
lying	liggende
macabre	makaber
mad	gal
maddening	frustrerende
madder	sintere
madman	galning
madness	galskap
maladjustment	mistilpasning
malady	sykdom
malaise	utilpasshet
malevolent	ondskapsfull
malice	ondskapsfullhet
malicious	skadelig
maliciously	skadelig
maliciousness	ondskap
malignant	ondartet
malodorous	illeluktende
maltreatment	mishandling
mangled	lemlestede
mania	mani
maniac	galning
maniacal	maniske
manic	manisk
manipulate	manipulere
manipulation	manipulasjon
manipulative	manipulerende
manipulators	manipulatorer
marginally	marginalt
martyrdom	martyrium
martyrdom-seeking	martyrdom-søkende
mashed	most
massacre	massakre
massacres	massakrer
matte	matt
meager	mager
meaningless	meningsløs
meanness	ondskap
mediocre	middelmådig
mediocrity	middelmådighet
melancholy	melankoli
melodramatic	melodramatisk
meltdown	nedsmelting
menace	trussel
menacing	truende
menacingly	truende
mendacious	løgnaktige
mendacity	løgnaktighet
merciless	nådeløs
mercilessly	nådeløst
mess	rot
messy	rotete
midget	dverg
miff	MIFF
militancy	militante
mindless	tankeløs
mindlessly	klippe
mirage	luftspeiling
mire	myr
misaligned	forskjøvet
misbegotten	stebarn
miscalculate	feilberegner
miscalculation	feilberegninger
miscellaneous	Diverse
mischief	ugagn
mischievous	rampete
misconception	misforståelse
misconceptions	misoppfatninger
miser	gnier
miserable	elendig
miserably	stort
miseries	elendighet
miserly	gjerrige
misery	elendighet
misfit	utilpass
misfortune	ulykke
misguidance	villfarelse
misguide	villede
misguided	villedet
mishap	uhell
misinform	feilinformere
misinformed	feilinformert
misinterpret	feiltolke
misjudgment	feilvurdering
mislead	villede
misleading	villedende
misleadingly	villedende
misreading	feiltolking
misrepresent	feilrepresentere
missed	savnet
misses	målet
misstatement	feilinformasjon
mist	tåke
mistake	feil
mistaken	feil
mistakenly	feilaktig
mistakes	feil
mistress	elskerinne
mistrust	mistillit
mistrustfully	mistenk
mists	tåke
misunderstand	misforstå
misunderstanding	misforståelse
misunderstandings	misforståelser
misunderstood	misforstått
misuse	misbruk
moan	stønn
mobster	gangster
mock	håne
mocked	latterliggjort
mockery	hån
mockingly	hånlig
mocks	spotter
molest	overgripe
molestation	overgrep
monotonous	monotont
monotony	monotonien
monstrosities	uhyrer
monstrosity	uhyrlighet
monstrous	monstrøse
moody	humørsyk
morbid	sykelig
morbidly	sykelig
moribund	døende
moron	idiot
morons	idioter
mortification	mortifikasjon
mortified	forskrekket
mortify	ydmyke
motionless	ubevegelig
mournful	sørgmodig
mournfully	vemodig
muddle	rot
muddy	gjørmete
multi-polarization	multi-polarisering
mundane	dagligdagse
murder	mord
murderer	morder
murderous	morderisk
murky	skummel
muscle-flexing	muskel-flexing
mushy	bløt
musty	muggen
mysterious	mystisk
mysteriously	mystisk
mystery	mysterium
mystify	mystifisere
myth	myte
nag	maser
nagging	griner
naive	naiv
naively	naivt
narrower	smalere
nasty	ekkel
naughty	slem
nauseating	kvalm
naïve	naiv
nebulous	tåkete
needless	unødvendig
needlessly	unødvendig
needy	trengende
negate	negere
negation	negasjon
negative	negativ
negatives	negativer
negativity	negativitet
neglect	forsømmelse
neglected	forsømt
negligence	forsømmelse
negligent	forsømmelig
nepotism	nepotisme
nervous	nervøs
nervously	nervøst
nervousness	nervøsitet
nettle	brennesle
neurotic	nevrotiske
niggles	småfeil
nightmare	mareritt
nightmarish	mareritt
nitpicking	småflikking
noise	bråk
noises	lyder
noisier	støy
noisy	støyende
non-confidence	non-tillit
nonexistent	ikke-eksisterende
nonsense	tull
nosey	nysgjerrig
notorious	notorisk
notoriously	notorisk
noxious	skadelig
nuisance	plage
numb	nummen
obese	overvektige
object	gjenstand
objection	innvending
objectionable	støtende
objections	innvendinger
oblique	skrå
obliterate	utslette
obliterated	utslettet
oblivious	uvitende
obscene	obskøn
obscenely	uanstendig
obscenity	obskønitet
obscure	obskur
obscured	skjult
obscures	tilslører
obscurity	uklarhet
obsess	besette
obsessively	besatt
obsessiveness	obsessivitet
obsolete	foreldet
obstacle	hindring
obstinate	sta
obstinately	hårdnakket
obstruct	blokkere
obstructed	hindret
obstructing	hinder
obstruction	hindring
obstructs	hindrer
obtrusive	påtrengende
obtuse	stumpe
occlude	tilstoppe
occluded	okkludert
occludes	tilstopper
occluding	okkluderende
odd	merkelig
oddest	rareste
oddities	rariteter
oddity	særhet
oddly	merkelig
odor	lukt
offence	fornærmelse
offend	fornærme
offender	lovbryteren
offending	uakseptable
offenses	lovbrudd
offensive	støtende
offensively	offensivt
offensiveness	offensive
ominous	illevarslende
ominously	faretruende
omission	unnlatelse
omit	utelate
one-sided	ensidig
onerous	tyngende
opinionated	sta
opponent	motstander
opportunistic	opportunistisk
oppose	motsette
opposition	motstand
oppositions	motsetninger
oppress	undertrykke
oppression	undertrykkelse
oppressive	undertrykkende
oppressively	trykkende
oppressors	undertrykkere
ordeal	ildprøve
orphan	foreldreløs
outbreak	utbrudd
outburst	utbrudd
outbursts	utbrudd
outcast	utstøtt
outcry	ramaskrik
outlaw	fredløs
outmoded	utrangerte
outrage	raseri
outraged	rasende
outrageous	opprør
outrageously	vanvittig
over-acted	over-handlet
over-awe	over-ærefrykt
over-balanced	over-balansert
over-priced	overprisede
over-valuation	over-verdivurdering
overacted	overspilte
overbalance	balanse
overbalanced	balansert
overbearing	nedlatende
overbearingly	Bully
overdo	drive
overdone	overdrevet
overdue	forfalt
overemphasize	drive
overheat	overopphetes
overkill	kill
overloaded	belastet
overlook	overse
overpaid	betalte
overplay	play
overpower	overmakten
overpriced	priset
overrated	overvurdert
overreach	overvurder
overrun	kjørt
overshadow	skygge
oversight	forglemmelse
oversights	forglemmelser
oversimplification	forenkling
oversimplified	unyansert
oversimplify	overforenkle
oversize	size
overstate	drive
overstated	tydelig
overstatement	overdriv
overstates	overdriver
overthrow	styrte
overthrows	utslagene
overturn	velte
overweight	overvekt
overwhelm	overvelde
overwhelmed	overveldet
overwhelming	overveldende
overwhelmingly	overveldende
overwhelms	overvelder
overzealous	ivrig
pain	smerte
painful	smertefull
painfully	smertefullt
pains	smerter
pale	blek
pales	blekner
paltry	ussel
pan	panne
pander	frir
panders	småplatene
panic	panikk
panicking	panikk
panicky	panikk
paradoxical	paradoksale
paradoxically	paradoksalt
paralyzed	lammet
parasite	parasitt
pariah	paria
parody	parodi
partiality	partiskhet
partisans	partisaner
passive	passiv
passiveness	passive
pathetic	patetisk
pathetically	patetisk
patronize	nedlatende
paucity	sparsomme
pauper	fattiglem
paupers	fattiglemmer
payback	Payback
peculiar	merkelig
peculiarly	besynderlig
pedantic	pedantisk
peeled	skrellet
peevishly	grettent
penalize	straffe
penalty	straff
perfunctory	overfladisk
peril	Peril
perilous	farefull
perish	omkomme
pernicious	pernisiøs
perplex	Perplex
perplexed	rådvill
perplexing	forvirrende
perplexity	forvirring
persecute	forfølge
persecution	forfølgelse
perturb	forurolige
perturbed	opprørt
pervasive	gripende
perversion	perversjon
perversity	perversitet
pervert	pervers
perverted	pervertert
perverts	perverse
pessimism	pessimisme
pessimistic	pessimistisk
pessimistically	pessimistisk
pest	skadedyr
pestilent	pest
petrified	forsteinet
petty	smålig
phobia	fobi
phobic	fobiske
phony	falsk
picketing	vakter
pickets	spissede
picky	kresen
pig	gris
pigs	griser
pillage	plyndring
pillory	gapestokken
pimple	Kvise
pinch	klype
pitiable	ynkelig
pitiful	ynkelig
pitifully	ynkelig
pitilessly	ubarmhjertig
pittance	luselønn
pity	medlidenhet
plagiarize	plagiere
plague	pest
plasticky	plastikk
plaything	leketøy
plea	bønn
plot	plott
plotters	plottere
ploy	knep
plunder	plyndre
plunderer	plyndrer
pointless	meningsløst
poison	gift
poisonous	giftig
polarisation	polarisering
pollute	forurense
polluter	forurenseren
polluters	forurensere
polution	forurensning
pompous	pompøs
poor	dårlig
poorer	dårligere
poorest	fattigste
poorly	dårlig
posturing	posering
pout	surmule
poverty	fattigdom
powerless	maktesløs
prattle	skravling
precarious	prekær
precipitate	utfelles
precipitous	stup
predatory	rov
predicament	knipe
prejudice	fordommer
prejudices	fordommer
prejudicial	skadelig
premeditated	lagt
preposterous	absurd
presumptuous	arrogant
presumptuously	dristet
pretence	påskudd
pretense	påskudd
pretentious	pretensiøs
pricey	kostbar
pricier	dyrere
prick	stikk
prickle	pigg
prickles	pigger
prideful	stolt
primitive	primitiv
prison	fengsel
prisoner	fange
problematic	problema
problems	problemer
procrastinate	utsette
procrastination	utsettelse
profanity	banning
prohibit	forby
prohibitive	uoverkommelige
prohibitively	uoverkommelig
propagandize	propagandere
proprietary	proprietær
prosecute	tiltale
protested	protest
protesting	protesterer
protests	protester
protracted	langvarig
provocation	provokasjon
provocative	provoserende
provoke	provosere
pry	lirke
pugnacious	strid
pugnaciously	stridslysten
punch	punsj
punish	straffe
punishable	straffes
punitive	straff
puny	ynkelig
puppet	dukketeater
puppets	marion
puzzled	rådvill
puzzlement	puzzle
puzzling	gåtefullt
quack	kvakk
qualms	betenkeligheter
quandary	dilemma
quarrel	krangle
quarrels	krangler
quarrelsome	kranglevoren
quash	oppheve
questionable	tvilsom
quibble	uenighet
quibbles	småplukk
rabid	rabiat
racism	Rasisme
racist	rasist
racists	rasister
radical	radikal
radicalization	radikalisering
radically	radikalt
radicals	radikaler
rage	raseri
ragged	fillete
raging	rasende
rail	skinne
raked	raket
rampant	tøylesløs
ramshackle	falleferdig
randomly	tilfeldig
rankle	nage
rant	tirade
rape	voldtekt
raped	voldtatt
raping	voldta
rascal	rakker
rash	utslett
rattle	skrangle
rattled	raslet
rattles	rangler
ravage	herje
reactionary	reaksjonær
rebellious	opprørsk
rebuff	avslag
rebuke	irettesettelse
recalcitrant	trassig
recession	resesjon
reckless	uforsvarlig
recklessly	uvørent
recklessness	hensynsløshet
recoil	rekyl
recourses	resurser
redundancy	overflødighet
redundant	overflødig
refusal	avslag
refuse	nekte
refused	nektet
refuses	nekter
refusing	nekter
refutation	imøtegåelse
refute	tilbakevise
refuted	tilbakevist
refutes	forkaster
refuting	motsier
regression	regresjon
regret	angre
regretful	angrende
regretfully	beklagende
regrets	angrer
regrettable	beklagelig
regrettably	beklageligvis
regretted	angret
reject	avvise
rejected	avvist
rejecting	avvise
rejection	avvisning
rejects	avviser
relapse	tilbakefall
relentless	nådeløse
relentlessly	ubønnhørlig
reluctance	motvilje
reluctant	motvillige
reluctantly	motvillig
remorse	samvittighetsnag
remorseful	angrende
remorsefully	anger
remorseless	ubarmhjertige
renunciation	forsakelse
repetitive	repeterende
reprehensible	forkastelig
reprehensibly	klanderverdig
repress	undertrykke
repression	undertrykkelse
repressive	undertrykkende
reprimand	reprimande
reproach	bebreidelse
reproachful	bebreidende
reprove	refs
reprovingly	bebreidende
repudiate	forkaste
repugnance	motvilje
repugnant	frastøtende
repulse	Repulse
repulsed	frastøtt
repulsing	avvisende
repulsive	frastøtende
resent	mislike
resentful	ergerlig
resentment	harme
resignation	oppsigelse
resistance	motstand
restless	rastløs
restlessness	rastløshet
restrict	begrense
restricted	begrenset
restriction	begrensning
restrictive	restriktiv
resurgent	gjenoppvåknende
retaliate	gjengjelde
retaliatory	gjengjeldelses
retard	tilbakestående
retarded	tilbakestående
reticent	tilbakeholden
retreat	retrett
revenge	hevn
revengeful	hevngjerrig
revengefully	hevn
revert	tilbake
revile	spotter
reviled	utskjelt
revoke	tilbakekalle
revolt	opprør
revolting	frastøtende
revulsion	avsky
rhetoric	retorisk
rhetorical	retorisk
ridicule	latterlig
ridicules	latterliggjør
ridiculous	latterlig
ridiculously	latterlig
rife	florerer
rifts	rifter
rigid	ubøyelig
rigidity	stivhet
riled	hisset
rip-off	svindel
ripoff	svindel
ripped	dratt
risk	Fare
risks	risikoer
risky	risikabelt
rivalry	rivalisering
roadblocks	veisperringer
rocky	steinete
rollercoaster	Berg-og-dal-bane
rot	råtne
rotten	råtten
rough	ujevn
rubbish	søppel
rude	uhøflig
ruffian	bølle
ruined	ruinert
ruining	ødelegger
ruinous	ødeleggende
ruins	ruiner
rumbling	buldrende
rumor	rykte
rumors	rykter
rumours	rykter
rupture	ruptur
rusts	ruster
rusty	rusten
rut	brunst
ruthless	hensynsløs
ruthlessly	hensynsløst
ruthlessness	hensynsløshet
ruts	hjulspor
sabotage	sabotasje
sack	sekk
sacrificed	ofret
sadden	bedrøvet
sadly	dessverre
sadness	tristhet
sagged	sigende
salacious	slibrig
sanctimonious	skinnhellig
sap	sevje
sarcasm	sarkasme
sarcastic	sarkastisk
sarcastically	spydig
sardonic	sardonisk
satirical	satirisk
savage	villmann
savagery	villskap
savages	villmenn
scaly	skjell
scam	svindel
scams	svindel
scandal	skandale
scandalize	forarge
scandalized	forarget
scandalous	skandaløs
scandalously	skandaløst
scandals	skandalene
scandel	Scandel
scant	snaut
scapegoat	syndebukk
scar	arr
scarce	knapp
scarcely	knapt
scarcity	knapphet
scare	skremme
scared	redd
scarier	skremmende
scariest	skumleste
scarily	skremmende
scarred	merket
scars	arr
scary	skummelt
scathing	bitende
sceptical	skeptisk
scoff	spotter
scold	skjenne
scolded	skjente
scolding	skjenn
scorching	glohet
scorn	forakt
scornful	hånlig
scornfully	hånlig
scoundrel	kjeltring
scourge	svøpe
scowl	skuler
scrambled	egge
scrambles	forvrenges
scrap	skrap
scratch	ripe
scratched	riper
scratches	riper
scratchy	skrapete
scream	hyle
screech	hvin
screwed	skrudd
screwed-up	feilet
scuffs	skraper
scum	avskum
second-tier	sekund-lags
secretive	hemmelighetsfull
sedentary	stillesittende
seedy	lurvete
seethe	syde
seething	sydende
self-coup	self-kuppet
self-criticism	selvkritikk
self-defeating	selvødeleggende
self-destructive	selvdestruktiv
self-humiliation	self-ydmykelse
self-interest	egeninteresse
self-interested	egeninteresse
self-serving	egoistiske
selfish	selvopptatt
selfishly	egoistisk
selfishness	egoisme
semi-retarded	semi-tilbakestående
senile	senil
senseless	meningsløs
seriousness	alvoret
servitude	trelldom
setback	tilbakeslag
setbacks	tilbakeslag
severe	alvorlig
severity	alvorlighetsgrad
shabby	loslitt
shadowy	skygge
shady	skygge
shake	riste
shaky	skjelvende
shallow	grunt
shame	skam
shameful	skammelig
shamefully	skammelig
shamefulness	skam
shameless	skamløs
shamelessly	skamløst
shamelessness	skamløshet
shark	hai
sharply	skarpt
shatter	knuse
shipwreck	skipsvrak
shirk	skulke
shit	dritt
shiver	skjelve
shock	sjokk
shocked	sjokkert
shocking	sjokkerende
shockingly	sjokkerende
short-lived	Kortlevd
shortage	mangel
shortcoming	brist
shortcomings	mangler
shortness	kortpustethet
shortsighted	kortsiktig
shortsightedness	nærsynthet
shrew	spissmus
shriek	skrik
shrill	skingrende
shrivel	skrumpe
shroud	liksvøpet
shrouded	innhyllet
shrug	skuldertrekk
shunned	skydd
sick	syk
sicken	kvalm
sickening	kvalm
sickly	sykelig
sickness	sykdom
sidetrack	sidesteg
sidetracked	avsporet
siege	beleiring
silly	dum
simplistic	forenklede
sin	synd
sinful	syndig
sinfully	syndig
sinister	skummel
sink	synke
sinking	synker
skeletons	skjeletter
skeptic	skeptiker
skeptical	skeptisk
skepticism	skepsis
sketchy	tvilsom
skimpy	snau
skinny	mager
slack	slakk
slander	bakvaskelse
slanderer	baktaler
slanderous	ærekrenkende
slanderously	spottes
slanders	bakvaskelser
slap	dask
slaughter	slakte
slaughtered	slaktet
slaves	slaver
slime	slim
slogged	traska
sloppily	slurvete
sloppy	slurvet
sloth	dovendyr
slothful	late
slow	langsom
slow-moving	saktegående
slowed	bremset
slower	tregere
slowest	langsomste
slowly	sakte
sluggish	treg
slump	nedgangen
slur	Nedsmelting
slut	ludder
smash	knuse
smear	smøre
smell	lukt
smelled	luktet
smelling	lukt
smells	lukter
smelly	stinkende
smoke	røyk
smokescreen	røykteppe
smolder	ulme
smoldering	ulmende
smother	kvele
smoulder	ulme
smouldering	ulmende
smudged	flekkete
smudges	flekker
smudging	flekker
smug	selvgode
smugly	tilfreds
smut	sote
smutty	Sotet
snag	ulempe
snare	skarptromme
snarky	spydig
snarl	snerr
sneak	snike
sneaky	sleipe
sneer	flir
sneering	flirte
snob	snobb
snobbish	snobbete
snobby	snobbete
snobs	snobbene
soapy	såpe
sob	hulke
sober	edru
sobering	tankevekkende
solemn	høytidelig
solicitude	omsorg
somber	sturen
sore	sår
sorely	sårt
soreness	sårhet
sorrow	sorg
sorrowful	sorgfull
sorrowfully	sorrow
sorry	Beklager
sour	sur
spank	slå
spew	spy
spewed	spydd
spewing	spyr
spilling	søle
spiritless	spirit
spiteful	ondskapsfull
split	dele
spoilage	forringende
spoiled	bortskjemte
spook	Spook
spooky	skummelt
spoon-fed	skje-matet
spoon-feed	skje-mate
sporadic	sporadisk
spotty	flekkete
spurious	falsk
sputter	frese
squabble	kjekle
squabbling	krangle
squander	sløse
squeak	knirker
squeaks	knirking
squeal	hyle
squealing	angiveri
squirm	vri
stab	stikke
stagnant	stillestående
stagnate	stagnere
stagnation	stagnasjon
staid	trauste
stain	flekk
stains	flekker
stale	Ståle
stalls	boder
stammer	stamme
stampede	panikk
standstill	stillstand
startle	skremme
startling	oppsiktsvekkende
startlingly	forbausende
starvation	sult
starve	sulte
static	statisk
steal	stjele
stealing	stjele
steals	stjeler
steep	bratt
steeply	bratt
stench	stank
stereotypical	stereotype
stern	Stern
stew	lapskaus
sticky	klissete
stiff	stiv
stiffness	stivhet
stifle	kvele
stifling	kvelende
stigmatize	stigmatisere
sting	stikke
stingy	stikkende
stink	stinke
stinks	stinker
stodgy	kjedelig
stole	stjal
stolen	stjålet
stormy	storm-
straggler	nøler
strain	press
strained	anstrengt
straining	anstreng
strange	rar
strangely	merkelig
stranger	fremmed
strangest	rareste
strangle	kvele
streaky	stripete
strenuous	anstrengende
stress	understreke
stresses	påkjenninger
stressful	stress
stressfully	stress
stricken	slått
strict	streng
strictly	strengt
strident	skingrende
strife	stridigheter
strike	streik
stringent	strengere
stringently	strengt
struck	rammet
struggle	streve
struggled	slet
struggles	kamper
struggling	sliter
strut	spankulere
stubborn	sta
stubbornly	sta
stubbornness	stahet
stuffy	trykkende
stumble	snuble
stumbled	snublet
stumbles	snubler
stump	stubbe
stumped	stabbet
stumps	stubber
stun	velde
stunted	forkrøplet
stupid	dum
stupidest	dummeste
stupidity	dumhet
stupidly	idiotisk
stupify	Stupify
stutter	stamme
stuttered	stotret
stuttering	stamming
stutters	stamming
sty	svinesti
stymied	hindret
sub-par	underordnet
subdued	dempet
subjected	kastet
subjection	under
subjugate	underkue
subjugation	undertrykkelse
submissive	underdanig
subordinate	underordnet
subpoena	stevning
subpoenas	stevninger
subservience	underdanighet
subservient	servil
subversive	undergravende
subvert	grave
succumb	bukke
suck	suge
sucked	sugd
sucks	suger
sue	saksøke
sued	saksøkt
sues	Sues
suffer	lide
suffered	LED
sufferer	lidende
sufferers	lider
suffering	lidelse
suffers	lider
suffocate	kveles
sugar-coat	sukker-coat
suicide	selvmord
sullen	mutt
sunk	senket
sunken	sunket
superficial	overfladisk
superficiality	overfladiskhet
superficially	overfladisk
superfluous	overflødig
superstition	overtro
superstitious	overtroisk
suppress	undertrykke
suppression	undertrykkelse
surrender	overgivelse
susceptible	utsatt
suspect	mistenkt
suspicion	mistanke
suspicions	mistanker
suspicious	mistenkelig
suspiciously	mistenksomt
swagger	sprade
swamped	belastet
sweaty	svett
swelled	svulmet
swelling	opphovning
swindle	svindle
swollen	hoven
symptoms	symptomer
syndrome	syndrom
taboo	tabu
tacky	klebrig
taint	plett
tainted	skjemt
tamper	tukle
tangle	floke
tangled	flokete
tangles	floker
tanked	tanket
tanks	tanker
tantrum	raserianfall
tardy	sen
tarnish	anløpe
tarnished	anløpet
tarnishes	oksiderer
tarnishing	misfarging
tattered	fillete
taunt	spydighet
taunting	spotter
tauntingly	ertende
taunts	erta
taut	stram
tawdry	glorete
tease	plage
teasingly	ertende
tedious	langtekkelig
tediously	ordinært
temper	temperament
tempest	uvær
temptation	fristelse
tenderness	ømhet
tense	anspent
tension	spenning
tentatively	forsøksvis
tenuous	tynn
tepid	lunken
terrible	fryktelig
terribly	fryktelig
terror	skrekk
terror-genic	terror-lende
terrorism	terrorisme
terrorize	terror
testy	Amper
thankless	utakknemlig
thicker	tykkere
thirst	tørst
thorny	tornete
thoughtless	tankeløs
thoughtlessly	tanke
thoughtlessness	tankeløshet
thrash	søppel
threat	trussel
threaten	true
threatening	truende
threats	trusler
threesome	trekant
throb	banke
throbbing	bankende
throttle	Gasspedal
thug	bølle
thwart	hindre
time-consuming	tidkrevende
timid	sjenert
timidity	fryktsomhet
timidly	forsagt
tin-y	tinn-y
tingled	kriblet
tingling	prikking
tired	trett
tiresome	slitsom
tiring	slitsomt
toil	slit
top-heavy	topptung
topple	velte
torment	pine
tormented	pines
tortuous	kronglete
torture	tortur
tortured	torturert
tortures	tortur
torturing	torturere
totalitarian	totalitær
touchy	nærtagende
toughness	seighet
touted	spioner
toxic	giftig
tragedy	tragedie
tragic	tragisk
tragically	tragisk
traitor	forræder
traitorous	forræderiske
tramp	landstryker
trample	tråkke
transgress	overtre
transgression	overtredelse
trap	felle
trapped	fanget
trash	søppel
trashed	kastet
trauma	traume
traumatic	traumatisk
traumatically	traumatisk
traumatize	traumatisere
traumatized	traumatisert
travesty	parodi
treacherous	forrædersk
treachery	forræderi
treason	forræderi
treasonous	forræderisk
trick	triks
tricked	lurt
trickery	lureri
tricky	vanskelig
trivial	triviell
trivialize	bagatell
trouble	problemer
troubled	urolig
troublemaker	bråkmaker
troubles	problemer
troublesome	plagsom
troubling	problema
truant	skulker
tumble	tørkes
tumbled	ramlet
tumultuous	stormende
turmoil	kaos
twist	vri
twisted	vridd
twists	vendinger
tyrannical	tyranniske
tyrannically	tyrannisk
tyranny	tyranni
tyrant	tyrann
uglier	styggere
ugliest	styggeste
ugliness	stygghet
ugly	stygg
ulterior	bakenforliggende
ultimatums	ultimatum
ultra-hardline	ultra-hardere
un-viewable	un-synlig
unacceptable	uakseptabelt
unacceptably	uakseptabelt
unaccustomed	uvant
unachievable	uoppnåelig
unaffordable	uoverkommelig
unattractive	uattraktiv
unavailable	utilgjengelig
unavoidably	uunngåelig
unbearable	uutholdelig
unbelievably	utrolig
uncertain	usikker
uncivilized	usiviliserte
unclean	urent
unclear	uklar
uncollectible	usikrede
uncomfortable	ubehagelig
uncomfortably	ubehagelig
uncomfy	ukomfortabelt
uncompetitive	Jaguaren
uncompromising	kompromissløs
uncompromisingly	kompromissløst
unconfirmed	ubekreftet
unconstitutional	grunnlovsstridig
uncontrolled	ukontrollert
unconvincing	bevis
uncouth	klossete
undecided	usikre
undefined	udefinert
undependable	upålitelig
undercut	underskåret
undercuts	undersnitt
undercutting	stammen
underestimate	undervurder
underlings	undersåtter
undermine	undergrave
undermined	undergraves
undermines	undergraver
undermining	undergrave
underpaid	underbetalt
undersized	underdimensjonert
undesirable	uønsket
undetermined	ubestemt
undid	Angret
undignified	uverdig
undissolved	uoppløst
undocumented	udokumentert
undone	ugjort
undue	utilbørlig
unease	uro
uneasiness	uro
uneasy	urolig
uneconomical	uøkonomisk
unemployed	arbeidsledig
unequal	ulik
unethical	uetisk
uneven	ujevn
uneventful	begivenhetsløs
unexpected	uventet
unexpectedly	uventet
unexplained	uforklarlig
unfairly	urettferdig
unfaithful	utro
unfaithfully	troløst
unfamiliar	ukjent
unfavorable	ugunstig
unfeeling	ufølsom
unfinished	uferdig
unfit	uegnet
unforeseen	uforutsett
unforgiving	uforsonlig
unfortunate	uheldig
unfortunately	dessverre
unfounded	ubegrunnet
unfriendly	uvennlig
unfulfilled	oppfylt
unfunded	udekkede
ungrateful	utakknemlig
unhappily	ulykkelig
unhappiness	ulykkelighet
unhappy	ulykkelig
unhealthy	usunn
unhelpful	uhjelpsom
unilateralism	unilateralisme
unimaginable	utenkelig
unimaginably	ufattelig
unimportant	uviktig
uninformed	uinformert
uninsured	uforsikret
unintelligible	uforståelig
unjust	urettferdig
unjustifiable	utilbørlig
unjustifiably	uberettiget
unjustified	grunnløs
unjustly	urettferdig
unkind	uvennlig
unkindly	uvennlig
unknown	ukjent
unlawful	ulovlig
unlawfully	ulovlig
unleash	frigjøre
unlicensed	ulisensiert
unlucky	uheldig
unmoved	uanfektet
unnatural	unaturlig
unnaturally	unaturlig
unnecessary	unødvendig
unneeded	unødvendige
unnerved	motløs
unnerving	nervepirrende
unnoticed	ubemerket
unorthodox	uortodokse
unpleasant	ubehagelig
unpopular	upopulær
unpredictable	uforutsigbar
unprepared	uforberedt
unproductive	uproduktive
unprofitable	ulønnsom
unproven	uprøvd
unqualified	ukvalifisert
unravel	rakne
unraveled	avslørt
unreadable	uleselig
unrealistic	urealistisk
unreasonable	urimelig
unreasonably	urimelig
unrelenting	nådeløs
unreliability	upålitelighet
unreliable	upålitelig
unresolved	uløst
unrest	uro
unruly	uregjerlig
unsafe	usikre
unsatisfactory	utilfredsstillende
unsavory	usmakelig
unscrupulous	samvittighetsløs
unscrupulously	hensynsløst
unsecure	usikker
unseemly	usømmelig
unsettle	rokke
unsettled	uoppgjorte
unsettling	forstyrrende
unskilled	ufaglært
unsophisticated	usofistikert
unsound	uholdbar
unspeakable	usigelige
unspecified	uspesifisert
unstable	ustabil
unsteadily	ustøtt
unsteadiness	ustøhet
unsteady	ustødig
unsuccessful	mislykket
unsupported	støttes
unsure	usikker
unsuspecting	intetanende
untenable	uholdbar
untested	utestet
unthinkable	utenkelig
unthinkably	utenkelig
untimely	utidige
untouched	urørt
untrue	usann
untrustworthy	upålitelige
untruthful	usann
unusable	ubrukelig
unuseable	ubrukelig
unusual	uvanlig
unusually	used
unwanted	uønsket
unwarranted	uberettiget
unwelcome	uvel
unwell	uvel
unwieldy	uhåndterlig
unwilling	uvillig
unwillingly	uvillig
unwillingness	uvilje
unwise	uklokt
unwisely	uklokt
unworkable	ubrukelig
unworthy	uverdig
unyielding	urokkelig
upbraid	refse
upheaval	omveltning
uprising	oppstand
uproar	opprør
uproot	rykke
upset	urolig
upsets	besvær
useless	ubrukelig
usurp	tilrive
utterly	fullstendig
vague	uklar
vagueness	vaghet
vain	forfengelig
vanity	forfengelighet
vehement	heftig
vehemently	heftig
vengeance	hevn
vengeful	hevngjerrig
venom	giften
venomous	giftig
vestiges	rester
vexation	ergrelse
vibrate	vibrere
vibrated	vibrerte
vibrates	vibrerer
vibrating	vibrerende
vibration	vibrasjon
vicious	ond
viciousness	vicious
victimize	bedra
vile	sjofel
vileness	gemenskapen
vilify	bakvaske
villainous	onde
villains	skurker
villian	skurk
vindictive	hevngjerrig
vindictively	hevngjerrig
violate	bryte
violation	brudd
violator	overtrederen
violators	overtredere
violent	voldelig
violently	voldelig
virulence	virulens
virulent	virulente
vociferous	høyrøstet
volatile	flyktige
volatility	volatilitet
vomited	spydde
vomiting	oppkast
vulgar	vulgær
vulnerable	sårbar
wail	jamre
wane	blekne
waning	avtagende
wanton	vilter
war-like	krigslignende
warily	varsomt
warlike	krigersk
warned	advart
warning	advarsel
warp	varp
warped	skjev
wary	skeptisk
waste	Avfall
wasteful	uøkonomisk
wasting	sløse
water-down	vann-ned
wayward	sindig
weak	svak
weaken	svekke
weakening	svekkelse
weaker	svakere
weakness	svakhet
weaknesses	svakheter
weariness	tretthet
weary	trett
wedge	kile
weed	ugress
weep	gråte
weird	merkelig
weirdly	nifs
whimper	klynk
whine	klynke
whining	klynking
whips	pisker
whore	hore
whores	horer
wicked	ond
wickedly	ugudelig
wickedness	ondskap
wild	vill
wildly	vilt
wily	snedig
wimpy	pysete
wince	krympe
wobble	vingle
wobbled	vaklet
woe	ve
woeful	sørgelig
woefully	sørgelig
womanizer	skjørtejeger
worn	slitt
worried	bekymret
worries	bekymringer
worrisome	bekymringsfull
worry	bekymre
worrying	bekymrings
worryingly	bekymringsfullt
worse	verre
worsen	forverre
worsening	forverring
worst	verst
worthless	verdiløs
worthlessness	verdiløshet
wound	sår
wounds	sår
wrangle	krangle
wrath	vrede
wreak	vrak
wreck	vraket
wrest	fravriste
wrestle	bryte
wretch	stakkar
wretched	elendig
wretchedly	usselt
wretchedness	elendighet
wrinkle	rynke
wrinkled	rynkete
wrinkles	rynker
wrong	feil
wrongful	urettmessig
wrongly	feil
wrought	smidd
yawn	gjesp
zealot	fanatiker
zealous	nidkjær
