abounds	vimlar
abundance	överflöd
abundant	riklig
accessable	uppsättningar
accessible	tillgänglig
acclaim	hylla
acclaimed	hyllade
acclamation	acklamation
accolades	hyllningar
accommodative	ackommoderande
accomplish	utföra
accomplished	skicklig
accomplishment	prestation
accomplishments	prestationer
accurate	exakt
accurately	exakt
achievable	uppnåe
achievement	prestation
achievements	prestationer
acumen	mannaskap
adaptable	anpassbar
adaptive	adaptiv
adequate	tillräcklig
adjustable	justerbar
admirable	beundransvärd
admirably	föredömligt
admiration	beundran
admire	beundra
admirer	beundrare
admiring	beundrande
adorable	förtjusande
adore	älska
adored	ädla
adorer	tillbedjare
adoring	beundrande
adroit	skicklig
adroitly	skickligt
adulatory	smickrande
advanced	Avancerad
advantage	fördel
advantageous	fördelaktig
advantageously	fördel
advantages	fördelar
adventuresome	adventure
adventurous	äventyrlig
advocate	förespråkare
advocated	förespråkade
advocates	förespråkar
affability	vänlighet
affable	förbindlig
affably	förbindligt
affectation	tillgjordhet
affection	tillgivenhet
affectionate	öm
affinity	affinitet
affirm	bekräfta
affirmation	bekräftelse
affirmative	korrekt
affluence	välstånd
affluent	rik
afford	råd
affordable	prisvärd
agile	vig
agilely	vigt
agility	rörlighet
agreeable	angenäm
agreeableness	behag
agreeably	angenämt
alluring	lockande
alluringly	lockande
altruistic	altruistisk
altruistically	altruistiskt
amaze	förvåna
amazed	förvånad
amazement	häpnad
amazes	förvånar
amazing	fantastiskt
amazingly	otroligt
ambitious	ambitiös
ameliorate	förbättra
amenable	mottaglig
amenity	facilitet
amiability	älskvärdhet
amiable	älskvärd
amicability	VÄNSKAPLIGHET
amicable	vänskaplig
amity	vänskap
ample	riklig
amply	rikligt
amuse	roa
amusing	rolig
amusingly	roande
angel	ängel
angelic	änglalik
apotheosis	apoteos
appeal	överklagande
appealing	lockande
applaud	applådera
appreciable	märkbar
appreciate	uppskatta
appreciated	uppskattad
appreciates	uppskattar
appreciative	uppskattande
appreciatively	uppskattande
appropriate	lämplig
approval	godkännande
approve	godkänna
ardent	ivrig
ardently	ivrigt
ardor	glöd
articulate	artikulera
aspiration	strävan
aspirations	strävanden
aspire	sträva
assurance	försäkran
assurances	försäkringar
assure	försäkra
assuredly	förvisso
assuring	säkerställa
astonish	förvåna
astonished	förvånad
astonishing	förvånande
astonishingly	förvånansvärt
astonishment	förvåning
astounded	förbluffad
astounding	förvånande
astoundingly	förbluffande
attentive	uppmärksam
attraction	attraktion
attractive	attraktiv
attractively	attraktivt
attune	tona
audible	hörbar
audibly	hörbart
auspicious	gynnsam
authentic	äkta
authoritative	auktoritativ
autonomous	autonom
available	tillgängliga
avid	ivrig
award	tilldela
awarded	tilldelats
awards	utmärkelser
awe	vördnad
awesomeness	häftighet
backbone	ryggrad
balanced	balanserad
bargain	förhandla
beautiful	skön
beautifully	vackert
beautify	försköna
beauty	skönhet
beckons	lockar
believable	trovärdig
beloved	älskad
benefactor	välgörare
beneficent	välgörande
beneficial	välgörande
beneficially	fördel
beneficiary	förmånstagare
benefits	fördelar
benevolence	välvilja
benevolent	välvillig
benifits	Fördelar
best	bäst
best-selling	bästsäljare
better	bättre
blameless	oskyldig
bless	välsigna
blessing	välsignelse
bliss	salighet
blissful	lycksalig
blissfully	lyckligt
blithe	munter
bloom	blomma
blossom	blomma
bolster	stödja
bonuses	bonus
boom	bom
booming	blomstrande
boost	lyft
boundless	gränslös
bountiful	riklig
brainiest	smartast
brainy	begåvad
brave	modig
bravery	mod
breakthrough	genombrott
breakthroughs	genombrott
breathlessness	andfåddhet
breathtaking	hisnande
breathtakingly	ringade
breeze	bris
bright	ljus
brighten	ljusna
brighter	ljusare
brightest	ljusaste
brilliance	briljans
brilliant	lysande
brilliantly	briljant
brisk	rask
brotherly	broderlig
bullish	hausse
buoyant	flytande
calm	lugna
calming	lugnande
calmness	stillhet
capability	förmåga
capable	kapabel
capably	DUGLIGT
captivate	fängsla
captivating	fängslande
carefree	sorglös
celebrate	fira
celebrated	berömd
celebration	firande
celebratory	högtidlig
champ	mästare
champion	mästare
charisma	karisma
charismatic	karismatiska
charitable	välgörande
charming	charmig
charmingly	greenen
chaste	kysk
cheaper	billigare
cheapest	billigaste
cheerful	glad
cheery	glad
cherish	vårda
cherished	omhuldade
cherub	kerub
chivalrous	ridderlig
chivalry	ridderlighet
civility	hövlighet
civilize	civilisera
clarity	klarhet
classic	klassisk
classy	flott
clean	rena
cleaner	rengöringsmedel
cleanest	renaste
cleanliness	renlighet
cleanly	rent
clear	klar
clear-cut	entydig
cleared	rensas
clearer	klarare
clearly	klart
clears	rensar
clever	duktig
cleverly	skickligt
cohere	Cohere
coherence	sammanhang
coherent	sammanhängande
cohesive	sammanhängande
colorful	färgrik
comfort	bekvämlighet
comfortable	bekväm
comfortably	bekvämt
comforting	tröstande
comfy	bekväm
commend	berömma
commendable	beröm
commendably	förtjänst
commitment	engagemang
commodious	rymlig
compact	kompakt
compactly	kompakt
compassion	medlidande
compassionate	medlidsam
compatible	kompatibel
competitive	konkurrenskraftig
complement	komplement
complementary	komplementär
complemented	kompletteras
complements	komplement
compliant	kompatibel
compliment	komplimang
complimentary	kostnadsfri
comprehensive	omfattande
conciliate	blidka
conciliatory	försonlig
concise	koncis
confidence	förtroende
confident	självsäker
congenial	sympatisk
congratulate	gratulera
congratulation	lyckönskan
congratulations	Grattis
congratulatory	gratulations
conscientious	samvetsgrann
considerate	omtänksam
consistent	konsekvent
consistently	konsekvent
constructive	konstruktiv
consummate	fullborda
contentment	belåtenhet
continuity	kontinuitet
contribution	bidrag
convenience	bekvämlighet
convenient	bekväm
conveniently	bekvämt
convienient	Good
convincing	övertygande
convincingly	övertygande
cool	Häftigt
coolest	kallast
cooperative	kooperativ
cooperatively	samverkande
cornerstone	hörnsten
correct	korrekt
correctly	korrekt
cost-effective	kostnadseffektiv
cost-saving	kostnadsbesparing
counter-attack	motattack
counter-attacks	motattacker
courage	mod
courageous	modig
courageously	modigt
courteous	artig
courtly	hövisk
covenant	förbund
cozy	mysigt
creative	kreativ
credence	tilltro
credible	trovärdig
crisp	knaprig
crisper	skarpare
cure	bota
cure-all	UNIVERSALMEDEL
cute	söt
danken	Danken
daring	vågad
darling	Älskling
dashing	käck
dauntless	oförfärad
dawn	gryning
dazzle	blända
dazzled	bländas
dazzling	bländande
decency	anständighet
decent	anständig
decisive	avgörande
decisiveness	beslutsamhet
dedicated	tillägnad
defeat	nederlag
defeated	besegras
defeating	besegra
defeats	förluster
defender	försvarare
deference	aktning
deft	skicklig
delectable	ljuvlig
delicacy	delikatess
delicate	delikat
delicious	utsökt
delight	glädje
delighted	förtjust
delightful	härlig
delightfully	härligt
dependable	pålitlig
dependably	pålitligt
deservedly	välförtjänt
deserving	förtjänar
desirable	önskvärd
desiring	önskar
desirous	lysten
destiny	Öde
detachable	avtagbar
devout	from
dexterous	skicklig
dignified	värdig
dignify	hedra
dignity	värdighet
diligence	flit
diligent	flitig
diligently	flitigt
diplomatic	diplomatisk
distinction	åtskillnad
distinctive	särskiljande
distinguished	distingerad
diversified	diversifierad
divine	gudomlig
divinely	gudom
dominate	dominera
dominated	dominerade
dominates	dominerar
dreamland	drömland
dumbfounded	förstummad
dummy-proof	dummy-bevis
durable	hållbar
dynamic	dynamisk
eager	ivrig
eagerly	ivrigt
eagerness	iver
earnest	allvarlig
earnestly	ärligt
earnestness	allvar
ease	lätthet
eased	lättade
eases	lättar
easier	lättare
easiest	enklaste
easiness	lätthet
easy	lätt
easygoing	Lättsam
ebullient	sprudlande
economical	ekonomisk
ecstasies	extaser
ecstasy	extas
ecstatic	extatisk
edify	uppbygga
educated	utbildad
effective	effektiv
effectively	effektivt
effectiveness	effektivitet
effectual	verkningsfull
efficacious	effektiv
efficient	effektiv
efficiently	effektivt
effortless	enkel
effortlessly	ansträngning
effusion	utgjutning
effusive	svallande
effusiveness	kryperi
elated	upprymd
elation	upprymdhet
electrify	elektrifiera
elegance	elegans
elegantly	elegant
elevate	upphöja
elite	elit
eloquence	vältalighet
eloquent	vältalig
eminence	höjd
empathy	empati
empower	bemyndiga
empowerment	bemyndigande
enchant	tjusa
enchanted	förtrollad
enchanting	förtjusande
encourage	uppmuntra
encouragement	uppmuntran
encouraging	uppmuntrande
encouragingly	uppmuntrande
endearing	älskvärd
endorse	stödja
endorsed	godkändes
endorsement	godkännande
endorses	Endorses
endorsing	godkänna
energetic	energisk
energy-efficient	energieffektiva
engaging	engagerande
engrossing	fängslande
enhance	förbättra
enhanced	förbättrad
enhancement	förbättring
enhances	förbättrar
enjoyable	trevlig
enjoyed	åtnjöt
enjoying	njuter
enjoyment	njutning
enjoys	åtnjuter
enlighten	upplysa
enlightenment	upplysning
ennoble	förädla
enough	tillräckligt
enrapture	HÄNFÖRA
enraptured	hänförd
enrich	berika
enrichment	berikning
enterprising	företagsam
entertain	underhålla
entertaining	underhållande
entertains	roar
enthral	fängsla
enthrall	fängsla
enthralled	trollbundit
enthuse	entusiasmera
enthusiasm	entusiasm
enthusiast	entusiast
enthusiastic	entusiastisk
enthusiastically	entusiastiskt
entice	locka
enticed	lockas
enticing	lockande
entranced	hänförd
entrust	anförtro
enviable	avundsvärd
envious	avundsjuk
enviously	avundsjukt
envy	avundas
equitable	rättvis
ergonomical	ergonomisk
err-free	fela-fri
erudite	lärd
ethical	etisk
eulogize	lovprisa
euphoria	eufori
euphoric	euforisk
euphorically	euforiskt
evaluative	evaluerande
evenly	jämnt
eventful	händelserikt
everlasting	evighet
evocative	suggestiva
exalt	upphöja
exaltation	upphöjelse
exalted	upphöjd
exalting	upphöjer
examplary	exemplifierande
exceed	överstiga
exceeded	överskridits
exceeding	överstiger
exceedingly	ytterst
exceeds	överstiger
excelent	Thanks
excellant	would
excelled	utmärkte
excellence	förträfflighet
excellency	excellens
excellently	utmärkt
excels	utmärker
exceptional	exceptionell
exceptionally	exceptionellt
excite	excitera
excited	upphetsad
excitedly	ivrigt
excitement	spänning
excites	exciterar
exciting	spännande
excitingly	spännande
exemplary	exemplarisk
exhilarating	uppiggande
exhilaration	upprymdhet
exonerate	befria
expansive	expansiv
expeditiously	snabbt
expertly	kunnigt
exquisite	utsökt
exquisitely	utsökt
extol	prisa
extraordinarily	utomordentligt
exuberance	överflöd
exuberant	sprudlande
exuberantly	översvallande
exult	jubla
exultant	jublande
exultation	jubel
eye-catch	eye-fångst
eye-catching	iögonfallande
fabulous	fantastisk
fabulously	fantastiskt
facilitate	främja
fair	rättvis
fairly	ganska
fairness	rättvisa
faith	tro
faithful	trogen
faithfully	troget
faithfulness	trofasthet
fame	berömmelse
famed	berömd
famous	känd
famously	ökänt
fancier	snyggare
fancy	fint
fanfare	fanfar
fans	fläktar
fantastic	fantastisk
fantastically	fantastiskt
fascinate	fascinera
fascinating	fascinerande
fascinatingly	fascinerande
fashionable	modern
fast	snabb
fast-growing	Snabbväxande
fast-paced	snabb
faster	snabbare
fastest	snabbast
faultless	felfri
favor	förmån
favorable	gynnsam
favored	gynnade
favorite	favorit-
favorited	favorit
favour	förmån
fearless	orädd
fearlessly	orätt
feasible	möjlig
feat	bedrift
feature-rich	funktionsrik
feisty	lättretlig
felicitous	lyckad
felicity	sällhet
fertile	bördig
fervent	brinnande
fervently	innerligt
fervid	glödande
fervor	glöd
festive	festlig
fidelity	trohet
fiery	eldig
fine	bra
fine-looking	snygg
finely	fint
finer	finare
finest	finaste
firmer	fastare
first-in-class	först-in-class
first-rate	förstklassig
flashy	prålig
flatter	smickra
flattering	smickrande
flawless	felfri
flawlessly	felfritt
flexibility	flexibilitet
flexible	flexibel
flourish	frodas
flourishing	blomstrande
fluent	flytande
flutter	fladdra
fondly	ömt
fondness	förkärlek
foolproof	idiotsäker
foremost	främst
foresight	framsynthet
formidable	formidabel
fortitude	mod
fortuitous	tillfällig
fortuitously	slump
fortunately	Lyckligtvis
fortune	förmögenhet
fragrant	doftande
free	fri
freed	befriad
freedom	frihet
freedoms	friheter
fresh	färsk
fresher	fräschare
freshest	färskaste
friendliness	vänlighet
friendly	vänlig
frolic	upptåg
frugal	sparsam
fruitful	givande
fulfillment	uppfyllelse
fun	roligt
futuristic	trogen
gaiety	glädje
gaily	glatt
gain	få
gained	vunnits
gainful	förvärvs
gainfully	förvärvs
gaining	få
gains	vinster
gallant	galant
geeky	nördig
gem	pärla
gems	pärlor
generosity	generositet
generous	generös
generously	generöst
genial	gemytlig
genius	geni
gentle	mild
gentlest	mild
genuine	äkta
gifted	begåvad
gladden	glädja
gladly	gärna
gladness	glädje
glamorous	glamorös
glee	glädje
gleeful	munter
gleefully	glatt
glimmer	glimma
glimmering	glittrande
glisten	glittra
glistening	blänkande
glitz	glitter
glorify	förhärliga
glorious	härlig
glory	ära
glow	glöd
glowing	lysande
god-given	gudsgiven
god-send	gudagåva
godlike	gudalik
godsend	gudagåva
gold	guld-
golden	gyllene
good	Bra
goodly	ansenlig
goodness	godhet
gorgeous	underbar
grace	nåd
graceful	graciös
gracefully	graciöst
gracious	nådig
graciously	älskvärt
grand	stor
grandeur	prakt
grateful	tacksam
gratefully	tacksamt
gratification	tillfredsställelse
gratifies	tillfreds
gratifying	glädjande
gratifyingly	glädjande
gratitude	tacksamhet
great	bra
greatest	störst
greatness	storhet
grin	flin
groundbreaking	banbrytande
guarantee	garanti
guidance	vägledning
guiltless	oskyldig
gush	välla
gusto	välbehag
hail	hagel
hale	frisk
hallmark	kännemärke
hallmarks	kännetecken
hallowed	helgat
handsome	stilig
handsomely	vackert
handy	praktisk
happier	lyckligare
happily	lyckligt
happiness	lycka
happy	Lycklig
hardier	härdigare
hardy	härdig
harmless	ofarlig
harmonious	harmonisk
harmoniously	harmoniskt
harmonize	harmonisera
harmony	harmoni
headway	framsteg
heal	läka
healthful	hälsosam
healthy	friska
heartening	uppmuntrande
heartfelt	innerlig
heartily	varmt
heartwarming	hjärtvärmande
heaven	himmel
heavenly	himmelskt
helped	hjälpte
helpful	hjälpsam
helping	portion
hero	hjälte
heroic	heroisk-
heroine	hjältinna
high-spirited	uppsluppen
hilarious	munter
holy	helig
homage	hyllning
honest	ärlig
honesty	ärlighet
honor	ära
honorable	hedrande
honored	hedrad
honoring	hedrar
hooray	hurra
hopeful	hoppfull
hospitable	gästfri
hot	varm
hottest	hetast
hug	kram
humane	human
humble	ödmjuk
humility	ödmjukhet
humor	humör
humorous	humoristisk
humorously	humoristiskt
humour	humör
humourous	humoristisk
ideal	idealisk
idealize	idealisera
ideally	idealt
idolize	avguda
idyllic	idyllisk
illuminate	belysa
illuminating	Illuminating
illumine	upplysa
illustrious	lysande
imaginative	fantasifull
immaculate	obefläckad
immaculately	oklanderligt
immense	enorma
impartial	opartisk
impartiality	opartiskhet
impartially	opartiskt
impassioned	passionerad
impeccable	oklanderlig
impeccably	oklanderligt
important	Viktig
impressed	imponerad
impresses	imponerar
impressive	imponerande
impressively	imponerande
improve	förbättra
improved	förbättrad
improvement	förbättring
improvements	förbättringar
improves	förbättrar
improving	förbättra
incredible	otrolig
incredibly	oerhört
indebted	skuldsatt
individualized	individualiserad
indulgence	flathet
indulgent	eftergiven
industrious	arbetsam
inestimable	ovärderlig
inexpensive	billig
infallibility	ofelbarhet
infallible	ofelbar
infallibly	ofelbart
influential	inflytelserik
ingenious	genial
ingeniously	sinnrikt
ingenuity	påhittighet
ingenuous	naiv
ingenuously	naivt
innocuous	ofarlig
innovative	innovativ
insightful	insiktsfull
insightfully	insikts
inspirational	inspirera
inspire	inspirera
inspiring	inspirerande
instantly	omedelbart
instructive	lärorik
integral	väsentlig
integrated	integrerad
intelligence	intelligens
intelligible	begriplig
interesting	intressant
interests	intressen
intimacy	intimitet
intimate	intim
intricate	invecklad
intrigue	intrig
intriguing	fängslande
intuitive	intuitiv
invaluable	ovärderlig
inventive	uppfinningsrik
invigorate	stärka
invigorating	uppfriskande
invincibility	oövervinnlighet
invincible	oövervinnerlig
inviolable	okränkbar
inviolate	oantastad
invulnerable	osårbar
irreplaceable	oersättlig
irreproachable	oklanderlig
irresistible	oemotståndlig
irresistibly	oemotståndligt
jaw-dropping	häpnadsväckande
jolly	glad
jovial	gladlynt
joy	glädje
joyful	glad
joyfully	glatt
joyous	glad
jubilant	jublande
jubilantly	jublande
jubilate	jubilera
jubilation	jubel
judicious	klok
justly	rättvist
keen	angelägen
keenly	kännbar
keenness	iver
kid-friendly	barnvänlig
kindliness	vänlighet
kindly	vänligt
kindness	vänlighet
knowledgeable	kunnig
kudos	beröm
laud	prisa
laudable	lovvärd
laudably	berömvärt
lavish	slösa
lavishly	frikostigt
law-abiding	laglydiga
lawful	laglig
lawfully	lagligen
lead	leda
leading	ledande
lean	mager
leverage	inflytande
liberate	befria
liberation	befrielse
liberty	frihet
lifesaver	livräddare
light-hearted	sorglös
lighter	lättare
likable	sympatisk
liked	omtyckt
likes	gillar
liking	böjelse
lionhearted	Lionhearted
lively	livlig
logical	logisk
long-lasting	långvarig
lovable	intagande
love	kärlek
loved	älskade
loveliness	skönhet
lovely	härlig
lover	älskare
loves	älskar
loving	kärleksfull
lower-priced	lägre-priced
loyal	lojala
loyalty	lojalitet
luck	tur
lucky	tur-
lucrative	lukrativ
luminous	lysande
lush	frodig
luster	lyster
lustrous	glänsande
luxuriant	frodig
luxuriate	frodas
luxurious	lyxig
luxuriously	lyxigt
luxury	lyx
lyrical	lyrisk
magic	magi
magical	magisk
magnanimous	storsint
magnificence	prakt
magnificent	magnifik
magnificently	magnifikt
majestic	majestätisk
majesty	majestät
manageable	hanterlig
maneuverable	lättmanövrerad
marvel	förundras
marveled	förundrade
marvelled	förundrade
marvellous	underbar
marvelous	underbar
master	bemästra
masterful	mästerlig
masterpiece	mästerverk
masterpieces	mäster
mastery	herravälde
matchless	makalös
mature	mogna
maturely	moget
maturity	mognad
meaningful	meningsfull
memorable	minnesvärd
merciful	barmhärtig
mercifully	barmhärtigt
mercy	barmhärtighet
meritorious	förtjänstfull
merrily	glatt
merriment	munterhet
merriness	munterhet
merry	glad
mesmerize	hypnotisera
mesmerized	uppslukad
mesmerizing	fascinerande
meticulous	noggrann
meticulously	noggrant
mightily	mäktigt
mighty	mäktig
mind-blowing	häpnadsväckande
miracle	mirakel
miracles	mirakel
miraculous	mirakulös
miraculously	mirakulöst
modest	blygsam
modesty	anspråkslöshet
momentous	betydelsefulla
morality	moral
motivated	motiverad
navigable	farbar
neat	propert
neatest	snyggaste
neatly	ordentligt
nice	trevlig
nicely	fint
nicer	trevligare
nicest	finaste
nifty	tjusig
nimble	vig
noble	ädel
nobly	ädelt
noiseless	ljudlös
non-violence	ickevåld
non-violent	icke-våldsamma
noteworthy	anmärkningsvärd
nourish	uppföda
nourishing	närande
nourishment	näring
novelty	nyhet
nurturing	vårda
oasis	oas
obsession	besatthet
obsessions	tvångstankar
obtainable	erhållas
openly	öppet
openness	öppenhet
optimistic	optimistisk
opulent	rik
orderly	ordnad
originality	originalitet
outdo	bräcka
outdone	överträffat
outperform	överträffa
outperformed	överträffade
outperforms	utklassar
outshine	glänsa
outshone	glänste
outsmart	överlista
outstanding	utestående
outstandingly	utomordentligt
outstrip	träffa
outwit	överlista
overjoyed	lycklig
overtaking	omkörning
overtook	passerade
overture	uvertyr
pain-free	smärtfri
painless	smärtfri
painlessly	smärtfritt
palatial	palats
panoramic	panorama-
paradise	paradis
pardon	förlåta
passionate	passionerad
passionately	passion
patience	tålamod
patiently	tålmodigt
patriotic	patriotisk
peace	fred
peaceable	fredlig
peaceful	fredlig
peacefully	lugnt
peacekeepers	fredsbevarare
peach	persika
peerless	makalös
pepping	Pepping
perfect	perfekt
perfection	fulländning
perfectly	perfekt
permissible	tillåten
perseverance	uthållighet
personages	personligheter
personalized	personlig
phenomenal	fenomenal
phenomenally	cancerfallen
picturesque	pittoresk
piety	fromhet
pinnacle	höjdpunkt
playful	lekfull
playfully	lekfullt
pleasant	behaglig
pleasantly	angenämt
pleased	nöjd
pleases	behagar
pleasing	behaglig
pleasurable	angenäm
pleasure	nöje
plentiful	rikligt
pluses	plussidan
plush	plysch
plusses	plustecknen
poetic	poetisk
poignant	gripande
poise	balans
poised	redo
polished	polerad
polite	artig
politeness	artighet
popular	populär
portable	bärbar
posh	flott
positive	positiv
positively	positivt
positives	positiva
powerful	kraftfull
powerfully	kraftigt
praise	beröm
praiseworthy	beröm
praising	prisa
pre-eminent	framstående
precious	dyrbar
precise	exakt
precisely	exakt
prefer	föredra
preferable	bättre
preferably	företrädesvis
prefered	föredragen
preferring	föredrar
prefers	föredrar
premier	premiärminister
prestigious	prestigefyllda
pretty	Söt
priceless	ovärderlig
pride	stolthet
principled	principfast
privilege	privilegium
privileged	privilegierad
prize	pris-
proactive	proaktiv
problem-free	problemfri
problem-solver	problemlösare
prodigious	oerhörd
prodigy	vidunder
productive	produktiv
productively	produktivt
proficient	skicklig
proficiently	skickligt
profound	djupgående
profoundly	djupt
profuse	riklig
profusion	ymnighet
progress	framsteg
progressive	progressiv
prolific	fruktsam
prominence	prominens
prominent	framträdande
promise	löfte
promised	utlovade
promises	löften
promising	lovande
promoter	promotor
promptly	omgående
proper	rätt
properly	ordentligt
propitious	gynnsam
prosper	blomstra
prosperity	välstånd
prosperous	välmående
protect	skydda
protection	skydd
protective	skyddande
proud	stolt
proven	bevisad
proves	bevisar
providence	försyn
proving	bevisa
prowess	förmåga
prudence	försiktighet
prudent	klok
prudently	försiktigt
punctual	punktlig
pure	ren
purify	rena
purposeful	meningsfullt
quaint	pittoresk
qualified	kvalificerad
qualify	kvalificera
quicker	snabbare
quiet	tyst
quieter	tystare
radiance	strålglans
radiant	strålande
rapid	snabb
rapt	försjunken
rapture	hänryckning
rapturous	hänryckt
rational	rationell
razor-sharp	knivskarpa
reachable	nåbar
readable	läsbar
readily	lätt
ready	redo
realistic	realistisk
realizable	realiserbar
reasonable	rimlig
reasonably	rimligen
reasoned	motiverade
reassurance	uppmuntran
reassure	försäkra
receptive	receptiv
reclaim	återvinna
recomend	rekommendera
recommend	rekommendera
recommendation	rekommendation
recommendations	rekommendationer
recommended	rekommenderad
reconcile	förena
reconciliation	försoning
record-setting	rekord
recovery	återhämtning
rectification	rättelse
rectify	rätta
rectifying	likriktande
redeeming	återlösande
redemption	inlösen
refine	förfina
refined	raffinerad
refinement	förfining
reform	reformera
reformed	reformerad
reforming	reformering
reforms	reformer
refreshed	uppdateras
refreshing	uppfriskande
refund	återbetalning
refunded	återbetalas
regal	kunglig
regally	kungligt
regard	betrakta
rejoice	glädjas
rejoicing	fröjd
rejoicingly	FESTLIGT
rejuvenate	föryngra
rejuvenated	föryngrad
rejuvenating	föryngrande
relaxed	avslappnad
relent	mjukna
reliable	pålitlig
reliably	tillförlitligt
relief	lättnad
remarkable	anmärkningsvärd
remarkably	anmärkningsvärt
remedy	avhjälpa
remission	eftergift
remunerate	ersätta
renaissance	renässans
renewed	förnyad
renown	ryktbarhet
renowned	känd
replaceable	utbytbar
reputable	ansedd
reputation	rykte
resilient	elastisk
resolute	beslutsam
resound	skalla
resounding	rungande
resourceful	rådig
resourcefulness	rådighet
respect	respekt
respectable	respektabel
respectful	respekt
respectfully	respekt
respite	respit
resplendent	glänsande
responsibly	ansvarsfullt
responsive	mottaglig
restful	rogivande
restored	återställd
restructure	omstrukturera
restructured	omstrukturerade
restructuring	omstrukturering
retractable	infällbar
revel	frossa
revelation	uppenbarelse
revere	vörda
reverence	vördnad
reverent	vördnads
revitalize	återuppliva
revival	väckelse
revive	återuppliva
revives	återupplivar
revolutionary	revolutionerande
revolutionize	revolutionera
revolutionized	revolution
revolutionizes	revolutionerar
reward	pris
rewarding	givande
rich	rik
richer	rikare
richly	rikt
richness	rikedom
right	höger
righteous	rättfärdig
righteously	rättfärdigt
righteousness	rättfärdighet
rightful	rättmätig
rightfully	rättmätigt
rightness	riktighet
risk-free	riskfri
rock-star	Rockstjärna
rock-stars	rockstjärnor
rockstar	Rockstjärna
rockstars	rockstjärnor
romantic	romantisk
romantically	romantiskt
romanticize	romantisera
roomier	rymligare
roomy	rymlig
rosy	rosig
safe	säker
safely	säkert
sagacity	klokhet
saint	helgon
salutary	välgörande
salute	honnör
sane	förnuftig
satisfactorily	tillfredsställande
satisfactory	tillfredsställande
satisfied	nöjd
satisfies	uppfyller
satisfy	uppfylla
satisfying	tillfredsställande
saver	sparare
savings	besparingar
savior	räddare
savvy	smart
scenic	naturskön
seamless	sömlös
seasoned	kryddat
secure	säkra
securely	säkert
selective	selektiv
self-determination	självbestämmande
self-respect	självrespekt
self-satisfaction	självtillfredsställelse
self-sufficiency	självförsörjning
self-sufficient	självförsörjande
sensation	känsla
sensational	sensationell
sensationally	sensationellt
sensations	förnimmelser
sensible	förnuftig
sensibly	förnuftigt
sensitive	känslig
serene	lugn
serenity	lugn
sexy	sexig
sharp	skarp
sharper	skarpare
sharpest	skarpaste
shimmering	skimrande
shimmeringly	skimrande
shine	glans
shiny	skinande
significant	signifikant
silent	tyst
simpler	enklare
simplest	enklaste
simplified	förenklad
simplifies	förenklar
simplify	förenkla
simplifying	förenkla
sincere	uppriktig
sincerity	uppriktighet
skill	skicklighet
skilled	skicklig
skillful	skicklig
skillfully	skickligt
sleek	elegant
slick	smart
smarter	smartare
smartest	smartaste
smartly	snyggt
smile	leende
smiles	ler
smiling	leende
smilingly	leende
smitten	slagen
smooth	slät
smoother	mjukare
smoothes	jämnar
smoothest	smidig
smoothly	mjukt
snappy	galleriets
snazzy	tjusig
sociable	sällskaplig
soft	mjuk
softer	mjukare
solace	tröst
solicitous	angelägen
solid	fast
solidarity	solidaritet
soothe	lugna
soothingly	lugnande
sophisticated	sofistikerad
soundly	väl
soundness	soliditet
spacious	rymlig
sparkle	gnistra
sparkling	gnistrande
spectacular	spektakulär
spectacularly	spektakulärt
speedily	snabbt
speedy	snabb
spellbinding	trollbindande
spellbound	förtrollad
spirited	pigg
spiritual	andlig
splendid	utmärkt
splendidly	utmärkt
splendor	prakt
spontaneous	spontan
sporty	sportig
spotless	fläckfri
sprightly	pigg
stability	stabilitet
stabilize	stabilisera
stable	stabil
stainless	rostfri
state-of-the-art	toppmodern
stately	ståtlig
statuesque	statylik
staunch	pålitlig
staunchly	hårdnackat
steadfast	ståndaktig
steadfastly	orubbligt
steadfastness	ståndaktighet
steadiness	stadighet
steady	stadig
stellar	stjärn-
stimulate	stimulera
stimulates	stimulerar
stimulating	stimulerande
stimulative	stimulerande
stirringly	Rörande
straightforward	enkel
streamlined	strömlinjeformad
striking	slående
strikingly	slående
striving	strävan
strong	stark
stronger	starkare
strongest	starkaste
stunned	bedövad
stunning	fantastisk
stunningly	häpnadsväckande
stupendous	förbluffande
sturdier	robustare
sturdy	kraftig
stylish	elegant
stylishly	elegant
stylized	stiliserade
suave	förbindlig
sublime	sublim
subsidize	subventionera
subsidized	subventionerad
subsidizes	subventionerar
subsidizing	subventionera
substantive	materiella
succeed	lyckas
succeeded	lyckades
succeeding	efterföljande
succeeds	lyckas
success	Framgång
successes	framgångar
successful	framgångsrik
successfully	framgångsrikt
suffice	räcka
sufficed	räckt
sufficient	tillräcklig
sufficiently	tillräckligt
suitable	lämplig
sumptuous	överdådig
sumptuously	prakt
superb	utmärkt
superbly	utmärkt
superior	överlägsen
superiority	överlägsenhet
supple	smidig
support	Stöd
supported	stöds
supporter	anhängare
supporting	stödjande
supportive	stödjande
supports	bärare
supremacy	överlägsenhet
supreme	överlägsen
surmount	övervinna
surpass	överstiga
surreal	overkligt
survival	överlevnad
survivor	efterlevande
sustainability	hållbarhet
sustainable	hållbar
swanky	flott
sweeping	sotning
sweet	ljuv
sweeten	söta
sweetheart	Älskling
sweetly	sött
sweetness	sötma
swift	snabb
swiftness	snabbhet
talent	talang
talented	begåvad
talents	talanger
tantalize	reta
tantalizing	frestande
tempt	fresta
tempting	frestande
temptingly	frestande
tenacious	envis
tenaciously	ihärdigt
tenacity	envishet
tender	anbud
tenderly	ömt
terrific	fantastiskt
terrifically	oerhört
thank	tacka
thankful	tacksam
thoughtful	omtänksam
thoughtfully	tänk
thoughtfulness	tänk
thrift	sparsamhet
thrifty	sparsam
thrill	spänning
thrilled	glada
thrilling	spännande
thrills	raffel
thrive	frodas
thriving	blomstrande
tickle	kittla
tidy	städa
time-honored	hävdvunna
tingle	pirra
titillate	kittla
titillating	kittlande
togetherness	samhörighet
tolerable	tolerabel
toll-free	tullfritt
top	topp
top-notch	förstklassig
top-quality	Toppkvalité
tops	blast
tough	tuff
tougher	segare
toughest	tuffaste
traction	dragning
tranquil	lugn
tranquility	lugn
treasure	skatt
tremendously	oerhört
trendy	trendig
triumph	triumf
triumphal	triumf-
triumphant	triumfer
triumphantly	triumfer
trivially	trivialt
trophy	trofén
trouble-free	problemfri
trump	trumf
trust	förtroende
trusted	betrodd
trusting	förtroendefullt
trustworthiness	trovärdighet
trustworthy	pålitlig
trusty	pålitliga
truthful	sanningsenlig
truthfully	sanningsenligt
truthfulness	sanningsenlighet
ultra-crisp	ultra-skarpa
unabashed	oblyg
unaffected	opåverkad
unassailable	oantastlig
unbeatable	oslagbar
unbiased	opartisk
unbound	obunden
uncomplicated	okomplicerad
unconditional	ovillkorlig
undamaged	oskadad
undaunted	oförskräckt
understandable	begriplig
undisputed	obestridd
unencumbered	obesvärad
unequivocal	entydig
unequivocally	otvetydigt
unfazed	oberörd
unfettered	ohämmad
unforgettable	oförglömlig
unity	enhet
unlimited	obegränsat
unmatched	oöverträffad
unparalleled	enastående
unquestionable	obestridlig
unquestionably	obestridligen
unreal	overklig
unrestricted	obegränsad
unrivaled	oöverträffad
unselfish	osjälvisk
unwavering	orubblig
upbeat	optimistisk
upgradeable	uppgraderas
upgraded	uppgraderad
upheld	godtas
uphold	vidmakthålla
uplift	lyfta
uplifting	upplyftande
upscale	exklusiva
usable	användbar
useable	användbart
useful	användbar
user-friendly	användarvänlig
user-replaceable	utbytbart
valiant	tapper
valor	tapperhet
valuable	värdefulla
variety	mängd
venerate	vörda
verifiable	verifierbar
veritable	veritabel
versatile	mångsidig
versatility	mångsidighet
vibrant	vibrerande
victorious	segrande
victory	seger
viewable	synlig
vigilance	vaksamhet
vigilant	vaksam
virtue	dygd
virtuous	dygdig
virtuously	dygdigt
visionary	visionär
vivacious	livlig
vivid	levande
vouch	garantera
vouchsafe	förunna
warm	värma
warmer	varmare
warmhearted	varmhjärtad
warmly	varmt
warmth	värme
wealthy	rik
welcome	Välkommen
well	väl
well-backlit	väl-bakgrundsbelyst
well-balanced	välbalanserad
well-behaved	Sköt
well-being	välbefinnande
well-bred	belevad
well-educated	välutbildade
well-established	väletablerad
well-informed	välinformerade
well-intentioned	välmenande
well-known	välkänd
well-mannered	väluppfostrad
well-run	välskött
wellbeing	välbefinnande
whoa	Oj
wholeheartedly	helhjärtat
wholesome	hälsosam
whoooa	WHOOOA
wieldy	lätthanterlig
willing	villig
willingly	villigt
willingness	villighet
win	vinna
windfall	fallfrukt
winner	vinnare
winners	vinnare
winning	vinnande
wins	segrar
wisdom	visdom
wise	klok
wisely	klokt
witty	kvick
won	vann
wonder	undra
wonderful	underbar
wonderfully	underbart
wonders	undrar
wondrous	underbar
woo	uppvakta
work	arbete
workable	genomförbar
worked	arbetade
works	Arbetar
world-famous	världskänd
worth	värde
worth-while	värt
worthiness	värdighet
worthwhile	värt
worthy	värdig
wow	Wow
wowed	bländade
yay	Jippie
youthful	ungdomlig
zeal	iver
zenith	zenit
zest	krydda
zippy	klämmig
abnormal	onormal
abolish	avskaffa
abominable	avskyvärd
abominably	avskyvärt
abominate	hata
abomination	avsky
abort	avbryta
aborted	avbruten
aborts	avbryter
abrade	abradera
abrasive	slipmedel
abruptly	tvärt
abscond	avvika
absence	frånvaro
absent-minded	tankspridd
absentee	frånvarande
absurdity	absurditet
absurdly	absurt
abuse	missbruk
abuses	missbruk
abusive	missbruk
abysmal	bottenlös
abyss	avgrund
accidental	tillfällig
accost	tala
accursed	förbannad
accusation	anklagelse
accusations	anklagelser
accuse	anklaga
accuses	anklagar
accusing	anklagar
acerbic	kärv
ache	värk
ached	värkte
aches	värk
aching	värk
acrid	frän
acridness	FRÄNHET
acrimonious	bitter
acrimony	bitterhet
adamant	orubblig
adamantly	benhårt
addict	missbrukare
addicted	Beroende
addicting	beroendeframkallande
addicts	missbrukare
admonish	förmana
admonisher	förman
admonition	förmaning
adulterate	förfalska
adulterated	uppblandat
adulteration	förfalskning
adversarial	kontradiktoriskt
adversary	motståndare
adverse	ogynnsam
adversity	motgång
afflict	plåga
affliction	lidande
affront	skymf
afraid	rädd
aggravate	förvärra
aggravating	försvårande
aggravation	förvärrande
aggressive	aggressiv
aggressiveness	aggressivitet
aggressor	angripare
aggrieve	kränka
aggrieved	förfördelad
aghast	bestört
agonize	pina
agonizing	plågsam
agony	vånda
ailing	sjuklig
ailment	sjukdom
alarm	larm
alarmed	orolig
alarming	oroväckande
alarmingly	alarmerande
alienate	fjärma
alienated	aliene
allegation	påstående
allegations	påståenden
allege	påstå
allergic	allergisk
allergies	allergier
allergy	allergi
altercation	gräl
ambiguity	tvetydighet
ambiguous	tvetydig
ambivalence	ambivalens
ambush	bakhåll
amiss	fel
amputate	amputera
anarchism	anarkism
anarchist	anarkist
anarchistic	anarkistisk
anarchy	anarki
anemic	anemisk
anger	ilska
angrily	argt
angry	arg
anguish	ångest
animosity	fientlighet
annihilate	förinta
annihilation	förintelse
annoy	förarga
annoyance	irritation
annoyances	populärare
annoyed	irriterad
annoying	irriterande
annoyingly	irriterande
annoys	retar
anomalous	anomal
anomaly	anomali
antagonistic	antagonistisk
antagonize	motverka
anti-american	anti-amerikan
anti-israeli	anti-israeliska
anti-occupation	anti-ockupation
anti-proliferation	anti-spridning
anti-semites	antisemiter
anti-social	asocial
anti-white	anti-vit
antipathy	antipati
antiquated	föråldrad
antithetical	motsättning
anxieties	oro
anxiety	ångest
anxious	angelägen
anxiously	oroligt
anxiousness	orolighet
apathetic	apatisk
apathetically	apatiskt
apathy	apati
apocalypse	apokalyps
apocalyptic	apokalyptiskt
apologist	apologet
apologists	apologeter
appal	förfära
appall	FÖRFÄRA
appalled	bestört
appalling	skrämmande
appallingly	förfärande
apprehension	uppfattning
apprehensions	farhågor
apprehensive	orolig
arbitrary	godtycklig
arcane	hemlig
archaic	arkaisk
arduous	mödosam
arduously	mödosamt
argumentative	argumenterande
arrogance	arrogans
ashamed	skamsen
askance	snett
asperse	SMÄDA
assail	angripa
assassin	mördare
assassinate	mörda
assault	överfall
astray	vilse
asunder	sönder
atrocious	avskyvärda
atrocities	illdåd
atrocity	illdåd
atrophy	atrofi
attacks	attacker
audacious	djärv
audaciously	fräckt
audaciousness	djärvhet
audacity	djärvhet
austere	stram
authoritarian	auktoritär
autocrat	envåldshärskare
autocratic	enväldig
avalanche	lavin
avarice	girighet
avaricious	girig
avenge	hämnas
averse	obenägna
aversion	motvilja
awful	förfärlig
awfully	väldigt
awkward	besvärlig
awkwardness	pinsamhet
ax	yxa
babble	babbel
back-logged	back-loggas
back-wood	back-trä
back-woods	obygd
backache	ryggvärk
backaches	ryggsmärtor
backbite	baktala
backbiting	förtal
backward	bakåt
backwardness	bliv
backwood	Backwood
backwoods	obygd
bad	dålig
badly	dåligt
baffle	trotsa
baffled	snopen
baffling	förbryllande
bait	bete
bane	fördärv
banish	förvisa
banishment	förvisning
bankrupt	bankrutt
barbarian	barbar
barbaric	barba
barbarically	barbar
barbarity	grymhet
barbarous	barba
barbarously	barbar
barren	karg
baseless	grundlös
bashful	försagd
bastards	jävlarna
battered	slagna
battering	misshandel
bearish	baisse
beastly	djurisk
bedlam	dårhus
bedlamite	GALEN
befoul	BESMUTSA
beg	be
beggar	tiggare
beggarly	UTFATTIG
begging	tiggeri
beguile	tjusa
belated	försenad
beleaguer	BELÄGRA
belie	motsäga
belittle	förringa
belittled	förringad
bellicose	krigisk
belligerence	stridslystnad
belligerently	aggressivt
bemoan	begråta
bemused	förvirrad
bent	böjd
bereave	beröva
bereavement	förlust
bereft	berövad
berserk	bärsärk
beseech	bönfalla
beset	anfäkta
besiege	belägra
besmirch	besudla
bestial	bestialisk
betray	förråda
betrayal	svek
betrayals	förräderier
betrayer	förrädare
betraying	förråd
betrays	förråder
bewail	begråta
bewilder	förvilla
bewildered	förvirrad
bewildering	förvirrande
bewilderingly	förvirrande
bewilderment	förvirring
bewitch	förhäxa
bias	partiskhet
biased	partisk
biases	förspänner
bicker	gnabbas
bickering	gnabb
bigotry	bigotteri
bitch	tik
biting	bitande
bitterly	bittert
bitterness	bitterhet
bizarre	bisarr
blab	skvallra
blackmail	utpressning
blah	bla
blame	skylla
blameworthy	klandervärd
bland	mild
blaspheme	häda
blasphemous	hädisk
blasphemy	hädelse
blatant	uppenbar
blatantly	uppenbart
blather	pladder
bleak	dyster
bleed	blöda
bleeding	blödning
bleeds	blöder
blemish	fläck
blinding	bländande
blindingly	bländande
blister	blåsa
blistering	svidande
bloated	uppsvälld
blockage	blockering
blockhead	dumskalle
bloodshed	blodsutgjutelse
bloodthirsty	blodtörstig
bloody	blodig
blotchy	flammigt
blow	blåsa
blundering	blunde
blunders	tabbar
blunt	trubbig
blur	fläck
blurred	suddig
blurring	suddighet
blurry	suddigt
blurs	oskärpa
blurt	VRÄKA
boastful	skrytsam
bogus	falsk
boiling	kokande
boisterous	stormig
bomb	bomba
bombard	bombardera
bombardment	bombardemang
bombastic	svulstig
bondage	träldom
bore	borra
bored	uttråkad
boredom	leda
bores	borrningar
boring	tråkig
bothered	besväras
bothering	stör
bothers	besvärar
bothersome	jobbig
boycott	bojkotta
braggart	skrävlare
brainless	korkad
brash	fräck
bravado	övermod
brazen	fräck
brazenly	fräckt
brazenness	fräckhet
breach	brott
break-up	upplösning
break-ups	bryta-ups
breaking	brytning
breaks	raster
breakup	upplösning
bribery	bestickning
brimstone	svavel
bristle	borst
brittle	spröd
broke	pank
broken	bruten
broken-hearted	hjärtekrossad
brood	grubbla
browbeat	kuscha
bruise	blåmärke
bruised	plåster
bruises	blåmärken
bruising	blåmärken
brusque	brysk
brutal	Brutal
brutalising	brutalise
brutalities	brutaliteter
brutality	råhet
brutalize	brutalisera
brutalizing	brutalise
brutally	brutalt
brute	djurisk
buckle	spänne
bug	insekt
bugging	buggning
bugs	buggar
bulkier	skrymmande
bulkiness	bulkighet
bulky	skrymmande
bull****	tjur****
bull----	tjur----
bullies	mobbare
bullshit	skitsnack
bully	översittare
bullying	mobbning
bum	luffare
bump	stöta
bumped	stötte
bumping	skumpande
bumps	bulor
bumpy	ojämn
bungler	klåpare
bungling	klumpiga
bunk	sovbrits
burden	börda
burdensome	betungande
burn	bränna
burned	bränt
burning	brinnande
burns	brännskador
busts	byster
butcher	slaktare
buzzing	surrande
byzantine	bysantinsk
cackle	kackla
calamities	katastrofer
calamitous	katastrofal
calamity	katastrof
callous	okänslig
calumniate	SMÄDA
calumniation	FÖRTAL
calumny	förtal
cancerous	cancer-
cannibal	kannibal
cannibalize	kannibalisera
capitulate	kapitulera
capricious	nyckfull
capsize	kantra
careless	slarvig
carelessness	slarv
caricature	karikatyr
carnage	blodbad
carp	karp
cash-strapped	cash-fastspänd
castigate	tukta
castrated	kastrerade
casualty	skadade
cataclysm	kataklysm
cataclysmic	omvälvande
catastrophe	katastrof
catastrophes	katastrofer
catastrophic	katastrofal
catastrophically	katastrofalt
catastrophies	katastrofer
caustic	frätande
cautionary	varnande
cave	grotta
censure	klander
chafe	skava
chaff	agnar
chagrin	förtret
challenging	utmanande
chaos	kaos
chaotic	kaotisk
chasten	tukta
chastise	tukta
chastisement	straff
chatter	prat
cheap	billig
cheapen	förbilliga
cheaply	billigt
cheat	fuska
cheated	fuskat
cheater	fuskare
cheating	fusk
cheats	fusk
checkered	rutig
cheerless	glädjelös
cheesy	ostliknande
childish	barnslig
chill	kyla
chilly	kyligt
choleric	kolerisk
choppy	krabb
chore	Syssla
chronic	kronisk
chunky	tjock
clamor	larm
clamorous	larmande
clash	krock
cliche	klyscha
clique	klick
clogged	igensatt
clogs	träskor
cloud	moln
clouding	grumling
cloudy	molnig
clueless	aningslös
clumsy	klumpig
coarse	grov
cocky	kaxig
coerce	tvinga
coercion	tvång
coercive	koercitiv
cold	kall
coldly	kallt
collapse	kollaps
collusion	maskopi
combust	förbränna
comical	komisk
commiserate	ömka
commonplace	alldaglig
commotion	uppståndelse
complacent	ro
complain	klaga
complained	klagade
complaining	klagar
complains	klagar
complaint	klagomål
complaints	klagomål
complex	komplex
complicated	komplicerad
complication	komplikation
complicit	delaktig
compulsion	tvång
compulsive	tvångsmässig
concede	medge
conceded	medgav
conceit	inbilskhet
conceited	inbilsk
concen	koncen
concern	oro
concerned	bekymrad
concerns	oro
concession	koncession
concessions	eftergifter
condemn	fördöma
condemnation	fördömelse
condemned	dömd
condemns	fördömer
condescending	nedlåtande
condescendingly	nedlåtande
condescension	nedlåtenhet
confess	bekänna
confession	bekännelse
confessions	bekännelser
confined	begränsad
conflict	konflikt
conflicted	konflikt
conflicting	motstridig
conflicts	konflikter
confound	förbrylla
confounded	förväxlas
confront	konfrontera
confrontation	konfrontation
confrontational	konfronterande
confuse	förvirra
confused	förvirrad
confuses	förvirrar
confusing	förvirrande
confusion	förvirring
confusions	förvirring
congested	belastade
congestion	trängsel
cons	nackdelar
conservative	konservativ
conspicuous	iögonfallande
conspicuously	iögonenfallande
conspiracies	konspirationer
conspiracy	konspiration
conspirator	konspiratör
conspiratorial	konspiratorisk
conspire	konspirera
consternation	bestörtning
contagious	smittosam
contaminate	förorena
contaminated	förorenade
contaminates	föroreningar
contaminating	kontaminerande
contamination	förorening
contempt	förakt
contemptible	föraktlig
contemptuous	förakt
contemptuously	förakt
contend	strida
contention	påstående
contentious	omtvistad
contort	sno
contradict	motsäga
contradiction	motsägelse
contradictory	motsägande
contrariness	motsats
contravene	strida
controversial	kontroversiell
controversy	kontrovers
convoluted	invecklad
corrode	korrodera
corrosion	korrosion
corrosions	korrosion
corrosive	frätande
corrupt	korrupt
corrupted	skadad
corrupting	korrumperande
corruption	korruption
corrupts	fördärvar
costlier	dyrare
costly	kostsam
counter-productive	kontraproduktivt
counterproductive	kontraproduktivt
covetous	girig
coward	feg
cowardly	feg
crack	spricka
cracked	knäckt
cracks	sprickor
craftily	listigt
crafty	listig
cramp	kramp
cramped	trång
cramping	kramper
crap	skit
crappy	kass
crash	krascha
crashed	kraschat
crashes	krascher
crashing	kraschar
crass	krass
craven	feg
cravenly	fegt
craze	dille
crazy	galen
creak	knarra
creaking	gnällig
credulous	godtrogen
creep	krypa
creeping	krypande
creeps	kryper
creepy	kuslig
crept	kröp
crime	brottslighet
criminal	kriminell
cringe	krypa
cripple	krympling
crippled	lam
cripples	krymplingar
crippling	förlamande
crisis	kris
critic	kritiker
critical	kritisk
criticism	kritik
criticisms	kritik
criticize	klandra
criticized	kritiserats
criticizing	kritisera
critics	kritik
crook	skurk
crooked	krokig
crooks	skurkar
crude	rå
cruel	grym
crueler	grymmare
cruelly	grymt
cruelties	grymheter
cruelty	grymhet
crummy	kass
crumpled	skrynkliga
crumples	knyck
crush	krossa
crushed	krossad
crushing	förkrossande
cry	gråta
culpable	skyldig
culprit	brottsling
cumbersome	besvärlig
cunt	fitta
curse	förbanna
cursed	förbannad
curses	förbannelser
curt	kyligt
cuss	förbannelse
cutthroat	mördande
cynical	cynisk
cynicism	cynism
damage	skada
damaged	skadad
damages	skadestånd
damaging	skadlig
damn	attans
damnably	förbannat
damnation	fördömelse
damned	förbannad
damning	graverande
damper	spjäll
danger	fara
dangerous	farlig
dangerousness	farlighet
dark	mörk
darken	mörkna
darkened	förmörkad
darker	mörkare
darkness	mörker
dastard	PULTRON
dastardly	usel
daunt	skrämma
daunting	skrämmande
daze	dvala
dazed	förvirrad
dead	död
deadlock	dödläge
deadly	dödligt
deadweight	dödvikt
deaf	döv
dearth	brist
death	död
debase	förnedra
debasement	förnedring
debatable	diskutabelt
debauch	orgie
debauchery	utsvävningar
debilitate	försvagar
debilitating	försvagande
debility	svaghet
debt	skuld
debts	fordringar
decadence	förfall
decadent	dekadent
decay	förfall
decayed	förfallen
deceit	svek
deceitful	bedräglig
deceitfully	falskt
deceitfulness	bedräglighet
deceive	lura
deceiver	bedragare
deceivers	bedragare
deceiving	lura
deception	bedrägeri
deceptive	vilseledande
deceptively	bedrägligt
declaim	deklamera
decline	nedgång
declines	nedgångar
declining	minskande
decrement	minskning
decrepit	skröplig
decrepitude	skröplighet
decry	fördöma
defamation	ärekränkning
defamations	förtal
defamatory	ärekränkande
defame	förtala
defect	defekt
defective	defekt
defects	defekter
defensive	defensiv
defiance	trots
defiant	trotsig
deficiencies	brister
deficiency	brist
deficient	bristfällig
defile	orena
deform	deformera
deformed	deformerad
defrauding	bedra
defunct	borttaget
defy	trotsa
degenerate	degenererad
degradation	degradering
degrade	degradera
degrading	nedbrytande
dehumanization	avhumanisering
deign	värdigas
dejected	nedslagen
dejection	förstämning
delay	dröjsmål
delayed	försenad
delaying	fördröjande
delays	förseningar
delinquency	brottslighet
delinquent	brottsling
delirious	yrande
delude	lura
deluded	vilseledda
deluge	syndaflod
delusion	villfarelse
delusional	förvirrad
delusions	vanföreställningar
demean	förnedra
demeaning	nedsättande
demise	frånfälle
demolish	förstöra
demolisher	Demolisher
demonic	demonisk
demonizes	demoniserar
demonizing	demonisering
demoralize	demoralisera
denial	avslag
denied	nekas
denies	förnekar
denounce	fördöma
dense	tät
dent	buckla
dented	bucklig
dents	bucklor
denunciation	uppsägning
denunciations	angivelser
deny	förneka
denying	förneka
deplete	tömma
deplorable	beklaglig
deplorably	beklagligt
deploring	beklagligt
deprave	DEMORALISERA
depraved	depraverad
deprecate	nedvärdera
depress	sänka
depressed	deprimerad
depressing	deprimerande
depressingly	deprimerande
depressions	fördjupningar
deprive	beröva
deprived	berövade
deride	förlöjliga
derision	hån
derisive	hånfull
derogatory	nedsättande
desecrate	vanhelga
desert	öken-
desertion	övergivenhet
desiccate	uttorka
desiccated	uttorkad
desolate	ödslig
desolately	ödsligt
desolation	ödslighet
despair	förtvivlan
despairing	förtvivlad
desperate	desperat
desperately	desperat
despicable	föraktlig
despise	förakta
despised	föraktade
despoil	plundra
despoiler	Despoiler
despondency	förtvivlan
despondent	förtvivlad
despotic	despotisk
destabilisation	destabilisering
destitute	utblottad
destitution	nöd
destroy	förstöra
destroyer	jagare
destruction	förstörelse
destructive	destruktiv
desultory	osammanhängande
deter	avskräcka
deteriorate	försämras
deteriorating	försämrades
deterioration	försämring
deterrent	avskräckande
detest	avsky
detestable	avskyvärd
detested	avskydda
detests	avskyr
detract	förr
detracted	urholkat
detracting	förringa
detracts	förringar
detriment	skada
detrimental	skadlig
devastate	ödelägga
devastated	förkrossad
devastates	ödelägger
devastating	förödande
devastatingly	förödande
devastation	förödelse
deviate	avvika
deviation	avvikelse
devil	jäkel
devilish	djävulsk
devious	oärlig
diabolic	djävulsk
diabolical	djävulsk
diabolically	djävulskt
diametrically	diametralt
dick	kuk
dictator	diktator
dictatorial	diktatorisk
die	dö
died	dog
dies	dör
difficult	svår
difficulties	svårigheter
difficulty	svårighet
diffidence	misstro
dilapidated	förfallen
dilly-dally	vela
dim	dämpa
din	dån
dirt	smuts
dirty	smutsig
disable	inaktivera
disabled	Inaktiverad
disaccord	OENIGHET
disadvantage	nackdel
disadvantaged	missgynnade
disadvantageous	ogynnsam
disadvantages	nackdelar
disaffected	missnöjd
disagreeable	obehaglig
disagreeably	obehagligt
disagreement	oenighet
disappoint	svika
disappointed	besviken
disappointing	nedslående
disappointingly	tyvärr
disappointment	besvikelse
disappointments	besvikelser
disapprobation	ogillande
disapproval	ogillande
disapprove	ogilla
disapproving	ogillande
disarm	avväpna
disarray	oordning
disaster	katastrof
disastrous	katastrofal
disastrously	katastrofalt
disavowal	förnekande
disbelief	misstro
disclaim	säger
discomfit	förvirra
discomfort	obehag
discompose	UPPSKAKA
disconcert	OMINTETGÖRA
disconcerted	förvirrad
disconcerting	förvirrande
disconcertingly	oroväckande
disconsolate	otröstlig
disconsolately	tröst
discontent	missnöje
discontented	missnöjd
discontinued	avbrytas
discontinuity	avbrott
discontinuous	diskontinuerlig
discord	disharmoni
discordant	disharmonisk
discountenance	OGILLA
discourage	avskräcka
discouragement	modfälldhet
discouraging	nedslående
discouragingly	avskräckande
discourteous	ohövlig
discourteously	ohövligt
discredit	misskreditera
discrepant	avvikande
discriminate	diskriminera
discrimination	diskriminering
discriminatory	diskriminerande
disdain	förakt
disdained	föraktade
disfavor	onåd
disgrace	skam
disgraceful	vanhedrande
disgracefully	skam
disgruntle	IRRITERA
disgruntled	missnöjd
disgust	avsky
disgusted	äcklad
disgustful	VIDRIG
disgusting	äcklig
disheartening	nedslående
dishonest	oärlig
dishonestly	oärligt
dishonesty	oärlighet
dishonor	vanära
dishonorable	vanhedrande
disillusion	desillusion
disillusioned	desillusionerad
disillusionment	besvikelse
disillusions	desillusioner
disinclination	obenägenhet
disinclined	obenägen
disingenuously	oärligt
disintegrate	desintegrera
disintegrated	sönderdelas
disintegrates	sönderfaller
disintegration	upplösning
disinterested	ointresserad
dislike	motvilja
disliked	ogillade
dislikes	ogillar
disliking	aversion
disloyal	illojal
disloyalty	illojalitet
dismal	dyster
dismay	bestörtning
dismayed	bestört
dismaying	förfärande
dismissive	avvisande
disobedience	olydnad
disobedient	olydig
disorder	oordning
disordered	oordnad
disorderly	bråkig
disorganized	oorganiserad
disorient	förvirra
disoriented	desorienterad
disown	förneka
disparage	nedvärdera
disparaging	nedsättande
disparagingly	nedsättande
dispensable	umbärlig
dispirited	nedslagen
displace	förflytta
displaced	förskjuten
displease	misshaga
displeased	missnöjd
displeasing	misshag
displeasure	missnöje
disproportionate	oproportionerlig
disprove	vederlägga
disputable	diskutabel
dispute	tvist
disputed	omtvistat
disquiet	oro
disquieting	oroande
disquietingly	oroväckande
disquietude	Disquietude
disreputable	vanhedrande
disrepute	vanrykte
disrespect	respektlöshet
disrespectful	respektlös
disrespectfully	respektlöst
disrupt	störa
disruption	avbrott
disruptive	störande
dissatisfaction	missnöje
dissatisfactory	otillfredsställande
dissatisfied	missnöjd
dissatisfy	missnöjd
dissed	dissad
dissembler	HYCKLARE
dissension	oenighet
dissent	meningsskiljaktighet
dissention	dissen
disservice	otjänst
dissidence	oliktänkande
dissidents	dissidenter
dissing	dissar
dissocial	OSÄLLSKAPLIG
dissolute	utsvävande
dissolution	upplösning
dissonance	dissonans
dissonant	disharmonisk
dissuade	avråda
dissuasive	avskräckande
distaste	avsmak
distasteful	motbjudande
distort	förvränga
distorted	förvrängd
distortion	förvrängning
distorts	förvränger
distract	distrahera
distracting	distraherande
distraction	distraktion
distraught	upprörd
distress	ångest
distressed	bedrövad
distressing	ömmande
distrust	misstro
distrustful	misstänksam
distrusting	misstro
disturb	störa
disturbance	störning
disturbed	störd
disturbing	störande
disunity	oenighet
divergent	avvikande
divisive	splitt
divisiveness	splittring
dizzy	yr
dogged	envis
doggedly	envist
dogmatic	dogmatisk
doldrums	stiltje
domineer	DOMINERA
domineering	dominerande
doom	undergång
doomed	dömd
doomsday	domedag
dope	dopa
doubt	tvivel
doubtful	tveksam
doubtfully	tveksamt
doubts	tvivel
douchbag	Douchbag
downcast	nedslagen
downfall	undergång
downgrade	nedvärdera
downhearted	nedstämd
downhill	utför
downside	nackdelen
downturn	nedgången
downturns	nedgångar
draconian	drakonisk
dragged	släpade
dragging	dra
dragoon	dragon
drags	drar
drain	dränera
drained	dränerad
draining	avtappning
drains	avlopp
drastic	drastisk
drastically	drastiskt
drawback	nackdel
drawbacks	nackdelar
dread	fruktan
dreadful	hemsk
dreadfully	fruktansvärt
dreary	trist
dripped	droppade
dripping	droppande
drips	droppar
drones	drönare
droop	sloka
droops	slokar
drought	torka
drowning	drunkning
drunk	full
drunkard	drinkare
drunken	berusad
dubious	tvivelaktig
dubitable	TVIVELAKTIG
dud	BLINDGÅNGARE
dull	tråkig
dumb	dum
dumbfound	FÖRSTUMMA
dump	dumpa
dumped	dumpade
dumping	dumpning
dumps	soptippar
dunce	dumhuvud
dungeon	fängelsehåla
dungeons	fängelsehålor
dupe	dupera
dust	damm
dusty	dammig
dwindling	krympande
dying	döende
eccentric	excentrisk
eccentricity	excentricitet
effigy	avbildning
effrontery	oförskämdhet
egocentric	egocentrisk
egomania	egomani
egotistically	egoistiskt
egregious	oerhörd
election-rigger	val-riggare
elimination	eliminering
emaciated	utmärglad
emasculate	kastrera
embarrass	besvära
embarrassing	pinsam
embarrassingly	pinsamt
embarrassment	förlägenhet
embattled	kämpande
embroiled	indragen
embroilment	FÖRVECKLING
emergency	nödsituation
emphatic	eftertrycklig
emptiness	tomhet
encroach	inkräkta
encroachment	intrång
endanger	äventyra
enemies	fiender
enemy	fiende
enfeeble	försvaga
engulf	uppsluka
enjoin	ålägga
enmity	fiendskap
enraged	rasande
entanglement	förveckling
entrap	snärja
entrapment	infångning
envious	avundsjuk
enviously	avundsjukt
epidemic	epidemi
equivocal	tvetydig
erase	radera
erode	erodera
erodes	eroderar
err	fela
errant	felande
erratic	oregelbunden
erratically	oregelbundet
erroneous	felaktig
erroneously	Felaktig
error	fel
errors	fel
eruptions	utbrott
escapade	eskapad
estranged	främmande
evade	undgå
evasion	undvikande
evasive	undvikande
evil	ondska
evildoer	illgärningsman
evils	onda
eviscerate	rensning
exacerbate	förvärra
exaggerate	överdriva
exaggeration	överdrift
exasperate	reta
exasperated	förbittrad
exasperating	irriterande
exasperatingly	förtvivlat
exasperation	förbittring
excessive	överdriven
excessively	alltför
exclusion	uteslutning
excruciating	olidlig
excuse	ursäkt
excuses	ursäkter
execrate	förbanna
exhaust	uttömma
exhausted	utmattad
exhaustion	utmattning
exhausts	avgaser
exhort	uppmana
exile	exil
exorbitant	orimlig
exorbitantly	omåttligt
expel	utvisa
expensive	dyr
expire	upphöra
expired	utgånget
explode	explodera
exploit	utnyttja
exploitation	utnyttjande
explosive	explosiv
expropriate	expropriera
expunge	utplåna
exterminate	utrota
extermination	utrotning
extinguish	släcka
extortion	utpressning
extraneous	främmande
extravagance	extravagans
extremists	extremister
fabricate	tillverka
fabrication	tillverkning
facetious	skämtsam
facetiously	skämt
fail	misslyckas
failed	misslyckades
failing	brist
fails	misslyckas
failure	fel
failures	misslyckanden
faint	svag
fainthearted	småsint
faithless	trolös
fake	falsk
fall	falla
fallacies	vanföreställningar
fallacious	vilseledande
fallacy	felslut
falling	faller
false	falsk
falsehood	lögn
falsely	falskt
falsify	förfalska
falter	vackla
famine	svält
famished	utsvulten
fanatic	fanatiker
fanatical	fanatisk
fanatically	fanatiskt
fanaticism	fanatism
fanatics	fanatiker
fanciful	fantasifull
far-fetched	långsökt
farce	fars
farcical	farsartad
farcically	farsartat
farfetched	långsökt
fascist	fascistisk
fastidious	kräsen
fastidiously	idogt
fat	fett
fatal	dödlig
fatalistic	fatalistisk
fatalistically	fatalistiskt
fatally	dödligt
fateful	ödesdiger
fatefully	ödesdigert
fathomless	bottenlös
fatigue	Trötthet
fatigued	trött
fatique	utmattnings
fatty	fet
fatuity	dumhet
fatuous	enfaldig
fatuously	MENINGSLÖST
fault	fel
faults	fel
faulty	felaktig
fear	rädsla
fearful	rädd
fearfully	fruktans
fears	rädsla
fearsome	skrämmande
feckless	hjälplös
feeble	svag
feebleminded	sinnessvag
feign	hyckla
feint	fint
fell	föll
felon	brottsling
ferociously	ursinnigt
ferocity	grymhet
fetid	stinkande
fever	feber
feverish	febrig
fevers	feber
fiasco	fiasko
fickle	ombytlig
fiction	fiktion
fictional	fiktiva
fictitious	fiktiv
fidgety	rastlös
fiend	djävul
fiendish	djävulsk
fierce	våldsam
figurehead	galjonsfigur
filth	smuts
filthy	snuskig
finagle	Finagle
finicky	petig
fissures	fissurer
fist	näve
flabbergasted	förbluffad
flagging	flaggning
flagrantly	uppenbart
flair	stil
flak	flaken
flake	flaga
flaking	flagning
flaky	fjällig
flare	blossa
flares	bloss
flaunt	pråla
flaw	fel
flawed	bristfällig
flaws	brister
flee	fly
fleeing	flyr
flees	flyr
fleeting	flyktig
flicker	flimmer
flickering	flimmer
flickers	flimrar
flimflam	LURENDREJERI
flimsy	tunn
flirt	flört
flirty	flörtig
floored	täckt
flounder	flundra
flout	trotsa
fluster	förvirra
foe	fiende
fool	lura
fooled	luras
foolhardy	dumdristig
foolish	dåraktig
foolishly	dåraktigt
foolishness	dåraktighet
forbid	förbjuda
forbidden	förbjuden
forbidding	förbjuder
forceful	kraftfull
foreboding	förebud
forfeit	förverka
forged	smidda
forgetful	glömsk
forgetfulness	glömska
forlorn	övergiven
forsake	överge
forsaken	övergiven
forswear	avsvärja
foully	OTÄCKT
foulness	VIDRIGHET
fractious	besvärliga
fracture	fraktur
fragile	ömtålig
fragmented	fragmenterad
frail	bräcklig
frantically	bläddrande
fraud	bedrägeri
fraudulent	bedräglig
fraught	fylld
freakish	underlig
freeze	frysa
freezes	fryser
freezing	frysning
frenetic	frenetisk
frenetically	frenetiskt
frenzied	frenetisk
frenzy	frenesi
fret	band
fretful	retlig
frets	band
friction	friktion
frictions	friktioner
fried	stekt
frigging	jävla
fright	skrämsel
frighten	skrämma
frightening	skrämmande
frighteningly	skrämmande
frightful	förskräcklig
frightfully	förskräckligt
frigid	kylig
frost	Frost
froze	frös
frozen	frysta
fruitless	fruktlös
frustrate	omintetgöra
frustrated	frustrerad
frustrates	omintetgör
frustrating	frustrerande
frustratingly	frustrerande
frustrations	frustration
fuck	knulla
fucking	jävla
fugitive	flykting
fulminate	DUNDRA
fumble	fumla
fume	rök
fumes	ånga
funky	stinkande
funny	rolig
furious	rasande
furiously	ursinnigt
fury	raseri
fuss	väsen
fussy	kinkig
fusty	unken
futile	meningslös
futility	meningslöshet
fuzzy	suddig
gabble	RABBLA
gaff	gaffel
gaffe	tabbe
gainsay	motsäga
gall	galla
galling	gallbildning
galls	gallbildningar
gape	gapa
garbage	sopor
garish	skrikig
gasp	flämtning
gauche	klumpig
gaudy	grann
gawky	tafatt
genocide	folkmord
ghetto	getto
ghosting	spökbilder
gibber	SLUDDER
gibberish	rotvälska
gibe	gliring
giddy	yr
gimmicks	jippon
glaringly	iögonfallande
glibly	lättvindigt
gloatingly	triumferande
gloom	dysterhet
gloomy	dyster
glum	dyster
gnawing	gnagande
goad	sporra
goofy	fånig
goon	Fortsätt
gossip	skvaller
graft	ympa
grainy	kornig
grapple	brottas
grate	galler
grating	galler
gravely	allvarligt
greasy	oljig
greed	girighet
greedy	girig
grief	sorg
grievance	klagomål
grievances	klagomål
grieve	sörja
grieving	sörjande
grievous	svår
grim	bister
grimace	grimas
grind	slipa
gripe	gnälla
gripes	gnäller
grisly	hemsk
gritty	grynig
gross	brutto
grossly	grovt
grotesque	grotesk
grouch	surpuppa
grouchy	vresig
groundless	grundlös
grouse	ripa
growl	morra
grudge	agg
grudges	agg
grudging	missunnsam
grudgingly	motvilligt
gruesome	hemsk
gruesomely	ruggigt
gruff	barsk
grumble	klaga
grumpy	vresig
guile	svek
guilt	skuld
guilty	skyldig
gullible	godtrogen
gutless	feg
gutter	ränna
hack	hacka
hacks	hacka
haggard	tärd
haggle	pruta
hairloss	håravfall
halfhearted	halvhjärtad
hallucinate	hallucinera
hamper	korg
hampered	hämmas
handicapped	handikappade
hang	hänga
hangs	hänger
haphazard	slumpmässig
hapless	olycklig
harangue	harang
harass	plåga
harassed	trakasserade
harasses	trakasserar
harassment	trakasserier
harboring	hysande
harbors	hamnar
hard	hård
hard-line	hårdföra
hard-liner	hård-liner
harden	härda
hardened	härdad
hardheaded	orubblig
hardhearted	hårdhjärtade
hardliners	hårdföra
hardship	strapats
hardships	svårigheter
harm	skada
harmed	skadad
harmful	skadlig
harms	skador
harpy	harpya
harrow	harv
harsh	hård
harshly	hårt
hasseling	hasse
hassle	krångel
hassles	krångel
haste	brådska
hastily	hastigt
hasty	förhastade
hate	hata
hated	hatade
hateful	förhatlig
hatefully	FÖRHATLIGT
hater	hatare
haters	hatare
hates	hat
hatred	hat
haughtily	högdraget
haughty	högdragen
haunt	förfölja
haunting	efterhängsen
havoc	kaos
hawkish	hökaktiga
hazard	fara
hazardous	farlig
haze	dis
hazy	dimmig
head-aches	huvud-värk
headache	huvudvärk
headaches	huvudvärk
heartbreaker	hjärtekrossare
heartbreaking	förkrossande
heartless	hjärtlös
heathen	hedning
heavy-handed	hårdhänta
heck	fan
heckle	häckla
hectic	hektisk
hedge	häck
hedonistic	hedonistiska
heedless	tanklös
hefty	rejäl
hegemonism	hegemoni
hegemonistic	hegemonistiska
hegemony	hegemoni
heinous	avskyvärd
hell	Helvete
hell-bent	botad
hells	helveten
helpless	hjälplös
helplessly	hjälplös
helplessness	hjälplöshet
heresy	kätteri
heretic	kättare
heretical	kättersk
hesitant	tveksam
hideous	otäck
hinder	hindra
hindrance	hinder
hiss	väsa
hissed	väste
hissing	väsande
hoard	förråd
hoax	bluff
hobble	stappla
hogs	svin
hollow	ihålig
hoodwink	lura
hooligan	ligist
hopeless	hopplös
hopelessly	hopplöst
hopelessness	hopplöshet
horde	hord
horrendous	fasansfulla
horrendously	oerhört
horrible	fruktansvärd
horrid	otäck
horrific	fruktansvärda
horrified	förfärade
horrify	skrämma
horrifying	skräckinjagande
hostage	gisslan
hostile	fientlig
hostilities	fientlighet
hostility	fientlighet
hotbeds	härdar
hothouse	drivhus
hubris	hybris
hum	brum
humid	fuktig
humiliate	förödmjuka
humiliating	förnedrande
humiliation	förnedring
humming	brummande
hung	hängd
hurt	ont
hurted	skadad
hurtful	sårande
hurting	skada
hypocrisy	hyckleri
hypocrite	hycklare
hypocrites	hycklare
hypocritical	hycklande
hypocritically	hycklande
hysteria	hysteri
hysteric	hysterisk
hysterical	hysterisk
hysterically	hysteriskt
hysterics	hysteri
idiocies	idiotier
idiocy	idioti
idiotic	idiotisk
idiotically	idiotiskt
idiots	idioter
ignoble	simpel
ignominy	vanära
ignorance	okunnighet
ignorant	okunnig
ignore	ignorera
ill-advised	oklokt
ill-fated	ödesdigra
ill-favored	OSKÖN
ill-formed	ill-bildade
ill-mannered	obelevad
ill-natured	HÄTSK
ill-sorted	ill-sorterat
ill-tempered	BITSK
ill-treated	misshandlas
ill-treatment	misshandel
ill-usage	ill-användning
illegal	olaglig
illegally	illegalt
illegitimate	illegitim
illicit	olaglig
illiterate	analfabet
illness	sjukdom
illogical	ologisk
illogically	ologiskt
illusions	illusioner
illusory	illusorisk
imaginary	imaginär
imbalance	obalans
imbecile	idiot
immaterial	immateriell
immature	omogen
immobilized	immobiliserat
immoderate	omåttlig
immodest	oblyg
immoral	omoralisk
immorality	omoral
immorally	sed
immovable	fast
impair	försämra
impaired	försämrad
impasse	dödläge
impatience	otålighet
impatient	otålig
impatiently	otåligt
impeach	anklaga
impedance	impedans
impede	hindra
impediment	hinder
impending	hotande
impenitent	obotfärdig
imperfect	ofullständig
imperfection	ofullkomlighet
imperfections	imperfektioner
imperfectly	ofullständigt
imperil	äventyra
imperious	befallande
imperiously	befallande
impermissible	otillåtlig
impersonal	opersonlig
impertinent	oförskämd
impetuous	häftig
impetuously	häftigt
impiety	ogudaktighet
impinge	inkräkta
impious	ogudaktig
implacable	oförsonlig
implausible	osannolik
implausibly	osannolikt
implication	inblandning
implode	implodera
impolite	oartig
impolitely	ohövligt
importunate	påträngande
importune	besvära
impose	förelägga
imposing	imponerande
imposition	utskjutning
impossible	omöjlig
impossibly	omöjligt
impoverish	utarma
impoverished	utfattig
impractical	opraktisk
imprecate	NEDKALLA
imprecise	oprecis
imprecisely	otydligt
imprison	fängsla
imprisonment	fängelse
improbability	osannolikhet
improbable	osannolik
improper	felaktig
improperly	otillbörligt
impropriety	oanständighet
imprudence	oförsiktighet
imprudent	oförsiktig
impudence	fräckhet
impudent	fräck
impudently	fräckt
impugn	ifrågasätta
impulsive	impulsiv
impulsively	impulsivt
impunity	straffrihet
impure	oren
impurity	förorening
inability	oförmåga
inaccuracies	felaktigheter
inaccuracy	felaktighet
inaccurate	felaktig
inaccurately	felaktigt
inaction	overksamhet
inactive	inaktiv
inadequacy	otillräcklighet
inadequate	otillräcklig
inadequately	otillräckligt
inadvisable	olämpligt
inane	fånig
inappropriate	olämplig
inappropriately	olämpligt
inapt	OSKICKLIG
inaptitude	OSKICKLIGHET
inarticulate	oartikulerad
inattentive	ouppmärksam
inaudible	ohörbar
incapable	oförmögen
incautious	oförsiktig
incendiary	upphetsande
incense	rökelse
incessant	oupphörlig
incessantly	oavbrutet
incite	hetsa
incitement	uppvigling
incivility	ohövlighet
inclement	bister
incognizant	OVETANDE
incoherent	osammanhängande
incoherently	osammanhängande
incommensurate	OJÄMFÖRBAR
incomparable	makalös
incomparably	ojämförligt
incompatability	inkompatibilitet
incompatibility	inkompatibilitet
incompatible	oförenlig
incompetence	inkompetens
incompetent	inkompetent
incompetently	inkompetent
incomplete	Ofullständig
incomprehensible	obegriplig
inconceivable	otänkbart
inconceivably	ofattbart
incongruous	motsägelsefull
inconsequent	inkonsekvent
inconsequential	obetydlig
inconsiderate	hänsynslöst
inconsistencies	inkonsekvenser
inconsistency	inkonsekvens
inconsistent	inkonsekvent
inconsolable	otröstlig
inconsolably	otröstligt
inconstant	föränderlig
inconvenience	besvär
inconveniently	ogenomlysligt
incorrect	felaktig
incorrectly	felaktigt
incorrigible	oförbätterlig
incorrigibly	oefterrättligt
incredulous	skeptisk
inculcate	inskärpa
indecency	oanständighet
indecent	oanständig
indecision	obeslutsamhet
indecisive	obeslutsam
indecorum	OTILLBÖRLIGHET
indefensible	oförsvarlig
indelicate	ogrannlaga
indeterminable	obestämbar
indeterminate	obestämd
indifference	likgiltighet
indifferent	likgiltig
indigent	utfattig
indignant	indignerad
indignantly	indignerat
indignity	skymf
indiscernible	urskiljbara
indiscreet	indiskret
indiscretion	indiskretion
indiscriminate	urskillningslös
indiscriminating	OKRITISK
indoctrinate	indoktrinera
indoctrination	indoktrinering
ineffective	ineffektiv
ineffectively	ineffektivt
ineffectiveness	ineffektivitet
ineffectual	verkningslös
ineffectually	ineffektivt
ineffectualness	verkningslöshetens
inefficacious	GAGNLÖS
inefficacy	ineffektivitet
inefficiency	ineffektivitet
inefficient	ineffektiv
inefficiently	ineffektivt
inelegant	klumpig
ineligible	berättigade
inept	olämplig
ineptitude	inkompetens
ineptly	oskickligt
inequalities	ojämlikhet
inequality	olikhet
inequitable	orättvis
inequitably	ojämnt
inescapable	ofrånkomlig
inescapably	oundvikligen
inessential	oväsentlig
inevitable	oundviklig
inevitably	oundvikligen
inexcusable	oursäktlig
inexcusably	olovligt
inexorable	obeveklig
inexorably	obevekligt
inexperience	oerfarenhet
inexperienced	oerfaren
inexpert	ovana
inextricable	ofrånkomlig
inextricably	oupplösligt
infamous	ökänd
infamy	vanära
infected	smittad
infection	infektion
infections	infektioner
inferior	sämre
inferiority	underlägsenhet
infernal	infernalisk
infest	hemsöka
infested	angripet
infidel	otrogen
infidels	otrogna
infiltrator	infiltratör
infiltrators	infiltratörer
infirm	handikappade
inflame	förvärra
inflammatory	inflammatorisk
inflated	uppblåst
inflationary	inflatorisk
inflexible	oböjlig
inflict	vålla
infraction	överträdelse
infringe	kränka
infringement	överträdelse
infringements	överträdelser
infuriating	upprörande
inglorious	skamlig
ingrate	otacksam
ingratitude	otack
inhibit	hämma
inhibition	hämning
inhospitable	ogästvänlig
inhospitality	ogästvänlighet
inhuman	omänsklig
inhumane	omänsklig
inhumanity	omänsklighet
inimical	fientlig
iniquitous	upprörande
iniquity	orätt
injudicious	omdömeslös
injure	skada
injurious	skadlig
injury	skada
injustice	orätt
injustices	orättvisor
innuendo	insinuation
inoperable	inoperabel
inopportune	oläglig
inordinate	omåttlig
inordinately	omåttligt
insane	sinnessjuk
insanely	galet
insanity	vansinne
insatiable	omättlig
insecure	osäker
insecurity	osäkerhet
insensible	okänslig
insensitive	okänslig
insensitivity	okänslighet
insidious	smygande
insidiously	försåtligt
insignificance	obetydlighet
insignificant	obetydlig
insignificantly	obetydligt
insincere	falsk
insincerity	falskhet
insinuate	insinuera
insinuating	insinuanta
insolence	fräckhet
insolent	oförskämd
insolently	fräckt
insouciance	likgiltighet
instability	instabilitet
instable	instabil
instigate	anstifta
instigator	anstiftare
instigators	anstiftare
insubordinate	uppstudsig
insubstantial	obetydlig
insufferable	olidlig
insufficiency	insufficiens
insufficient	otillräcklig
insufficiently	otillräckligt
insular	trångsynt
insult	förolämpning
insulted	förolämpade
insulting	kränkande
insultingly	förolämpande
insults	förolämpningar
insupportable	outhärdlig
insurmountable	oöverstiglig
insurrection	uppror
intense	intensiv
interference	interferens
interferes	stör
interrupt	avbryta
interruption	avbrott
interruptions	avbrott
intimidate	skrämma
intimidating	hotfull
intimidation	skrämsel
intolerable	outhärdlig
intolerance	intolerans
intoxicate	berusa
intractable	svårbehandlad
intransigent	oförsonlig
intrude	inkräkta
intrusion	intrång
intrusive	påträngande
inundate	dränka
inundated	svämmas
invader	inkräktare
invalid	ogiltig
invalidate	ogiltigförklara
invalidity	invaliditet
invasive	invasiv
invective	invektiv
inveigle	tubba
invidious	orättvis
invisible	osynlig
involuntarily	ofrivilligt
involuntary	oavsiktlig
irascible	hetlevrad
irate	ilsken
ire	vrede
irk	reta
irks	irriterar
irksome	irriterande
ironic	Ironisk
ironical	ironisk
ironically	ironiskt
irony	ironi
irrational	irrationell
irrationalities	irrationaliteter
irrationality	irrationella
irrationally	irrationellt
irreconcilable	oförenlig
irrecoverable	oindrivbara
irrecoverably	oåterkalleligen
irredeemable	oförbätterlig
irredeemably	ohjälpligt
irregular	oregelbunden
irregularity	oegentlighet
irrelevance	irrelevans
irreparable	irreparabel
irrepressible	okuvlig
irresolute	obeslutsam
irresolvable	olöslig
irresponsible	oansvarig
irresponsibly	oansvarigt
irretrievable	oersättlig
irreversible	irreversibel
irritable	irritabel
irritably	irriterat
irritant	irriterande
irritate	irritera
irritated	irriterad
irritating	irriterande
irritations	irritationer
isolate	isolera
isolated	isolerat
isolation	isolering
issue	problem
issues	frågor
itch	klia
itching	klåda
itchy	kliande
jabber	pladder
jaded	utsliten
jagged	ojämn
jam	sylt
jarring	skärande
jealous	svartsjuk
jealousy	svartsjuka
jeer	håna
jeering	hånfull
jeers	hån
jeopardize	äventyra
jeopardy	Jeopardy
jerk	rycka
jerky	ryckig
jitters	panik
jittery	skakis
jobless	arbetslös
joke	skämt
jolt	ryck
jumpy	nervös
junk	skräp
junkyard	skrotupplag
jutter	Jutter
kaput	kaputt
kill	döda
killed	dödade
killer	mördare
killing	dödande
kills	fiender
knave	knekt
knife	kniv
knock	slå
knotted	knölig
kooky	knasig
lack	brist
lackadaisical	nonchalant
lacked	saknade
lackey	lakej
lackeys	lakejer
lacking	saknas
lackluster	matt
lacks	saknar
laconic	lakonisk
lag	eftersläpning
lagged	släpat
lagging	eftersläpande
laggy	laggig
lags	eftersläpning
laid-off	uppsagd
lambaste	KLÅ
lame	lam
lame-duck	tandlös
lament	beklaga
lamentable	bedrövlig
lamentably	beklagligt
languid	matt
languish	tråna
languor	matthet
languorous	smäktande
lanky	gänglig
lapse	upphöra
lapsed	bortfallit
lapses	bortfaller
lascivious	vällustig
latency	latens
laughable	retande
laughingstock	åtlöje
lawbreaker	lagbrytare
lawbreaking	lagöverträdelser
lawless	laglös
lawlessness	laglöshet
layoff	permittering
layoff-happy	friställning-happy
lazy	lat
leak	läcka
leakage	läckage
leakages	läckage
leaking	läckande
leaks	läckor
leaky	läckande
lecherous	liderlig
lechery	liderlighet
leech	igel
left-leaning	vänster-lutande
lemon	citron-
lengthy	långvarig
lethal	dödlig
lethargic	slö
lethargy	letargi
lewd	oanständig
liability	ansvar
liable	ansvarig
liar	lögnare
licentious	utsvävande
licentiousness	tygellöshet
lie	lögn
lier	lögnare
lies	lögner
life-threatening	livshotande
lifeless	livlös
limit	begränsa
limitation	begränsning
limitations	begränsningar
limited	begränsad
limits	gränser
limp	halta
listless	håglös
litigious	stridslysten
livid	askgrå
loath	ovillig
loathe	avsky
loathing	avsky
loathsome	avskyvärd
lone	ensam
loneliness	ensamhet
lonely	ensam
loner	enstöring
lonesome	ensam
long-winded	långrandiga
longing	längtar
longingly	längtans
loophole	kryphål
loopholes	kryphål
loose	lösa
loot	plundra
lose	förlora
loser	förlorare
losers	förlorare
loses	förlorar
losing	förlorande
loss	förlust
losses	förluster
lost	förlorat
loud	högt
louder	högre
lousy	nedlusad
loveless	kärlekslös
low-rated	låg-rated
lowly	ringa
ludicrous	löjlig
ludicrously	löjligt
lugubrious	lugubra
lukewarm	ljummen
lull	stiltje
lumpy	klimpig
lunatic	galning
lurch	kränga
lure	locka
lurid	spöklik
lurking	lurar
lying	liggande
macabre	makaber
mad	galen
maddening	irriterande
madder	galnare
madman	galning
madness	galenskap
maladjusted	missanpassade
maladjustment	missanpassning
malady	sjukdom
malaise	obehag
malcontent	missnöjd
malevolence	illvilja
malevolent	illvillig
malevolently	illvilligt
malice	illvilja
malicious	illvillig
maliciously	uppsåt
malign	baktala
malignant	malign
malodorous	illaluktande
maltreatment	misshandel
mangle	mangel
mangled	manglas
mangles	manglar
mania	mani
maniac	galning
maniacal	maniskt
manic	manisk
manipulate	manipulera
manipulative	manipulativ
manipulators	manipulatorer
marginally	marginellt
martyrdom	martyrium
martyrdom-seeking	martyrium-söker
mashed	mosad
massacre	massaker
massacres	massakrer
matte	matt
meager	mager
meaningless	meningslös
meanness	elakhet
measly	ynklig
meddlesome	beskäftig
mediocre	medelmåttig
mediocrity	medelmåttighet
melancholy	melankoli
melodramatic	melodramatisk
meltdown	härdsmälta
menace	hot
menacing	hotfulla
mendacious	lögnaktig
mendacity	lögnaktighet
menial	simpel
merciless	skoningslös
mercilessly	obarmhärtigt
mess	röra
messed	trasslat
messes	mässar
messy	rörig
midget	dvärg
miff	BRÅK
militancy	stridbarhet
mindless	själlös
mindlessly	tanklöst
mirage	hägring
mire	myr
misalign	felinrikta
misaligned	felinriktad
misapprehend	MISSFÖRSTÅ
misbecome	MISSKLÄ
miscalculate	RÄKNA
miscalculation	felräkning
miscellaneous	diverse
mischief	rackartyg
mischievous	busig
mischievously	skälmskt
misconception	missuppfattning
misconceptions	missuppfattningar
miser	girigbuk
miserable	eländig
miserably	eländigt
miseries	elände
miserly	girig
misery	elände
misfit	missanpassad
misfortune	olycka
misgiving	farhåga
misgivings	tvivel
misguided	missriktade
mishandle	misshandla
mishap	missöde
misinform	vilseleda
misinformed	felunderrättad
misinterpret	misstolkar
misjudge	felbedöma
misjudgment	felbedömning
mislead	vilseleda
misleading	vilseledande
misleadingly	vilseledande
mismanage	missköta
misread	misstolkas
misreading	felläsning
misrepresent	förvränga
misrepresentation	förvrängning
miss	Fröken
missed	missade
misses	missar
misstatement	felaktigheter
mist	dimma
mistake	misstag
mistaken	felaktig
mistakes	misstag
mistress	husmor
mistrust	misstro
mistrustful	misstrogna
mistrustfully	misstänk
mists	dimmor
misunderstand	missförstå
misunderstanding	missförstånd
misunderstandings	missförstånd
misunderstood	missförstås
misuse	missbruka
moan	stöna
mobster	gangster
mock	falsk
mockeries	hån
mockery	hån
mocking	hånfull
mockingly	Mockingly
molest	antasta
molestation	ofredande
monotonous	monoton
monotony	monotoni
monstrosities	monstrositeter
monstrosity	monster
monstrous	monstruös
moody	lynnig
moot	omtvistad
mope	TJURA
morbid	sjuklig
mordant	bitande
moribund	döende
moron	dumhuvud
mortification	förödmjukelse
mortified	beskedet
mortify	späka
motionless	orörlig
motley	brokig
mourn	sörja
mourner	sörjande
mournful	sorgsen
muddle	virrvarr
muddy	grumlig
mudslinging	smutskastning
mulish	HALSSTARRIG
mundane	världslig
murder	mörda
murderer	mördare
murderous	mördande
murky	mulen
muscle-flexing	muskel-böjning
mushy	sörjig
musty	unken
mysterious	mystisk
mysteriously	mystiskt
mystery	mysterium
mystify	mystifiera
myth	myt
nagging	tjatar
naive	naiv
naively	naivt
narrower	smalare
nasty	otäck
naughty	stygg
nauseate	äckla
nauseating	kväljande
naïve	naiv
nebulous	oklar
needless	onödigt
needlessly	onödigt
needy	behövande
nefarious	skändlig
negate	förneka
negative	negativ
negatives	negativ
negativity	negativitet
neglect	försummelse
neglected	försummad
negligence	oaktsamhet
negligent	försumlig
nervous	nervös
nervously	nervöst
nervousness	nervositet
nettle	nässla
neurotic	neurotisk
niggle	knåpa
nightmare	mardröm
nightmarishly	mardrömslikt
noise	ljud
noises	ljud
noisier	bullrigare
noisy	högljudd
non-confidence	icke-förtroende
nonexistent	obefintlig
nonresponsive	Icke-mottagande
nonsense	dumheter
nosey	nyfiken
notoriety	ökändhet
notorious	ökänd
notoriously	ökänt
noxious	skadlig
nuisance	obehag
numb	stel
obese	fet
object	objekt
objection	invändning
objectionable	stötande
objections	invändningar
oblique	sned
obliterate	utplåna
obliterated	utplånas
oblivious	omedveten
obnoxious	motbjudande
obscene	obscen
obscenely	oanständigt
obscenity	obscenitet
obscure	skymma
obscured	skyms
obscures	fördunklar
obscurity	dunkel
obsess	hemsöka
obsessive	obsessiv
obsessively	tvångsmässigt
obsessiveness	besatthet
obsolete	föråldrad
obstacle	hinder
obstinate	envis
obstinately	envist
obstruct	hindra
obstructed	hindras
obstructing	hindrande
obstruction	hinder
obstructs	hindrar
obtrusive	påfallande
obtuse	trubbig
occluded	ockluderade
occludes	ockluderar
occluding	ockluderande
odd	udda
oddity	underlighet
oddly	underligt
odor	odör
offence	anfall
offend	förolämpa
offender	lagbrytare
offending	felande
offenses	brott
offensive	offensiv
officious	beskäftig
ominous	olycksbådande
omission	underlåtenhet
omit	utelämna
one-sided	ensidig
onerous	betungande
onslaught	angrepp
opinionated	påstridig
opponent	motståndare
opportunistic	opportunistisk
oppose	motsätta
oppositions	invändningar
oppress	förtrycka
oppression	förtryck
oppressive	förtryckande
oppressively	damages
oppressiveness	instängdhet
oppressors	förtryck
ordeal	prövning
orphan	föräldralös
outbreak	utbrott
outburst	utbrott
outbursts	utbrott
outcast	utstött
outcry	skrik
outlaw	fredlös
outmoded	omodern
outrage	upprördhet
outraged	upprörda
outrageous	skandalös
outrages	övergrepp
outsider	utomstående
over-acted	over-handlat
over-balanced	over-viktad
over-hyped	över-hyped
over-valuation	övervärdering
overbalance	överbalans
overbalanced	överbalanserad
overbearing	högdragen
overblown	uppblåst
overdo	driv~~POS=HEADCOMP
overdue	försenad
overemphasize	betona
overheat	överhettas
overloaded	överbelastad
overlook	förbise
overpaid	överbetalda
overplay	överspela
overpower	manna
overrated	överskattade
overrun	överskridande
overshadow	överskugga
oversight	tillsyn
oversights	förbiseenden
oversimplified	förenklad
oversimplify	förenkling
overstate	överdriva
overstated	överskattas
overstatement	överdrift
overstatements	övervärderingar
overstates	överdriver
overthrow	störta
overthrows	överhäng
overturn	stjälpa
overweight	övervikt
overwhelm	överösa
overwhelmed	överväldigad
overwhelming	överväldigande
overwhelmingly	överväldigande
overwhelms	överväldigar
overzealous	nitiska
pain	smärta
painful	smärtsam
painfull	pain
painfully	plågsamt
pains	möda
pale	blek
paltry	ynklig
pan	panorera
panic	panik
panicked	panik
panicking	panik
paradoxical	paradoxal
paradoxically	paradoxalt
paralyzed	lam
parasite	parasit
pariah	paria
parody	parodi
partiality	partiskhet
partisans	partisaner
passive	passiv
passiveness	passivitet
pathetic	patetisk
pathetically	patetiskt
patronize	förmyndare
paucity	brist
pauper	fattighjon
payback	hämnd
peculiar	egendomlig
peculiarly	besynnerligt
pedantic	pedantisk
peeled	skalad
peevish	vresig
peevishly	vresigt
penalize	straffa
penalty	straff
perfunctory	summarisk
peril	fara
perilous	farlig
perish	förgås
pernicious	skadlig
perplex	förbrylla
perplexed	förvirrad
perplexing	förbryllande
perplexity	bryderi
persecute	förfölja
persecution	förföljelse
pertinacious	HALSSTARRIG
pertinacity	envishet
perturb	störa
pervasive	genomträngande
perverse	pervers
perversion	förvrängning
perversity	vrånghet
pervert	pervers
perverted	pervers
pessimistic	pessimistisk
pessimistically	pessimistiskt
pest	skadedjur
pestilent	Pestilent
petrified	förstenad
petrify	förstena
petty	ringa
phobia	fobi
phobic	fobiska
phony	falska
picket	postering
picketed	strejkvakt
picketing	strejkvakt
picky	petig
pig	gris
pigs	grisar
pillage	plundring
pillory	skampåle
pimple	finne
pinch	nypa
pique	såra
pitiable	ynklig
pitiful	ynklig
pitiless	skoningslös
pitilessly	skoningslöst
pity	medlidande
plagiarize	plagiera
plague	plåga
plaything	leksak
plea	grunden
pleas	grunder
plebeian	plebejisk
plot	komplott
plotters	konspiratörer
ploy	trick
plunder	plundra
pointless	meningslös
pointlessly	onödigt
poison	förgifta
poisonous	giftig
polarisation	polarisering
pollute	förorena
polluter	förorenaren
polluters	förorenare
polution	förorening
pompous	pompös
poor	fattig
poorer	sämre
poorest	fattigaste
poorly	dåligt
posturing	poser
poverty	fattigdom
powerless	maktlös
prate	BABBLA
prattle	pladder
precarious	osäker
precariously	betänkligt
precipitate	fällning
precipitous	brant
predicament	predika
prejudge	griper
prejudice	fördomar
prejudices	fördomar
prejudicial	skadlig
premeditated	uppsåtlig
preoccupy	sysselsätta
preposterous	orimlig
presumptuous	förmäten
pretence	anspråk
pretend	låtsas
pretense	anspråk
pretentious	pretentiös
prevaricate	slingra
pricey	dyr
prick	sticka
prickle	tagg
prickles	taggar
primitive	primitiv
prison	fängelse
prisoner	fånge
problematic	problematisk
problems	problem
procrastinate	förhala
procrastination	uppskjutande
profane	vanhelga
profanity	hädelser
prohibit	förbjuda
prohibitive	hindrande
prohibitively	oöverkomligt
proprietary	Proprietär
prosecute	åtala
protested	protest
protesting	protesterar
protests	protester
protracted	utdragen
provocation	provokation
provocative	provokativ
provoke	provocera
pry	bända
pugnacity	stridslystnad
punch	stansa
punish	straffa
punishable	straffbar
punitive	straff-
punk	punk-
puppet	marionett
puppets	dockor
puzzled	förbryllad
puzzlement	förvirring
puzzling	förbryllande
quack	kvacksalvare
qualms	samvetskval
quandary	dilemma
quarrel	gräl
quarrels	bråk
quash	krossa
questionable	tveksamt
quibble	käbbla
quibbles	juristeri
quitter	smitare
rabid	fanatisk
racism	rasism
racist	rasist
racists	rasister
radical	radikal
radicalization	radikalisering
radically	radikalt
radicals	radikaler
rage	rasa
ragged	ojämn
raging	rasande
rail	järnväg
rampage	framfart
rampant	skenande
ramshackle	skranglig
rancor	agg
randomly	slumpvis
rant	utläggning
rants	gormanden
rape	våldta
raped	våldtagen
raping	våldta
rascal	skojare
rash	utslag
rattle	skallra
rattles	skallror
ravage	härja
raving	yra
reactionary	reaktionär
rebellious	upprorisk
rebuff	avvisa
rebuke	tillrätta
recalcitrant	motsträvig
recession	lågkonjunktur
reckless	hänsynslös
recklessly	vårdslöst
recklessness	övermod
recoil	rekyl
recourses	resurser
redundancy	redundans
redundant	överflödig
refusal	vägran
refuse	vägra
refused	vägrade
refuses	vägrar
refusing	vägrar
refutation	vederläggning
refute	vederlägga
refuted	motbevisade
refutes	vederlägger
refuting	bemötande
regressive	regressiv
regret	ångra
regretful	beklagande
regretfully	tyvärr
regrets	beklagar
regrettable	beklaglig
regrettably	tyvärr
regretted	beklagade
reject	avvisa
rejected	avvisade
rejecting	förkasta
rejection	avslag
rejects	avvisar
relapse	återfall
relentless	obeveklig
relentlessly	obevekligt
relentlessness	oförsonlighet
reluctance	motvillighet
reluctant	motvillig
reluctantly	motvilligt
remorse	ånger
remorsefully	ånger
remorselessly	samvetslöst
renunciation	avsägelse
repetitive	repetitiva
reprehensible	klandervärd
reprehensibly	klandervärt
reprehension	KLANDER
repress	förtränga
repression	undertryckande
repressive	repressiv
reprimand	tillrättavisning
reproach	förebrå
reproachful	förebrående
reprove	förebrå
reprovingly	förebrående
repudiate	förkasta
repudiation	förkastande
repugnance	avsky
repugnant	motbjudande
repulsed	avsky
repulsive	motbjudande
repulsively	repellerande
repulsiveness	repulsions
resentful	förbittrad
resentment	förbittring
resignation	avgång
resistance	motstånd
restless	rastlös
restlessness	rastlöshet
restrict	begränsa
restricted	begränsad
restriction	restriktion
restrictive	restriktiv
retaliate	hämnas
retaliatory	motåtgärder
retard	hämma
retarded	retarderad
reticent	förtegen
retreat	reträtt
revenge	hämnd
revert	återgå
revile	smäda
revoke	återkalla
revolting	upprörande
revulsion	motvilja
revulsive	MOTVILLIG
rhapsodize	RAPSODIERA
rhetoric	retorik
rhetorical	retorisk
ridicule	förlöjliga
ridicules	preciöserna
ridiculous	löjlig
ridiculously	löjligt
rife	utbredd
rift	reva
rifts	sprickor
rigid	stel
rigidity	stelhet
rigidness	styvhet
ripped	rev
risks	risker
risky	riskabel
rivalry	rivalitet
roadblocks	spärrar
rocky	klippig
rogue	skurk
rot	ruttna
rotten	rutten
rough	grov
rubbish	skräp
rude	oförskämd
rue	ångra
ruffian	buse
ruffle	krås
ruined	förstörd
ruining	förstör
ruinous	ödeläggande
ruins	ruiner
rumbling	mullrande
rumor	rykte
rumors	rykten
rumours	rykten
rupture	brista
rust	rost
rusts	rost
rusty	rostig
rut	brunst
ruthless	hänsynslös
ruthlessly	hänsynslöst
ruthlessness	hänsynslöshet
ruts	hjulspår
sack	säck
sacrificed	offrades
sad	ledsen
sadden	bedröva
sadly	tyvärr
sadness	sorg
sag	svikta
sags	bottnar
salacious	slipprig
sanctimonious	skenhelig
sap	sav
sarcasm	sarkasm
sarcastically	sarkastiskt
sardonic	hånfull
satirical	satirisk
savage	vilde
savagery	barbari
savages	vildar
scaly	fjällig
scam	lurendrejeri
scams	bedrägerier
scandal	skandal
scandalize	SKANDALISERA
scandalous	skandal-
scandals	skandaler
scant	ringa
scapegoat	syndabock
scar	ärr
scarce	knapp
scarcely	knappt
scarcity	brist
scare	skrämma
scared	rädd
scarier	skrämmande
scarred	ärrig
scars	ärr
scary	skrämmande
scathing	skarp
sceptical	skeptisk
scoff	håna
scold	skälla
scolding	utskällning
scorching	brännhet
scorn	förakt
scornful	hånfull
scornfully	hånfullt
scoundrel	skurk
scourge	gissel
scramble	förvränga
scrambled	oordning
scrambles	blandar
scrambling	krypteringskod
scrap	skrot
scratch	repa
scratched	repig
scratches	repor
scratchy	knaster
scream	skrika
screech	tjut
screwed	skruvad
screwy	knäpp
scuff	skava
scuffs	skav
scum	avskum
secretive	hemlighetsfull
sedentary	stillasittande
seedy	krasslig
seethe	koka
seething	sjudande
self-criticism	självkritik
self-defeating	självförgörande
self-destructive	självdestruktiv
self-humiliation	SJÄLVMORD
self-interest	egenintresse
self-interested	egennyttiga
self-serving	självbetjäning
selfish	självisk
selfishly	själviskt
selfishness	själviskhet
senile	senil
senseless	meningslös
senselessly	meningslöst
seriousness	allvar
servitude	träldom
set-up	inrätta
setback	motgång
setbacks	bakslag
sever	kapa
severe	svår
severity	stränghet
shabby	sjaskig
shadowy	skuggig
shady	skuggig
shake	skaka
shaky	skakig
shallow	grund
sham	bluff
shambles	förödelse
shame	skam
shameful	skamlig
shamefully	skamligt
shameless	skamlös
shamelessly	skamlöst
shamelessness	skamlöshet
shark	haj
sharply	skarpt
shimmer	skimmer
shipwreck	förlisning
shirker	smitare
shit	Skit
shiver	darrning
shock	chock
shocked	chockade
shocking	upprörande
shockingly	chockerande
shoddy	usel
short-lived	kortlivad
shortage	brist
shortchange	short
shortcoming	brist
shortcomings	brister
shortness	korthet
shortsighted	närsynt
shortsightedness	närsynthet
showdown	uppgörelse
shrew	argbigga
shriek	skrika
shrill	gäll
shrilly	gällt
shrivel	skrumpna
shroud	svepa
shrouded	höljd
shun	sky
shunned	skytt
sick	sjuk
sicken	äcklas
sickening	kväljande
sickly	sjuklig
sickness	sjukdom
sidetrack	sidospår
sidetracked	sidospår
siege	belägring
silly	dumbom
simplistic	naiv
simplistically	förenklat
sin	synd
sinful	syndig
sinister	olycksbådande
sink	sjunka
sinking	sjunkande
skeletons	skelett
skeptic	skeptiker
skeptical	skeptisk
skeptically	skeptiskt
skepticism	skepsis
sketchy	luddigt
skimpy	snål
skinny	mager
skittish	skygg
skulk	MASKA
slack	slak
slander	förtal
slanderer	baktalare
slanderous	kränkande
slanderously	smäda
slanders	förtal
slap	slag
slaughter	slakt
slaughtered	slaktade
slave	slav
slaves	slavar
sleazy	sjaskig
slime	slem
slog	slit
sloppily	slarvigt
sloppy	slarvig
sloth	lättja
slothful	lättjefull
slow	långsam
slow-moving	långsamma
slowed	saktat
slower	långsammare
slowest	långsammaste
slowly	långsamt
slug	snigel
sluggish	trög
slump	svacka
slur	sluddra
slut	slampa
sly	slug
smallish	små
smear	smeta
smell	lukt
smelled	luktade
smelling	lukta
smells	luktar
smelly	stinkande
smelt	smälta
smoke	rök
smokescreen	dimridå
smolder	pyra
smoldering	pyrande
smother	kväva
smoulder	pyra
smouldering	pyrande
smudge	fläcka
smudged	suddig
smudges	fläckar
smudging	smetas
smug	självbelåtna
smugly	självbelåtet
snag	krux
snagging	upphakning
snags	hakar
snare	snara
snarl	morra
sneak	smyg
sneaky	lömsk
sneer	håna
sneering	hånfull
sneeringly	försmädligt
snob	snobb
snobbish	snobbig
snobby	snobbig
snub	nonchalera
soapy	tvål
sob	snyfta
sober	nykter
sobering	nyktra
solemn	högtidlig
solicitude	omtanke
somber	dyster
sore	öm
soreness	ömhet
sorrow	sorg
sorrowful	sorgsen
sorrowfully	sorgset
sorry	förlåt
sour	sur
sourly	surt
spank	daska
spew	spy
spewed	spydde
spilling	spilla
spiritless	ande
spite	trots
spiteful	hätsk
spitefully	illvilligt
spitefulness	illvilja
split	dela
splitting	delning
spoilage	förruttnelse
spoiled	bortskämd
spoils	bytet
spook	spöke
spooky	läskigt
spoon-fed	sked-fed
sporadic	sporadisk
spotty	ojämn
spurious	oäkta
spurn	förakta
sputter	fräsa
squabble	kivas
squabbling	käbbel
squander	slösa
squeak	gnissla
squeaks	gnissel
squeaky	pipig
squeal	skrika
squealing	skrikande
squeals	tjut
squirm	våndas
stab	hugg
stagnant	stagnerande
stagnate	stagnera
staid	stadgad
stain	fläck
stains	fläckar
stale	unken
stalemate	dödläge
stall	bås
stalls	parkett
stammer	stamma
stampede	panik
stark	skarp
startle	skrämma
startling	häpnadsväckande
starvation	svält
starve	svälta
static	statisk
steal	stjäla
stealing	stjäla
steals	stjäl
steep	brant
steeply	brant
stench	stank
stereotype	stereotyp
stereotypical	stereotyp
stereotypically	stereotypt
stern	akter
stew	gryta
sticky	klibbig
stiff	styv
stiffness	styvhet
stifle	kväva
stifling	kvalmig
stigmatize	stigmatisera
stinging	svidande
stingy	snål
stink	stank
stinks	stinker
stodgy	bastant
stole	stola
stolen	stulna
stooge	nickedocka
stormy	stormig
strain	anstränga
strained	spänd
straining	spännare
strange	konstig
strangely	underligt
stranger	främling
strangest	underlig
strangle	strypa
streaky	strimmig
strenuous	ansträngande
stress	påfrestning
stresses	påkänningar
stressful	stressig
stricken	drabbade
strict	sträng
strictly	strikt
strident	skärande
strife	kiv
strike	strejk
stringent	stränga
stringently	strikt
struck	slog
struggle	kamp
struggled	kämpade
struggles	kamp
struggling	kämpar
strut	stag
stubborn	envis
stubbornly	envis
stubbornness	envishet
stuck	fastnat
stuffy	tilltäppt
stumble	snubbla
stumbled	snubblat
stumbles	snubblar
stump	stubbe
stumps	stubbar
stun	bedöva
stunt	hämma
stunted	förkrympt
stupid	dum
stupidest	dummaste
stupidity	dumhet
stupidly	dumt
stupify	Stupify
stupor	dvala
stutter	stamma
stuttered	stammade
stuttering	stamning
stutters	hackar
sty	vagel
subdued	dämpad
subjected	utsattes
subjection	underkastelse
subjugate	kuva
subjugation	underkuvande
submissive	undergiven
subordinate	underlydande
subpoena	stämning
subpoenas	stämningar
subservience	underkastelse
subservient	underdånig
substandard	undermålig
subtract	subtrahera
subversion	omstörtning
subversive	omstörtande
subversively	subversivt
subvert	omstörta
suck	suga
sucked	sugs
sucker	parasit
sucks	suger
sue	stämma
sued	stämd
sues	Sues
suffer	lida
suffered	lidit
suffering	lidande
suffers	lider
suffocate	kväva
suicide	självmord
sulk	tjura
sullen	trumpen
sunk	sjunkit
sunken	nedsänkt
superficial	ytlig
superficiality	ytlighet
superficially	ytligt
superfluous	överflödig
superstition	vidskepelse
superstitious	vidskeplig
suppress	dämpa
suppression	undertryckande
surrender	överlämna
susceptible	mottaglig
suspect	misstänka
suspicion	misstanke
suspicions	misstankar
suspicious	misstänksam
suspiciously	misstänk
swagger	skryt
swamped	svämmas
sweaty	svettig
swelled	svällde
swelling	svullnad
swindle	lura
swollen	svullen
symptoms	symptom
syndrome	syndrom
taboo	tabu
tacky	klibbig
taint	bismak
tainted	fläckas
tamper	manipulera
tangle	härva
tangled	tilltrasslad
tangles	tovor
tanks	tankar
tantrum	raserianfall
tardy	långsam
tarnish	missfärgning
tarnished	anlupen
tarnishes	anlöpningar
tarnishing	mattas
tattered	trasig
taunt	håna
taunting	pika
taunts	glåpord
taut	spänd
taxing	beskatta
tease	reta
teasingly	retsamt
tedious	tråkig
temerity	dumdristighet
temper	humör
tempest	storm
temptation	frestelse
tenderness	ömhet
tense	spänd
tension	spänning
tentative	preliminär
tentatively	preliminärt
tenuous	svag
tepid	ljummen
terrible	fruktansvärd
terribly	fruktansvärt
terror	skräck
terror-genic	terror-framkallande
terrorize	terrorisera
testy	retlig
thankless	otacksam
thicker	tjockare
thirst	törst
thorny	taggig
thoughtless	tanklös
thoughtlessly	tank
thoughtlessness	tanklöshet
thrash	tröska
threat	hot
threaten	hota
threatening	hotfull
threats	hot
threesome	trekant
throb	bulta
throbbed	dunkade
throbbing	bultande
throbs	bultar
throttle	strypa
thug	gangster
thwart	omintetgöra
time-consuming	tidskrävande
timid	skygg
timidity	skygghet
timidly	blygt
tingling	stickningar
tired	trött
tiresome	tröttsam
tiring	tröttsam
toil	slit
toll	vägtull
top-heavy	topp-tung
topple	störta
torment	plåga
tormented	plågade
tortuous	slingrig
torture	tortyr
tortured	torterade
tortures	tortyr
torturous	plågsam
totalitarian	totalitär
touchy	känslig
toughness	seghet
touted	tippad
toxic	toxisk
traduce	BAKTALA
tragedy	tragedi
tragic	tragisk
tragically	tragiskt
traitor	förrädare
traitorous	förrädisk
tramp	luffare
transgress	överskrida
transgression	överträdelse
trap	fälla
traped	Traped
trapped	instängd
trash	skräp
trashed	skrotade
traumatic	traumatisk
traumatically	traumatiskt
traumatized	traumatiserad
travesty	travesti
treacherous	förrädisk
treacherously	förrädiskt
treachery	förräderi
treason	förräderi
treasonous	förrädisk
trick	lura
tricked	luras
trickery	knep
tricky	knepig
trivialize	trivialisera
trouble	problem
troubled	bekymrad
troublemaker	bråkmakare
troubles	bekymmer
troublesome	besvärlig
troublesomely	besvär
troubling	oroande
troublingly	besvär
truant	skolkare
tumble	tumla
tumbled	tumlas
tumbles	Tumbles
tumultuous	stormande
turmoil	kaos
twist	vrida
twisted	vriden
twists	vändningar
tyrannical	tyrannisk
tyrannically	tyrann
tyranny	tyranni
tyrant	tyrann
ugh	usch
uglier	fulare
ugliness	fulhet
ugly	ful
ultimatums	ultimatum
ultra-hardline	ultrahårdföre
un-viewable	un-synlig
unable	oförmögen
unacceptable	oacceptabel
unacceptably	oacceptabelt
unaccessible	oåtkomliga
unaccustomed	ovana
unachievable	ouppnåeliga
unappealing	oattraktiv
unattractive	oattraktiv
unavoidably	oundvikligt
unbearable	outhärdlig
unbelievable	otrolig
unbelievably	otroligt
uncaring	OBEKYMRAD
uncertain	osäker
uncivil	ohövlig
uncivilized	ociviliserad
unclean	oren
unclear	oklar
uncollectible	osäkra
uncomfortable	obekväm
uncomfortably	obekvämt
uncompetitive	konkurrenskraftiga
uncompromising	kompromisslös
uncompromisingly	kompromisslöst
unconfirmed	obekräftad
unconstitutional	okonstitutionellt
uncontrolled	okontrollerad
uncooperative	samarbetsvillig
undecided	obeslutsam
undefined	odefinierad
undependable	opålitliga
undercut	underskärning
undercuts	underskärningar
undercutting	underskärning
underdog	underläge
underestimate	underskattar
undermine	underminera
undermined	undermineras
undermines	undergräver
undermining	underminera
underpaid	betalda
underpowered	powered
undersized	underdimensionerade
undesirable	oönskad
undetermined	obestämd
undid	lossade
undignified	ovärdig
undissolved	oupplöst
undocumented	odokumenterad
undone	uppknäppt
undue	otillbörlig
unease	oro
uneasily	oroligt
uneasiness	oro
uneconomical	oekonomisk
unemployed	arbetslös
unequal	olika
unethical	oetisk
uneven	ojämn
uneventful	händelselös
unexpected	oväntat
unexpectedly	oväntat
unexplained	oförklarad
unfairly	Orättvist
unfaithful	otrogen
unfaithfully	trolöst
unfamiliar	obekant
unfavorable	ogynnsam
unfeeling	okänslig
unfinished	oavslutat
unfit	olämplig
unforeseen	oförutsedd
unforgiving	oförsonlig
unfortunate	olyckligt
unfortunately	tyvärr
unfounded	ogrundad
unfriendly	ovänlig
unfulfilled	ouppfylld
unfunded	ofonderad
ungovernable	oregerlig
ungrateful	otacksam
unhappily	olyckligt
unhappiness	olycka
unhappy	olycklig
unhealthy	ohälsosam
unhelpful	ohjälpsam
unimaginable	ofattbar
unimaginably	ofattbart
unimportant	oviktig
uninformed	oinformerad
uninsured	oförsäkrade
unintelligible	obegriplig
unipolar	unipolär
unjust	orättvis
unjustifiable	oberättigad
unjustifiably	oberättigat
unjustified	oberättigad
unjustly	orättvist
unkind	ovänlig
unkindly	ovänligt
unknown	okänd
unlawful	olaglig
unlawfully	olovligen
unlawfulness	rättsstridighet
unleash	frigöra
unlicensed	olicensierad
unlikely	osannolik
unlucky	olycklig
unmoved	oberörd
unnatural	onaturlig
unnecessary	onödig
unorthodox	oortodox
unpleasant	obehaglig
unpopular	impopulär
unpredictable	oförutsägbar
unprepared	oförberedd
unqualified	okvalificerad
unreachable	onåbar
unreadable	oläslig
unrealistic	orealistisk
unreasonable	orimlig
unrelenting	obeveklig
unreliability	opålitlighet
unreliable	opålitliga
unresolved	olöst
unresponsive	okänslig
unrest	oro
unruly	ostyrig
unsafe	osäker
unsatisfactory	otillfredsställande
unsavory	motbjudande
unsettling	oroande
unspeakable	outsäglig
unspecified	ospecificerad
unstable	instabil
unsure	osäker
untenable	ohållbar
unwanted	oönskade
uprising	uppror
uproar	kalabalik
uproot	utrota
upset	upprörd
upsets	störningar
useless	onyttig
usurper	inkräktare
utterly	ytterst
vagrant	luffare
vague	vag
vagueness	vaghet
vanity	fåfänga
vehemently	häftigt
vengeance	hämnd
venom	gift
vent	ventilera
vestiges	spår
vibrate	vibrera
vibrating	vibrerande
vicious	ond
viciously	illvilligt
vile	vidrig
vilify	förtala
villainous	skurkaktig
villains	skurkar
violate	kränka
violation	överträdelse
violator	lagbrytare
violent	våldsam
violently	våldsamt
volatile	flyktig
volatility	flyktighet
vomit	kräkas
vomited	kräktes
vomiting	kräkningar
vulgar	vulgär
vulnerable	sårbar
warily	varsamt
wariness	varsamhet
warlike	krigisk
warning	varning
warp	varp
warped	skev
wary	försiktig
waste	avfall
wasted	förlorad
wasteful	slösaktig
wasting	slöseri
wayward	egensinnig
weak	svag
weaken	försvaga
weakening	försvagning
weaker	svagare
weakness	svaghet
weaknesses	svagheter
weariness	trötthet
wearisome	tröttsam
weary	trötta
weed	ogräs
weep	gråta
weird	konstig
weirdly	konstigt
whimper	gnälla
whine	gnälla
whining	vinande
wicked	ond
wickedness	ondska
wild	vild
wildly	vilt
woebegone	BEDRÖVAD
womanizer	womaniser
worried	orolig
worriedly	oroligt
worries	bekymmer
worrisome	besvärlig
worry	oroa
worse	värre
worsen	förvärra
worsening	försämring
worst	värst
wound	sår
wounds	sår
wrath	vrede
wreck	förstöra
wrestle	brottas
wretched	usel
wrinkle	skrynkla
wrinkles	rynkor
wrong	fel
wrought	dekorerad
zealot	fanatiker
zealous	nitisk
